Mm, Mm^Xm, Mm^Xm, Mm, Mm^Xm, Mm, Mm, Mm, Mm, Mm, Mm^Xm, Mm, Mm, Mm, Mm, Mm, Mm, Mm, Mm, Mm, Mm, Gg, Mm, Mm, Mm, Mm, Hh^Fms, Hh^Fms, Gg^Efm, Gg, Hh^Fms, Mm, Mm, Mm, Mm, Mm, Mm^Xm, Mm, Mm, Mm, Mm, Mm, Mm, Mm, Mm, Mm, Hh^Fms, Hh^Fms, Ww, Ww, Ww
Mm^Xm, Mm^Xm, Mm, Mm^Xm, Mm, Mm^Xm, Mm^Xm, Mm^Xm, Mm^Xm, Mm^Xm, Mm, Mm, Mm, Mm, Mm, Mm, Mm, Mm, Hh^Fms, Mm, Hh^Fms, Mm, Mm, Mm, Hh^Fms, Mm, Hh^Fms, Gg^Efm, 1 Gg^Efm, Hh^Fms, Mm, Mm, Mm, Mm^Xm, Mm, Mm^Xm, Mm, Mm, Mm, Mm, Mm, Mm, Mm, Mm, Hh^Fms, Hh^Fms, Ww, Ww, Ww, Ww, Ww
Mm^Xm, Mm, Mm, Mm, Mm, Mm, Mm^Xm, Mm, Mm, Mm^Xm, Mm, Mm^Xm, Mm, Mm, Mm, Mm, Mm, Hh^Fms, Hh^Fms, Hh^Fms, Hh^Fms, Hh^Fms, Hh^Fms, Hh^Fms, Kw, Hh^Fms, Gg^Efm, Gs, Gg^Efm, Hh^Fms, Mm, Mm, Mm, Mm^Xm, Mm, Mm, Mm, Mm, Hh^Fms, Mm, Mm, Mm, Hh^Fms, Hh^Fms, Gs^Fms, Ww, Ww, Ww, Ww, Ww, Hh^Fms
Mm^Xm, Mm, Mm, Mm, Mm^Xm, Mm, Mm, Mm, Mm, Mm^Xm, Mm, Mm, Mm, Mm, Mm, Mm, Mm, Hh^Fms, Hh^Fms, Hh^Fms, Gll, Hh^Fms, Cw, Cw, Gg^Efm, Cw, Cw, Gs^Efm, Gg, Hh^Fms, Hh^Fms, Mm, Mm, Mm, Mm, Mm, Hh^Fms, Hh^Fms, Gs^Fms, Hh^Fms, Hh^Fms, Hh^Fms, Gs^Fms, Gs^Fms, Ww, Ww, Ww, Ww, Ww, Hh^Fms, Hh^Fms
Mm^Xm, Mm, Mm, Mm^Xm, Mm, Mm, Mm, Mm, Mm, Mm, Mm, Mm, Mm, Mm, Mm, Mm, Mm, Hh^Fms, Gs, Gll, Gg^Efm, Gs, Kw, Gs^Efm, Gg^Efm, Gg^Efm, Kw, Gg^Efm, Gg^Es, Gs^Fms, Gs^Fms, Hh^Fms, Hh^Fms, Mm, Hh^Fms, Hh^Fms, Gs^Fms, Gs^Fms, Ww, Gs^Fms, Ww, Ww, Ww, Ww, Ww, Ww, Ww, Ww, Hh^Fms, Hh^Fms, Mm
Mm^Xm, Mm, Mm^Xm, Mm^Xm, Mm, Mm, Mm, Mm^Xm, Mm, Mm, Mm, Mm, Hh^Fms, Mm, Mm, Mm, Hh^Fms, Hh^Fms, Gs, Gg^Efm, Gg^Efm, Gg^Vws, Gg, Gg^Efm, Kw, Gll^Efm, Gg, Gg^Vws, Gg, Gll, Gs^Fms, Gs^Fms, Gs^Fms, Hh^Fms, Gs^Fms, Gs^Fms, Ww, Ww, Ww, Ww, Ww, Ww, Ww, Ww, Ww, Ww, Hh^Fms, Hh^Fms, Hh^Fms, Mm, Mm
Mm^Xm, Mm^Xm, Mm, Mm, Mm^Xm, Mm, Mm, Mm, Mm, Mm, Mm, Hh^Fms, Hh^Fms, Hh^Fms, Hh^Fms, Hh^Fms, Gg^Efm, Gg, Gg, Gs, Gs, Gg^Efm, Gg^Efm, Gg^Efm, Gg, Gs, Gll, Gg, Gs, Gg, Gg^Es, Gll, Gg, Gs^Fms, Ww, Ww, Ww, Ww, Ww, Ww, Ww, Ww, Ww, Ww, Gs^Fms, Gs^Fms, Hh^Fms, Hh^Fms, Mm, Mm, Mm
Mm, Mm, Mm, Mm, Mm, Mm, Mm, Mm, Mm, Mm, Hh^Fms, Hh^Fms, Gs^Fms, Gs^Fms, Gll, Gg, Gg^Efm, Gg, Gg^Es, Gg, Gg, Gg, Hh, Hh^Fms, Hh^Fms, Gs^Fms, Gll, Gs^Fms, Gs^Fms, Gg, Gs, Gg, Ww, Wwf, Wwf, Ww, Ww, Ww, Gs^Fms, Ww, Gs^Fms, Gs^Fms, Gs^Fms, Gs^Fms, Gs^Fms, Hh^Fms, Mm, Mm, Mm, Mm, Mm
Mm, Mm, Mm, Mm, Mm, Mm, Mm, Mm, Hh^Fms, Hh^Fms, Gs^Fms, Gs^Fms, Gll, Gll, Gs^Fms, Gs^Fms, Hh^Vud, Gg^Efm, Gg, Gg, Gg, Gs, Hh^Fms, Hh^Fms, Hh^Fms, Gs, Gg, Gll, Gs^Fms, Gs^Fms, Gg, Ww, Ww, Ww, Ww, Wwf, Wwf, Gg, Gs^Fms, Gs^Fms, Hh^Fms, Hh^Fms, Hh^Fms, Gs^Fms, Hh^Fms, Hh^Fms, Mm, Mm, Mm, Mm, Mm
Mm, Mm, Mm, Mm, Mm, Mm, Mm, Mm, Hh^Fms, Gs^Fms, Gs^Fms, Gs^Fms, Gll, Gs^Fms, Gs^Fms, Hh^Fp, Hh, Hh^Fp, Gg, Gg^Efm, Gg, Gs, Gs, Gs^Fms, Gs^Fms, Gll, Gll, Gs^Fms, Gg, Gg^Efm, Gg, Ww, Ww, Ww, Gg, Wwf, Gg, Gg, Gs^Fms, Hh^Fms, Mm, Mm, Mm, Hh^Fms, Mm, Mm, Mm, Mm, Mm^Xm, Mm^Xm, Mm
Mm, Mm, Mm^Xm, Mm^Xm, Mm, Mm, Mm, Mm, Mm, Hh^Fms, Hh^Fms, Gs, Gs, Gs^Fms, Gs^Fms, Gll, Gll, Gs^Fms, Gs^Fms, Gg^Efm, Gg, Gg^Es, Gg, Gg, Gg, Gg, Gg^Efm, Gg^Efm, Gg, Gg^Es, Gg^Ve, Ww, Ww, Ww, Gg^Es, Gg, Gg, Gg, Gs^Fms, Hh^Fms, Hh^Fms, Mm, Mm, Mm, Mm^Xm, Mm, Mm, Mm^Xm, Mm^Xm, Mm^Xm, Mm
Mm^Xm, Mm^Xm, Mm, Mm, Mm, Mm, Mm, Mm, Mm, Mm, Hh^Fms, Gg, Gg, Gg, Gg, Gg, Gs^Fms, Gll, Gs^Fms, Gs, Gll, Gs^Fms, Gs^Fms, Gg, Gg, Gg, Ww, Gg, Ww, Wwf, Ww, Ww, Ww, Ww, Gg, Gs, Gs^Fms, Gll, Gs^Fms, Gs^Fms, Hh^Fms, Mm, Mm, Mm, Mm, Mm^Xm, Mm, Mm^Xm, Mm^Xm, Mm, Mm
Mm^Xm, Mm, Mm^Xm, Mm, Mm, Mm, Mm, Mm, Mm, Hh^Fms, Gs, Gll, Gs^Fms, Gs^Fms, Gll, Gs^Fms, Gg, Gs^Fms, Gg^Es, Gg, Gg^Efm, Gs^Fms, Gg^Ve, Gg, Ww, Ww, Ww, Ww, Ww, Ww, Ww, Ww, Ww, Ww, Gg, Gll, Gs^Fms, Gll, Gll, Gs^Fms, Gs^Fms, Hh^Fms, Hh^Fms, Mm, Mm, Mm, Mm, Mm^Xm, Mm^Xm, Mm^Xm, Mm
Mm, Mm^Xm, Mm^Xm, Mm, Mm, Mm, Mm, Mm, Hh, Hh^Fms, Gg, Gg, Hh, Hh^Fms, Hh^Fms, Gg, Gg, Gg^Es, Gg, Gg, Gg, Gg^Efm, Ww, Ww, Ww, Ww, Ww, Ww, Ww, Ww, Ww, Ww, Gg, Gg, Gs^Fms, Gll, Hh^Fms, Gs^Fms, Gg, Gg^Ve, Gs^Fms, Gs^Fms, Gs^Fms, Hh^Fms, Hh^Fms, Mm, Mm, Mm, Mm, Mm, Mm
Mm, Mm, Mm, Mm, Mm, Mm, Mm, Hh, Hh^Vud, Gs, Gg, Gg, Gs, Hh^Vud, Hh, Gg, Gs^Fms, Gll, Gs^Fms, Gs, Gg, Gg, Ww, Ww, Ww, Ww, Gg^Es, Gs^Efm, Gg^Es, Gg^Efm, Gg, Gg, Gs, Gs^Fms, Gs^Fms, Hh^Fms, Hh^Fms, Hh, Gg^Efm, Gg, Gg^Efm, Gs^Fms, Gll, Gs^Fms, Hh^Fms, Mm, Mm, Mm, Mm, Mm, Mm
Mm, Mm, Mm, Mm, Mm, Mm, Mm, Mm, Hh, Gs, Gs, Gg^Es, Gg, Gs, Gg, Gs, Gs, Gs^Fms, Gg, Gs, Ww, Ww, Ww, Ww^Ewl, Ww, Gs^Efm, Ww^Ewl, Gs, Ww, Gg, Gg^Efm, Gg^Es, Gg, Gll, Gs^Fms, Hh^Ve, Hh^Fms, Gg, Gg^Efm, Gg, Gg, Gg, Gs^Fms, Gs^Fms, Hh^Fms, Mm, Mm, Mm, Mm, Mm, Mm
Mm, Mm, Mm, Mm, Mm, Mm, Mm, Hh, Gs, Gs, Gg, Gg, Gs, Gg, Gg, Gg, Gg, Gg, Wwf, Wwf, Wwf, Ww, Ww^Ewf, Ww^Ewf, Ww, Ww^Ewl, Ww, Ww^Ewl, Ww, Ww, Ww, Gg, Gg, Gg, Gs, Gs^Fms, Gg, Gg, Gs^Fms, Gg^Efm, Cv, Cv, Cv, Gs^Fms, Gs^Fms, Hh^Fms, Mm, Mm, Mm, Mm, Mm
Mm, Mm, Mm, Mm, Mm, Cud, 4 Kud, Cud, Cud, Gg, Gg, Gg, Hh, Gg, Gg^Es, Gg, Ww, Ww, Ww, Wwf, Gs^Efm, Gll, Gg^Fet, Gll^Fp, Ww^Ewf, Ww, Wwf, Ww, Gll^Fp, Ww, Ww, Ww, Ww, Gg, Gg^Es, Gg, Gg, Gs^Fms, Gll, Gs, Gg^Es, Gg^Efm, Cv, 3 Kv, Gs^Fms, Hh^Fms, Hh^Fms, Mm, Hh^Fms, Hh^Fms, Hh^Fms
Mm, Mm^Xm, Mm^Xm, Mm, Mm, Hh, Cud, Cud, Gs, Gg, Gg, Hh^Vud, Hh, Hh, Gg, Gg, Ww^Ewl, Ww, Ww, Gll^Fp, Gll, Gll^Fp, Gll, Gll^Fp, Gg^Efm, Wwf, Ww, Gll, Gg^Fet, Gll^Fp, Ww^Ewf, Ww, Ww, Gg^Efm, Gg^Efm, Gs, Gs^Fms, Gs^Fms, Hh, Gll, Gs^Fms, Gs^Efm, Gg^Efm, Cv, Gs^Fms, Gs^Fms, Gs^Fms, Hh^Fms, Gs^Fms, Gs^Fms, Gs^Fms
Mm, Mm^Xm, Mm^Xm, Mm, Mm, Mm, Mm, Cud, Hh, Gs, Gg, Gs, Gs, Gs, Gg, Gg, Ww^Ewl, Ww, Ww^Ewf, Gg^Fet, Gll^Fp, Gg^Ve, Ww, Wwf, Wwf, Ww, Ww, Ww^Ewf, Ww, Gll^Efm, Ww, Ww, Ww, Gg^Efm, Gg, Gs, Hh^Fms, Hh, Gs^Fms, Gs^Fms, Gs^Fms, Gs^Fms, Cv, Cv, Gg, Gll, Gll^Efm, Gs^Fms, Gg, Gs^Fms, Gg
Mm, Mm^Xm, Mm^Xm, Mm^Xm, Mm^Xm, Mm, Mm, Mm, Mm, Hh, Gg, Gg, Gg, Gg, Gg, Gg, Ww, Ww, Ww^Ewf, Ww, Ww, Ww^Ewl, Ww, Ww, Gll^Efm, Ww, Gll^Fp, Ww^Ewf, Ww, Wwf, Ww, Ww, Ww, Gg^Efm, Gg, Gll, Hh^Fms, Hh^Fms, Hh, Gg^Ve, Hh^Fms, Hh, Gs, Gg^Es, Gg, Gll^Efm, Gll, Gll, Gll, Gll^Efm, Gll
Mm, Mm^Xm, Mm^Xm, Mm, Mm^Xm, Mm, Mm, Mm, Mm, Hh, Hh^Vud, Gg, Gg, Gs, Gs, Gg, Ww, Ww, Ww, Ww^Ewf, Ww, Ww, Ww^Ewf, Gg^Fet, Gll, Gll^Fp, Ww, Ww, Ww, Gg, Gg, Ww, Gg, Gg^Efm, Gs, Gs^Fms, Gs^Fms, Hh^Fms, Hh^Fms, Hh^Fms, Hh^Fms, Gs^Fms, Gll, Gll, Gs^Fms, Gs^Fms, Gs^Fms, Gs^Fms, Gs^Fms, Gll, Gg
Mm, Mm^Xm, Mm^Xm, Mm^Xm, Mm, Mm, Mm, Mm, Mm, Mm, Hh, Gs, Gg^Es, Gg, Gs, Gg, Ww^Ewl, Ww, Ww, Ww, Ww, Ww, Ww, Ww, Wwf, Ww, Ww, Ww, Gg, Gg, Gs, Gg, Gg^Es, Gs, Gs, Gs^Fms, Gll, Gll, Gs^Fms, Gs^Fms, Gg, Gg, Gll, Gs^Fms, Gs^Fms, Gll, Gs^Fms, Gll, Gs^Fms, Gs^Fms, Gs^Fms
Mm^Xm, Mm^Xm, Mm^Xm, Mm, Mm^Xm, Mm, Hh, Mm, Hh, Hh, Gs, Gs, Gg, Gg, Gs, Gg, Gg, Ww, Ww, Ww, Gs^Fms, Gs^Fms, Gg, Ww, Gg, Ww, Gg, Gg, Gg^Es, Gg, Gg, Gs, Gg, Gg^Efm, Gg^Efm, Gs^Fms, Gs^Fms, Gll, Gs, Gg, Gg^Efm, Gs, Gs^Fms, Gs^Fms, Gs^Fms, Gs^Fms, Hh^Fms, Gs^Fms, Gs^Fms, Gs^Fms, Gs^Fms
Mm, Mm, Mm^Xm, Mm^Xm, Hh^Fms, Hh^Fms, Hh^Fms, Hh, Gs^Fms, Gg, Gg, Gg, Gg, Gg, Gg, Hh^Vud, Ww, Wwf, Wwf, Ww, Gg, Gg, Gs^Fms, Gg, Gg^Es, Gs, Gs, Gs, Gs, Gs, Gs, Gs, Gs, Gg, Gg, Gs, Gs, Gs^Fms, Gs^Fms, Gg, Gs, Gs, Gs^Fms, Gs^Fms, Hh^Fms, Hh^Fms, Mm, Hh^Fms, Hh^Fms, Gs^Fms, Hh^Fms
Mm, Mm, Mm, Mm, Hh^Fms, Hh^Fms, Gs^Fms, Gs^Fms, Ww, Gg, Ww, Gg, Wwf, Ww, Ww, Wwf, Wwf, Ww, Gg, Gg, Gg, Gg^Es, Gg, Gg, Gs, Gg^Es, Gg, Gg, Gg, Gg, Gg, Gg^Es, Gg, Gg, Gg^Es, Gg^Es, Gg^Es, Gg, Gg, Gg^Efm, Gg^Efm, Gg, Gll, Hh^Fms, Mm, Mm, Mm, Mm, Mm, Hh^Fms, Mm
Mm, Mm, Hh^Fms, Hh^Fms, Gs^Fms, Gs^Fms, Ww, Ww, Ww, Ww, Ww, Ww, Ww, Wwf, Ww, Ww, Gs, Gg, Gll, Gs, Gs^Fms, Gll, Gll, Gg, Gs, Gg, Gd^Fetd, Gg, Gs, Gs, Gg, Gg^Es, Gg^Es, Gg, Gg, Gg, Gg, Gg^Es, Gg, Gg^Es, Gg, Gg, Gs^Fms, Hh^Fms, Mm, Mm, Mm, Mm, Mm, Mm, Mm
Mm, Hh^Fms, Hh^Fms, Hh^Fms, Ww, Ww, Ww, Ww, Gs^Fms, Ww, Gll, Ww, Gs^Fms, Gg, Gg, Gs, Gs^Fms, Gs^Fms, Gs^Fms, Gs^Fms, Hh^Fms, Gs^Fms, Gs^Fms, Gg, Gg^Es, Gs, Gd, Gg^Ve, Gd^Fetd, Gg, Gd^Fetd, Gg^Es, Gg, Gg, Gs, Gg, Gs, Gs, Gs, Gg, Gg, Gs, Gs^Fms, Hh^Fms, Hh^Fms, Mm, Mm, Mm, Mm, Mm, Mm
Mm, Hh^Fms, Gs^Fms, Gs^Fms, Ww, Ww, Gg, Gg^Efm, Gs^Fms, Gll, Gs^Fms, Gs^Fms, Hh^Vud, Gs^Fms, Gs^Fms, Gs^Fms, Hh^Fms, Hh^Fms, Hh^Fms, Hh^Fms, Mm, Hh^Fms, Hh^Fms, Gs^Fms, Gd^Fetd, Gd^Es, Gd^Es, Gd, Gd, Gg^Es, Gg^Es, Gs, Gs^Fms, Gs^Fms, Gs^Fms, Gll, Gs^Fms, Gs^Fms, Gs^Fms, Gs^Fms, Gll, Gg, Gll, Gs^Fms, Hh^Fms, Mm, Hh^Fms, Mm, Mm, Mm, Mm
Mm, Hh^Fms, Gs^Fms, Ww, Ww, Ww, Gg^Efm, Gll, Gs^Fms, Gs^Fms, Hh^Fms, Hh^Fms, Hh^Fms, Hh^Fms, Hh^Fms, Hh^Fms, Mm, Mm, Mm, Mm, Mm, Mm, Hh^Fms, Gs^Fms, Gs^Fms, Gd^Es, Gd^Cov, Gd^Cov, Gd^Cov, Gd^Fetd, Gs^Fms, Gs^Fms, Hh^Fms, Hh^Fms, Hh^Fms, Gs^Fms, Hh^Fms, Hh^Fms, Hh^Fms, Hh^Fms, Hh^Fms, Gs^Fms, Gll, Gll, Gs^Fms, Hh^Fms, Gs^Fms, Hh^Fms, Hh^Fms, Mm, Mm
Hh^Fms, Hh^Fms, Gs^Fms, Ww, Ww, Ww, Gg, Gs^Fms, Hh^Fms, Hh^Fms, Mm, Mm, Mm, Mm, Mm, Mm, Mm, Mm, Mm^Xm, Mm, Mm, Mm, Mm, Hh^Vud, Gd^Cov, Gd^Cov, Gd^Cov, 2 Gd^Kov, Gd^Cov, Gd^Cov, Gs^Cov, Hh^Fms, Mm, Mm, Mm, Hh^Fms, Mm, Mm, Mm, Mm, Mm, Hh^Fms, Hh^Fms, Gll, Gll, Gs^Fms, Gs^Fms, Gs^Fms, Hh^Fms, Mm, Mm
Gs^Fms, Gs^Fms, Ww, Ww, Ww, Gg, Gll, Gs^Fms, Hh^Fms, Mm, Mm, Mm, Mm^Xm, Mm, Mm, Mm, Mm^Xm, Mm^Xm, Mm, Mm^Xm, Mm, Mm, Mm, Hh^Fms, Gll^Cov, Gd^Fetd, Gd^Fetd, Gd^Fetd, Gd^Fetd, Gd^Fetd, Hh^Cov, Hh^Fms, Mm, Mm, Mm, Mm, Mm, Mm, Mm^Xm, Mm^Xm, Mm, Mm, Hh^Fms, Gs^Fms, Gll, Gs^Fms, Gll, Gs^Fms, Gs^Fms, Hh^Fms, Hh^Fms
Gs^Fms, Ww, Ww, Ww, Gg^Efm, Gs^Fms, Gs^Fms, Gs^Fms, Hh^Fms, Mm, Mm, Mm, Mm^Xm, Mm, Mm^Xm, Mm, Mm, Mm, Mm, Mm^Xm, Mm, Mm, Mm, Hh^Fms, Hh^Fms, Hh^Cov, Hh^Cov, Hh^Cov, Hh^Cov, Gll^Cov, Hh^Fms, Mm, Mm, Mm, Mm^Xm, Mm, Mm, Mm^Xm, Mm, Mm, Mm, Mm, Hh^Fms, Gs^Fms, Gs^Fms, Gll, Gll, Gs^Fms, Gs^Fms, Gs^Fms, Gg
Gs^Fms, Ww, Ww, Gg^Efm, Gs^Fms, Gs^Fms, Hh^Fms, Hh^Fms, Mm, Mm, Mm, Mm^Xm, Mm, Mm^Xm, Mm, Mm, Mm, Mm, Mm, Mm^Xm, Mm, Mm, Mm, Mm, Mm, Mm, Mm, Mm, Hh^Fms, Hh^Fms, Mm, Mm, Mm, Mm^Xm, Mm, Mm, Mm, Mm, Mm^Xm, Mm, Mm, Mm, Hh^Fms, Hh^Fms, Hh^Fms, Gs^Fms, Gs^Fms, Gll, Gll, Gs^Fms, Gg
Ww, Ww, Ww, Gs^Fms, Gll, Gs^Fms, Hh^Fms, Mm, Mm, Mm, Mm, Mm, Mm^Xm, Mm^Xm, Mm, Mm, Mm, Mm, Mm, Mm^Xm, Mm, Mm, Mm, Mm, Mm, Mm, Mm, Mm, Mm, Mm, Mm, Mm, Mm, Mm^Xm, Mm, Mm, Mm, Mm, Mm, Mm, Mm, Mm, Mm, Mm, Mm, Hh^Fms, Gs^Fms, Gll, Gll, Gs^Fms, Gg
Ww, Ww, Ww, Gs^Fms, Gg, Gs^Fms, Hh, Mm, Mm, Mm, Mm, Mm, Mm^Xm, Mm, Mm, Mm, Mm, Mm, Mm, Mm, Mm, Mm, Mm, Mm, Mm, Mm, Mm, Mm, Mm, Mm, Mm, Mm, Mm, Mm, Mm, Mm, Mm, Mm, Mm, Mm, Mm^Xm, Mm, Mm, Mm, Mm, Hh^Fms, Gg, Gs^Fms, Gs^Fms, Gll, Gg
