Hh^Fms, Hh^Fms, Hh^Fms, Gg, Gg, Gg, Gg, Rrc, Rrc, Gg, Gs^Fms, Gs^Fms, Gs^Fms, Gg, Gll, Gg, Gll, Gg, Hh^Fms, Gg, Gg^Fms, Gg, Gg, Gg, Gs^Fms, Gs^Fms, Gs^Fms, Gg, Gs^Fms, Gg, Gs^Fms, Gg, Hh^Fms, Hh^Fms, Hh^Fms, Hh^Fms, Mm, Mm, Mm, Mm, Mm, Mm, Mm, Mm, Mm, Mm
Hh^Fms, Hh^Fms, Hh^Fms, Gs^Fms, Gs^Fms, Gll^Efm, Gg^Fet, Rrc, Rrc, Gg, Gg^Es, Gll, Gg, Gs^Fms, Gg^Fms, Gg^Fms, Hh, Hh^Fms, Hh, Hh^Fms, Hh, Gg^Fms, Gg^Fms, Gs^Fms, Gll, Gs^Fms, Gll^Efm, Gs^Fms, Gll, Gs^Fms, Hh^Fms, Hh^Fms, Hh^Fms, Hh^Fms, Mm, Mm, Mm, Mm, Mm, Mm, Mm, Mm, Mm^Xm, Mm^Xm, Mm, Mm
Hh^Fms, Hh^Fms, Hh^Fms, Hh^Fms, Gs^Fms, Gll, Gg, Rrc, Rrc, Gg^Es, Gs, Gg^Es, Gs, Re^Vct, Gg^Fms, Hh, Hh, Hh^Fms, Hh^Fms, Hh, Hh, Hh^Fms, Hh^Fms, Gs^Fms, Gs^Fms, Gll, Gll^Es, Gs^Efm, Gs, Gll^Efm, Hh^Fms, Hh^Fms, Mm, Mm, Mm, Mm, Mm, Mm, Mm, Mm, Mm, Mm^Xm, Mm, Mm, Mm, Mm
Hh^Fms, Hh^Fms, Hh^Fms, Hh^Fms, Gs^Fms, Gs^Fms, Gs^Es, Rrc, Rrc, Gg, Ce, Ce, Ce, Gg, Gg^Fms, Hh, Hh, Hh, Hh^Fms, Hh, Hh^Fms, Hh^Fms, Hh^Fms, Gg^Fms, Gs^Fms, Gs^Fms, Gs^Fms, Gs^Efm, Hh^Fms, Hh^Fms, Mm, Mm, Mm, Mm, Mm, Mm, Mm, Mm, Mm^Xm, Mm^Xm, Mm, Mm, Mm, Mm, Mm, Mm
Hh^Fms, Hh^Fms, Hh^Fms, Hh^Fms, Gll, Gs^Fms, Gll^Efm, Rrc, Rrc, Gs, Ce, 1 Ke, Ce, Gg, Gll, Gg^Fms, Gg^Fms, Hh^Fms, Hh, Hh^Fms, Hh^Fms, Hh^Fms, Hh^Fms, Gg^Fms, Gll, Gll^Efm, Gll^Efm, Hh^Fms, Hh^Fms, Mm, Mm, Mm, Mm, Mm, Mm, Mm, Mm^Xm, Mm^Xm, Mm, Mm, Mm, Mm, Mm, Mm, Mm, Mm
Mm, Hh^Fms, Gs^Fms, Gs^Fms, Gll, Gs^Es, Gg, Rrc, Rrc, Gg, Gg, Ce, Gs^Fms, Gs^Fms, Gs^Fms, Gll, Gll, Gg^Fms, Gs^Fms, Hh^Fms, Hh^Fms, Hh, Hh, Gg^Fms, Gs^Fms, Gg^Fet, Gll, Hh^Fms, Hh^Fms, Mm, Mm, Mm, Mm, Mm, Mm, Mm, Mm, Mm^Xm, Mm^Xm, Mm, Mm, Mm, Mm, Mm, Mm, Mm
Mm, Hh^Fms, Gs^Fms, Gg^Fet, Gll^Efm, Gs^Fms, Gg^Fet, Rrc, Rrc, Gg^Fet, Re^Vct, Gg, Gg, Gll, Gg^Efm, Gg^Efm, Gg^Efm, Gg^Fms, Gg^Fms, Hh^Fms, Gs^Fms, Hh, Gg^Fms, Gg^Fms, Gs^Fms, Gs^Fms, Gs^Fms, Hh^Fms, Hh^Fms, Mm, Mm, Mm, Mm, Mm, Mm, Mm, Mm, Mm, Mm, Mm^Xm, Mm^Xm, Mm, Mm, Mm, Mm, Mm
Mm, Hh^Fms, Hh^Fms, Gs^Fms, Gll, Gs^Efm, Gg^Fet, Rrc, Rrc, Rrc, Rrc, Rrc, Rrc, Gs, Rrc, Gg^Efm, Gg^Fet, Gg, Gg, Gg^Fms, Gg^Fms, Gg^Fms, Gg^Fms, Gll^Efm, Gll, Gs^Fms, Gll, Gs^Fms, Hh^Fms, Mm, Mm, Mm, Mm, Mm, Mm, Mm, Mm, Mm, Mm, Mm, Mm, Mm^Xm, Mm, Mm, Mm, Mm
Mm, Hh^Fms, Hh^Fms, Gs^Fms, Gs^Fms, Gs^Fms, Gs^Fms, Gg^Fet, Gll, Rrc, Rrc, Rrc, Rrc, Rrc, Rrc, Rrc, Rrc, Rrc, Rrc, Gll, Gg^Fet, Gg^Efm, Gs, Gs^Vh, Gg^Es, Gg, Gs^Fms, Gll, Hh^Fms, Mm, Hh^Fms, Mm, Mm, Mm, Mm, Mm, Mm, Mm, Mm, Mm, Mm, Mm^Xm, Mm, Mm, Mm, Mm
Mm, Mm, Mm, Hh^Fms, Hh^Fms, Gll, Gg^Ve, Gs^Fms, Gs^Fms, Gll, Gg^Efm, Gg^Fet, Gs, Rrc, Gg^Fet, Rrc, Rrc, Rrc, Rrc, Rrc, Rrc, Gg, Gs, Gs, Gg, Gll, Gs^Fms, Gll, Gs^Es, Hh^Fms, Gs^Fms, Hh^Fms, Hh^Fms, Mm, Mm, Mm, Mm, Mm, Mm, Mm, Mm, Mm^Xm, Mm^Xm, Mm, Mm, Mm
Mm, Mm, Mm, Mm, Mm, Hh^Fms, Hh^Fms, Gs^Fms, Gll, Gg, Gg, Gg^Efm, Gg^Efm, Gg^Efm, Gg, Gg, Gg^Fet, Gg, Gs, Rrc, Rrc, Rrc, Rrc, Gg^Fet, Gg^Fet, Gg, Gs^Fms, Gll, Gs^Fms, Gs^Fms, Gs^Fms, Gll, Gg^Fet, Hh^Fms, Mm, Mm, Mm, Mm, Mm, Mm, Mm, Mm^Xm, Mm^Xm, Mm, Mm, Mm
Mm, Mm, Mm, Mm, Mm, Mm, Mm, Hh^Fms, Gs^Fms, Gg^Fet, Gs^Fms, Gs^Fms, Hh^Fms, Gs^Fms, Hh^Fms, Gs^Fms, Hh^Fms, Gs, Gg, Gg^Efm, Gg^Fet, Rrc, Rrc, Rrc, Gg^Fet, Gg, Gll, Gs^Fms, Gs^Fms, Gg^Fet, Gs^Fms, Gll, Gs, Hh^Fms, Hh^Fms, Mm, Mm, Mm, Mm, Mm, Mm, Mm^Xm, Mm, Mm, Mm, Mm
Mm, Mm, Mm^Xm, Mm, Mm, Mm, Mm, Hh^Fms, Hh^Fms, Hh^Fms, Hh^Fms, Hh^Fms, Mm, Hh^Fms, Mm, Hh^Fms, Hh^Fms, Gs^Fms, Gs^Fms, Gs^Efm, Gs, Gg^Fet, Rrc, Rrc, Gg^Es, Gg^Efm, Gs^Fms, Gs^Fms, Gs^Fms, Gs^Fms, Gs^Fms, Gs^Fms, Hh^Fms, Hh^Fms, Mm, Mm, Mm, Mm, Mm, Mm, Mm^Xm, Mm, Mm^Xm, Mm, Mm, Mm
Mm, Mm, Mm^Xm, Mm, Mm, Mm, Mm, Mm, Mm, Mm, Mm, Mm, Mm, Mm, Mm, Mm, Mm, Hh^Fms, Hh^Fms, Gll, Gs, Gg^Fet, Rrc, Rrc, Gs, Gg, Gs^Fms, Gll, Gs^Es, Gg^Ve, Gs, Gs, Hh^Fms, Mm, Mm, Mm, Mm, Mm, Mm, Mm, Mm, Mm, Mm^Xm, Mm, Mm, Mm
Mm, Mm, Mm, Mm^Xm, Mm^Xm, Mm^Xm, Mm^Xm, Mm, Mm, Mm, Mm, Mm, Mm, Mm, Mm, Mm, Mm, Mm, Hh^Fms, Gs^Fms, Gg, Gg^Es, Rrc, Rrc, Gs, Gg^Es, Gs^Fms, Gll, Gll, Gs^Fms, Gs, Hh^Fms, Mm, Mm, Mm, Mm, Mm, Mm, Mm, Mm^Xm, Mm, Mm, Mm^Xm, Mm^Xm, Mm, Mm
Mm, Mm, Mm^Xm, Mm, Mm, Mm, Mm, Mm^Xm, Mm^Xm, Mm^Xm, Mm^Xm, Mm^Xm, Mm, Mm, Mm, Mm, Mm, Mm, Mm, Hh^Fms, Gs, Gs^Es, Rrc, Rrc, Gg, Gg, Gll, Gs^Fms, Gs^Fms, Gs^Fms, Hh^Fms, Hh^Fms, Mm, Mm, Mm, Mm, Mm^Xm, Mm^Xm, Mm, Mm, Mm, Mm, Mm^Xm, Mm, Mm, Mm
Mm, Mm, Mm, Mm, Mm^Xm, Mm, Mm^Xm, Mm, Mm^Xm, Mm^Xm, Mm, Mm^Xm, Mm, Mm, Mm, Mm, Hh^Ve, Hh^Fms, Hh^Fms, Hh^Fms, Gg, Gg, Rrc, Rrc, Gg^Efm, Gs^Fms, Gs^Fms, Gll, Gs^Fms, Gs^Fms, Hh^Fms, Mm, Mm, Mm, Mm, Mm, Mm^Xm, Mm, Mm, Mm, Mm, Mm, Mm^Xm, Mm, Mm, Mm
Mm^Xm, Mm^Xm, Mm, Mm^Xm, Mm, Mm^Xm, Mm, Mm^Xm, Mm, Mm, Mm, Mm, Mm, Mm, Hh^Fms, Hh^Fms, Hh^Fms, Hh^Fms, Gs^Fms, Gll, Gll, Gg^Fet, Rrc, Rrc, Gg, Gs^Fms, Gs^Fms, Gll, Gs^Fms, Gs^Fms, Hh^Fms, Mm, Mm, Mm, Mm, Mm, Mm, Mm^Xm, Mm, Mm, Mm, Mm, Mm^Xm, Mm, Mm^Xm, Mm
Mm, Mm, Mm^Xm, Mm, Mm, Mm, Mm, Mm, Mm, Mm, Mm, Mm, Hh^Fms, Mm, Hh^Fms, Hh^Fms, Gs^Fms, Gs^Fms, Gs^Fms, Gg, Gg^Fet, Gg^Fet, Rrc, Rrc, Gg^Fet, Gs^Efm, Gll^Efm, Gll, Gs^Fms, Gs, Hh^Ve, Mm, Mm, Mm, Mm, Mm, Mm, Mm^Xm, Mm, Mm, Mm, Mm, Mm^Xm, Mm^Xm, Mm, Mm
Mm, Mm, Mm, Mm, Mm, Mm, Hh^Ve, Hh^Fms, Hh^Fms, Hh^Fms, Hh^Fms, Hh^Fms, Hh^Fms, Hh^Fms, Gs^Fms, Gll, Gg, Gll^Efm, Gg, Gg, Rrc, Rrc, Rrc, Rrc, Gg^Fet, Gll, Gs^Fms, Gs^Fms, Gll, Gs^Fms, Gll, Hh^Fms, Hh^Fms, Mm, Mm, Mm, Mm, Mm, Mm, Mm, Mm, Mm, Mm^Xm, Mm^Xm, Mm, Mm
Mm, Mm, Mm, Mm, Hh^Fms, Hh^Fms, Hh^Fms, Hh^Fms, Gll, Hh^Fms, Gs^Fms, Gs^Fms, Gll, Gs^Fms, Gll, Gg, Gg^Fet, Gg, Rrc, Rrc, Rrc, Rrc, Gg, Gg^Fet, Gll, Gll, Gs^Fms, Gs, Gg, Hh^Fms, Hh^Fms, Hh^Fms, Hh^Fms, Hh^Fms, Hh^Fms, Hh^Fms, Hh^Fms, Hh^Fms, Mm, Mm, Mm, Mm, Mm, Mm, Hh^Fms, Mm
Mm, Mm, Mm, Hh^Fms, Gs^Fms, Gs^Fms, Gs^Fms, Gs^Fms, Gs^Fms, Gs^Fms, Gs^Efm, Gll, Gg, Gs^Fms, Gll, Gg^Fet, Rrc, Rrc, Rrc, Rrc, Gg^Efm, Gll^Efm, Gs^Fms, Gs^Fms, Gs^Fms, Gs^Fms, Hh^Fms, Gll, Hh^Fms, Hh^Fms, Hh^Fms, Hh^Fms, Hh^Fms, Hh^Fms, Hh^Fms, Hh^Fms, Hh^Fms, Hh^Fms, Hh^Fms, Hh^Fms, Hh^Fms, Mm, Mm, Mm, Hh^Fms, Hh^Fms
Mm, Mm, Hh^Fms, Hh^Fms, Gs^Fms, Gll, Gll, Gs^Fms, Gs^Es, Gg, Gg^Efm, Gs, Gs^Fms, Gs^Fms, Gg^Fet, Rrc, Rrc, Rrc, Gg, Gg, Gg^Efm, Gs^Fms, Hh^Fms, Hh^Fms, Hh^Fms, Hh^Fms, Mm, Hh^Fms, Mm, Hh^Fms, Hh^Fms, Hh^Fms, Hh^Fms, Hh^Fms, Hh^Fms, Hh^Fms, Hh^Fms, Hh^Fms, Hh^Fms, Gs^Fms, Gg^Fet, Hh^Fms, Hh^Fms, Hh^Fms, Gs^Fms, Gs^Fms
Mm, Mm, Hh^Fms, Hh^Fms, Gll, Gs^Fms, Gg, Gll, Gg, Gll^Efm, Gg, Gs^Fms, Gs, Gg, Rrc, Rrc, Rrc, Gg^Fet, Gg, Gg^Es, Gg, Gs^Fms, Hh^Fms, Mm, Mm, Mm, Mm, Mm, Mm, Hh^Fms, Hh^Fms, Hh^Fms, Hh^Fms, Hh^Fms, Hh^Ve, Hh^Fms, Hh^Fms, Hh^Fms, Hh^Fms, Gs^Fms, Hh^Fms, Gs^Fms, Gs^Fms, Gs^Fms, Gs^Fms, Gs^Fms
Hh^Fms, Hh^Fms, Gs^Fms, Gs^Fms, Gg^Fet, Gs^Fms, Gg^Ve, Gg^Efm, Gs^Fms, Gs, Gg^Efm, Gg, Rrc, Rrc, Rrc, Rrc, Gs^Fms, Gg, Gg, Gg, Gg, Hh^Fms, Mm, Mm^Xm, Mm^Xm, Mm, Mm, Mm, Mm, Mm, Hh^Fms, Hh^Fms, Hh^Fms, Hh^Fms, Hh^Fms, Hh^Fms, Hh^Fms, Hh^Fms, Mm, Hh^Fms, Mm^Xm, Hh^Fms, Hh^Fms, Gs^Fms, Gs^Fms, Gs^Fms
Hh^Fms, Gs^Fms, Gg^Fet, Gll, Gg^Es, Gg^Es, Gg, Gs^Fms, Gs^Fms, Gs, Gg^Fet, Rrc, Rrc, Rrc, Gg^Fet, Gs^Fms, Hh^Fms, Hh, Hh^Fms, Gg^Efm, Gll, Hh^Fms, Hh^Fms, Mm, Mm, Mm^Xm, Mm, Mm, Mm, Mm, Mm, Hh^Fms, Hh^Fms, Hh^Fms, Hh^Fms, Hh^Fms, Hh^Fms, Mm, Mm, Mm^Xm, Mm, Mm, Mm, Hh^Fms, Hh^Fms, Gs^Fms
Gg, Gg^Fet, Gll, Gll, Gg, Gs, Gs^Efm, Gs, Gs^Es, Gg, Gg^Fet, Rrc, Rrc, Gg^Fet, Gg^Fet, Hh, Hh^Fms, Hh^Fms, Hh^Ve, Gs^Fms, Gll, Gs^Fms, Gs^Fms, Hh^Fms, Mm, Mm, Mm^Xm, Mm^Xm, Mm, Mm, Mm, Hh^Fms, Hh^Fms, Hh^Fms, Hh^Fms, Hh^Fms, Hh^Fms, Mm, Mm, Mm, Mm, Mm, Mm, Mm, Mm, Hh^Fms
Gg, Gll, Gg^Fet, Gs^Fms, Gs^Fms, Gg^Fet, Gs^Fms, Gg^Efm, Gll, Gg, Gs, Rrc, Rrc, Rrc, Rrc, Gs, Gs^Fms, Hh, Hh, Gs^Fms, Gg^Efm, Gll, Gs^Fms, Hh^Fms, Mm, Mm^Xm, Mm, Mm, Mm, Mm, Mm, Hh^Fms, Hh^Fms, Hh^Fms, Hh^Fms, Hh^Fms, Hh^Fms, Hh^Fms, Hh^Fms, Mm, Mm, Mm, Mm^Xm, Mm^Xm, Mm, Hh^Fms
Hh^Fms, Gg^Fet, Hh^Fms, Hh^Fms, Hh^Fms, Hh^Fms, Hh^Fms, Gs^Fms, Hh^Fms, Gs^Fms, Gg, Gg^Fet, Gg^Efm, Rrc, Rrc, Rrc, Rrc, Gs^Fms, Gs^Fms, Gs^Fms, Gg, Gll^Efm, Gs^Fms, Hh^Fms, Hh^Fms, Mm, Mm, Mm, Mm, Mm, Mm, Hh^Fms, Hh^Fms, Hh^Fms, Hh^Fms, Hh^Fms, Hh^Fms, Hh^Fms, Hh^Fms, Mm, Mm, Mm, Mm, Mm, Hh^Fms, Hh^Fms
Mm, Hh^Fms, Mm, Mm, Mm, Mm, Mm, Hh^Fms, Mm, Hh^Ve, Gs^Fms, Gs, Gg^Efm, Gs, Gg^Fet, Rrc, Rrc, Rrc, Rrc, Gll, Gg^Fet, Gs, Gg, Gs^Fms, Gll^Efm, Hh^Fms, Hh^Fms, Hh^Fms, Hh^Fms, Hh^Fms, Hh^Fms, Hh^Fms, Gs^Fms, Hh^Fms, Hh^Fms, Hh^Fms, Hh^Fms, Hh^Fms, Hh^Fms, Hh^Fms, Mm, Mm, Mm, Mm, Hh^Fms, Gs^Fms
Mm, Mm, Mm, Mm, Mm, Mm, Mm, Mm, Mm, Hh^Fms, Gs^Fms, Gll, Gll, Gs, Gg^Efm, Gs, Gg^Fet, Rrc, Rrc, Rrc, Rrc, Gg^Fet, Rrc, Gs, Gg, Gs^Fms, Gs^Fms, Gs^Fms, Gs^Fms, Gs^Fms, Gll, Gs^Fms, Gll, Gg^Fet, Gs^Fms, Hh^Fms, Mm, Mm, Mm, Mm, Mm, Mm, Mm, Mm, Hh^Fms, Gs^Fms
Mm, Mm, Mm, Mm, Mm, Mm, Mm, Mm, Mm, Hh^Fms, Gs^Fms, Gs^Fms, Gs^Fms, Gs^Fms, Gll, Gg^Efm, Gg^Es, Gs, Gg^Efm, Rrc, Rrc, Rrc, Rrc, Rrc, Rrc, Gg^Fet, Gs^Efm, Gg, Gg^Efm, Gll^Efm, Gg^Efm, Gg^Efm, Gg^Efm, Gs^Fms, Hh^Fms, Hh^Ve, Mm, Mm, Mm^Xm, Mm^Xm, Mm, Mm, Mm, Mm, Hh^Fms, Gs^Fms
Mm, Mm, Mm^Xm, Mm^Xm, Mm^Xm, Mm, Mm, Mm, Mm, Hh^Fms, Hh^Fms, Hh^Fms, Hh^Fms, Hh^Fms, Hh^Fms, Gs^Fms, Gll, Gs, Gg, Gs, Gg^Fet, Rrc, Gg^Fet, Rrc, Rrc, Gg, Gg, Gg^Efm, Gs^Fms, Gll, Hh, Gs, Gg^Es, Gll^Es, Hh^Fms, Mm, Mm, Mm, Mm, Mm, Mm^Xm, Mm^Xm, Mm, Mm, Hh^Fms, Gs^Fms
Mm, Mm, Mm, Mm, Mm, Mm^Xm, Mm^Xm, Mm, Mm, Mm, Mm, Mm, Mm, Mm, Mm, Hh^Fms, Hh^Fms, Gs^Fms, Gg^Ve, Gg^Efm, Gg, Gg^Fet, Gll^Efm, Rrc, Rrc, Gg^Fet, Gg, Gs^Fms, Hh, Hh, Hh^Fms, Gg^Fms, Gs^Efm, Gs^Fms, Gs^Fms, Hh^Fms, Mm, Mm, Mm, Mm^Xm, Mm, Mm, Mm, Hh^Fms, Gll, Gs^Fms
Mm, Mm, Mm^Xm, Mm, Mm, Mm, Mm^Xm, Mm, Mm, Mm, Mm^Xm, Mm, Mm, Mm, Mm, Mm, Mm, Hh^Fms, Hh^Fms, Gs^Fms, Gs^Fms, Gs, Gg, Rrc, Rrc, Gg, Gs^Es, Gs^Fms, Gs^Fms, Hh^Fms, Hh^Ve, Hh^Fms, Gg, Gg, Gll, Hh^Fms, Hh^Fms, Mm, Mm, Mm, Mm, Mm^Xm, Mm, Hh^Fms, Gs^Fms, Gll
Mm, Mm, Mm, Mm^Xm, Mm, Mm, Mm, Mm^Xm, Mm, Mm^Xm, Mm^Xm, Mm, Mm, Mm, Mm, Mm, Mm, Mm, Hh^Fms, Hh^Fms, Gs^Fms, Gg, Gg^Fet, Rrc, Rrc, Gg^Fet, Gg, Gs, Gll, Hh, Hh, Hh^Fms, Gs^Efm, Gll^Efm, Gs^Fms, Gs^Fms, Gs^Fms, Hh^Fms, Hh^Fms, Hh^Fms, Hh^Fms, Mm, Hh^Fms, Hh^Fms, Gs^Fms, Gll
Mm, Mm, Mm^Xm, Mm, Mm, Mm, Mm, Mm, Mm, Mm, Mm^Xm, Mm, Mm, Mm, Mm, Mm, Mm, Mm, Hh^Fms, Hh^Fms, Gs^Fms, Gll, Rrc, Rrc, Rrc, Gg, Gs^Efm, Gg^Efm, Gg^Efm, Gs^Fms, Gll, Gg^Es, Gg, Gs^Fms, Gll, Gs^Fms, Gll, Gs^Fms, Gll, Hh^Fms, Gll, Hh^Fms, Gs^Fms, Hh^Fms, Gs^Fms, Gs^Fms
Mm, Mm, Mm, Mm^Xm, Mm, Mm, Mm, Mm, Mm^Xm, Mm^Xm, Mm, Mm, Mm, Mm, Mm, Mm, Mm, Mm, Hh^Fms, Gs^Fms, Gll, Gg^Efm, Rrc, Rrc, Gs, Gg^Efm, Gg^Efm, Gg^Efm, Gg, Gs^Fms, Gs^Fms, Gs^Fms, Gs^Fms, Gg^Fet, Gll, Gs^Fms, Gs^Fms, Gll^Efm, Gll^Efm, Gs^Fms, Gs^Fms, Gs^Fms, Gs^Fms, Gll, Gll, Gs^Fms
Mm^Xm, Mm, Mm, Mm^Xm, Mm^Xm, Mm, Mm^Xm, Mm^Xm, Mm, Mm, Mm, Mm, Mm, Mm, Mm, Mm, Mm, Hh^Fms, Gs^Fms, Gs^Fms, Gll, Gg^Fet, Rrc, Rrc, Gg, Gg^Efm, Gs, Gs, Gs^Fms, Gll, Hh^Fms, Hh^Fms, Hh^Fms, Gs^Fms, Gs, Gll^Efm, Gg, Gg^Es, Cv, Gs^Fms, Gg^Fet, Gs^Fms, Gs^Fms, Gs^Fms, Gs^Fms, Gs^Fms
Mm, Mm, Mm, Mm^Xm, Mm, Mm^Xm, Mm, Mm, Mm, Mm, Mm, Mm, Mm, Mm, Mm, Mm, Hh^Fms, Hh^Fms, Gs^Fms, Gll, Gg^Fet, Gg^Fet, Rrc, Rrc, Gg^Fet, Gg^Efm, Gs, Gs^Fms, Hh^Fms, Hh^Fms, Mm, Mm, Mm, Hh^Fms, Hh^Fms, Gll, Gs^Fms, Cv, Gg^Fet, Cv, Kv, Gg^Fet, Gll^Es, Gll^Es, Gs^Fms, Gll
Mm^Xm, Mm, Mm^Xm, Mm, Mm, Mm, Mm^Xm, Mm^Xm, Mm^Xm, Mm, Mm, Mm, Hh^Fms, Hh^Fms, Hh^Fms, Hh^Fms, Gll, Gs^Fms, Gg, Gg, Rrc, Rrc, Rrc, Rrc, Gg^Fet, Gg, Gg^Es, Gs^Fms, Hh^Fms, Mm, Mm, Mm, Mm, Mm, Hh^Fms, Gs^Fms, Gs^Fms, Cv, Cv, Cv, Cv, Gg^Fet, Gs^Fms, Gs^Fms, Gll, Gll
Mm, Mm, Mm, Mm, Mm^Xm, Mm^Xm, Mm, Mm^Xm, Mm, Mm, Mm, Hh^Fms, Hh^Fms, Hh^Fms, Gll, Gs^Fms, Gs, Gg^Efm, Gg, Rrc, Rrc, Rrc, Gg, Gg^Ve, Gg, Gg, Gs^Fms, Gll, Hh^Fms, Mm, Mm, Mm, Hh^Fms, Mm, Hh^Fms, Gll, Gs^Fms, Gg, Cv, Gg^Fet, Cv, Gll, Gg, Gll^Efm, Gs^Fms, Gg
Mm, Mm, Mm, Mm, Mm, Mm, Mm, Mm, Mm, Mm, Hh^Fms, Hh^Fms, Gs^Fms, Gs^Fms, Gg, Gs^Fms, Gs, Gg, Gg, Rrc, Rrc, Gg^Fet, Gg, Gg^Es, Gg, Gg, Gs, Gs^Fms, Gs^Fms, Hh^Fms, Hh^Ve, Hh^Fms, Gs^Fms, Hh^Fms, Gs^Fms, Gs^Fms, Gs^Fms, Gg, Gg^Es, Cv, Gll, Gs^Fms, Gs^Fms, Gll, Gs^Fms, Gg
Mm, Mm, Mm, Mm, Mm, Mm, Mm, Mm, Hh^Fms, Hh^Fms, Hh^Fms, Hh^Fms, Gll, Gs^Fms, Gd, Gs, Gg, Gg, Gg^Fet, Rrc, Rrc, Gg^Fet, Gg, Gg, Gg^Efm, Gg^Efm, Gg^Efm, Gs, Gg^Es, Gll, Gs^Fms, Gs^Fms, Gs, Gs^Fms, Gs, Gs^Fms, Gs, Gs, Gs^Efm, Gg, Gs^Es, Gg, Gg^Es, Gs^Fms, Gll, Gg
Mm, Mm, Mm, Mm, Hh^Fms, Hh^Fms, Hh^Ve, Hh^Fms, Hh^Fms, Hh^Fms, Gs^Fms, Gs^Fms, Gd^Cov, Gd^Cov, Gd^Cov, Gd, Gg^Es, Gg, Gg^Fet, Rrc, Rrc, Rrc, Rrc, Gg^Efm, Gg, Gg, Cv, Cv, Gg, Gg, Gll, Gll, Gg, Gg, Gg, Gg, Gg, Gg, Gg^Es, Gg, Gs^Fms, Gg^Es, Gll, Gg^Es, Gll, Gg
Mm, Mm, Hh^Fms, Hh^Fms, Gs^Fms, Hh^Fms, Gs^Fms, Gs^Fms, Gll, Gs^Fms, Gs^Es, Gd, Gd^Cov, Gd^Kov, Gd^Cov, Gd, Gs, Gg, Gg, Gg^Fet, Gg, Rrc, Rrc, Gg^Fet, Gg, Gg^Es, Gg^Efm, Cv, Gll, Gs^Fms, Hh^Ve, Hh^Fms, Gs, Gg^Efm, Gg^Efm, Gg^Fet, Gg^Es, Gg^Es, Gll, Gs^Fms, Gs^Fms, Gs^Fms, Hh^Fms, Gs^Fms, Gs^Fms, Gs^Fms
Mm, Mm, Hh^Fms, Hh^Fms, Ww^Ewf, Ww^Ewf, Ww, Ww^Ewf, Ww^Ewf, Gg, Gg^Es, Gd, Gs^Fms, Gd^Cov, Gd, Gd, Gs^Es, Gg, Gs, Gg, Gll, Rrc, Rrc, Rrc, Gg, Gg^Es, Gg, Gg^Efm, Gg, Gs^Fms, Gs^Fms, Hh^Fms, Gs, Gg, Gg, Gg, Gg^Es, Gs, Gs^Fms, Gll, Hh^Fms, Hh^Fms, Mm, Hh^Fms, Hh^Fms, Hh^Fms
Mm, Hh^Fms, Hh^Fms, Hh^Fms, Ww, Ww, Ww^Ewf, Ww, Ww^Ewf, Gll, Gs^Fms, Gs^Fms, Gs^Fms, Gll, Gs^Fms, Gs, Gs, Gg^Es, Gg, Gg, Gg, Gg^Fet, Rrc, Rrc, Rrc, Gg, Gg^Fet, Gll, Gg^Fet, Gg, Gg, Gs, Gg^Es, Gg, Gg^Efm, Gg^Fet, Gg, Gs, Hh^Fms, Hh^Fms, Mm, Mm, Mm^Xm, Mm^Xm, Mm, Mm
Mm, Mm, Hh^Fms, Hh^Fms, Gg^Ve, Gs^Fms, Gs^Fms, Ww^Ewf, Gs^Fms, Gs^Fms, Hh^Fms, Hh^Fms, Hh^Fms, Hh^Fms, Hh^Fms, Gs^Fms, Gs^Fms, Gs, Gs, Gg, Gg^Efm, Gll, Gg, Rrc, Rrc, Rrc, Rrc, Rrc, Rrc, Rrc, Rrc, Gg, Gg, Gg^Es, Gg, Gg^Efm, Gs, Gs^Fms, Hh^Fms, Mm, Mm, Mm, Mm, Mm, Mm^Xm, Mm
Mm, Mm, Mm, Hh^Fms, Hh^Fms, Gs^Fms, Hh^Fms, Gs^Fms, Hh^Fms, Hh^Fms, Mm, Mm, Mm, Hh^Fms, Mm, Hh^Fms, Hh^Fms, Gs^Fms, Hh^Fms, Gs^Fms, Gs, Gg^Es, Gs^Es, Gg, Gg, Rrc, Rrc, Rrc, Rrc, Rrc, Rrc, Rrc, Rrc, Gg^Fet, Gg, Gg^Efm, Gg^Es, Gg^Ve, Hh^Fms, Mm, Mm, Mm, Mm^Xm, Mm, Mm, Mm
Mm, Mm, Mm, Hh^Fms, Hh^Fms, Hh^Fms, Hh^Fms, Hh^Fms, Hh^Fms, Mm, Mm, Mm, Mm^Xm, Mm, Mm, Mm, Mm, Hh^Fms, Hh^Fms, Gs^Fms, Gs^Fms, Gs, Gg^Ve, Gg^Efm, Gg^Efm, Gg^Efm, Gg^Efm, Gg^Fet, Gll, Gg^Fet, Gs, Rrc, Rrc, Rrc, Rrc, Gg, Gg, Gs^Fms, Gs^Fms, Hh^Fms, Mm, Mm, Mm, Mm^Xm, Mm^Xm, Mm
Mm, Mm, Mm, Mm, Hh^Fms, Hh^Fms, Hh^Fms, Hh^Fms, Mm, Mm, Mm, Mm, Mm, Mm^Xm, Mm^Xm, Mm, Mm, Hh^Fms, Hh^Fms, Hh^Fms, Hh^Fms, Gs^Fms, Gs^Fms, Gg, Gs^Fms, Gs, Gg, Gg, Gg, Gg^Efm, Gg^Efm, Gg, Gg^Fet, Rrc, Rrc, Gg^Fet, Gg, Gll, Gs^Fms, Hh^Fms, Hh^Fms, Mm, Mm, Mm, Mm, Mm
Mm, Mm, Mm, Mm, Mm, Mm, Mm, Mm, Mm, Mm, Mm^Xm, Mm, Mm, Mm^Xm, Mm^Xm, Mm, Mm, Mm, Mm, Mm, Hh^Fms, Hh^Fms, Hh^Fms, Gs^Fms, Hh^Fms, Gs^Fms, Hh^Fms, Gs^Fms, Gs^Fms, Gs, Gg^Efm, Gll, Gg^Fet, Rrc, Rrc, Rrc, Rrc, Gs, Gs^Fms, Hh^Fms, Hh^Fms, Hh^Fms, Hh^Fms, Mm, Hh^Fms, Mm
Mm, Mm^Xm, Mm^Xm, Mm, Mm, Mm, Mm, Mm, Mm, Mm^Xm, Mm, Mm, Mm, Mm, Mm, Mm^Xm, Mm^Xm, Mm, Mm, Mm, Hh^Fms, Hh^Fms, Hh^Fms, Hh^Fms, Hh^Fms, Hh^Fms, Hh^Fms, Hh^Fms, Hh^Fms, Gs^Fms, Gs^Fms, Gs^Efm, Gg, Gg^Fet, Gs^Efm, Rrc, Rrc, Rrc, Rrc, Gs^Fms, Gs^Fms, Gs^Fms, Gs^Fms, Hh^Fms, Gs^Fms, Hh^Fms
Mm, Mm, Mm, Mm^Xm, Mm^Xm, Mm, Mm, Mm, Mm, Mm, Mm, Mm, Mm, Mm, Mm, Mm, Mm, Mm, Mm, Mm, Mm, Mm, Gg, Hh^Fms, Hh^Fms, Hh^Fms, Gg, Hh^Fms, Hh^Fms, Hh^Fms, Gg, Gg, Gg, Gs, Gg^Efm, Gg, Gg, Rrc, Rrc, Rrc, Gg, Gg, Gg, Gs^Fms, Gg, Gs^Fms
