Mm, Mm, Mm, Mm, Mm^Xm, Mm, Mm, Mm, Mm, Mm, Mm, Mm, Mm, Mm, Mm, Hh^Fms, Gs^Fms, Gg, Gll, Gs^Fms, Hh^Fms, Gg, Hh^Fms, Hh^Fms, Hh^Fms, Hh^Fms, Gs^Fms, Gll, Gs^Fms, Gg, Hh^Fms, Hh^Fms, Hh^Fms, Hh^Fms, Hh^Fms, Gg, Gs^Fms, Gg, Gg, Gg, Gs^Fms, Gg, Hh^Fms, Hh^Fms, Hh^Fms, Hh^Fms, Mm, Mm^Xm, Mm^Xm, Mm, Mm
Mm, Mm, Mm, Mm, Mm, Mm^Xm, Mm^Xm, Mm, Mm, Mm, Mm, Mm, Mm, Mm, Hh^Fms, Hh^Fms, Gs^Fms, Gll, Gg, Gs^Fms, Gs^Fms, Hh^Fms, Gs^Fms, Gs^Fms, Gs^Fms, Gs^Fms, Gs^Fms, Gll, Gs^Fms, Hh^Fms, Gs^Fms, Hh^Fms, Gs^Fms, Gs^Fms, Gs^Fms, Gll, Gg^Efm, Gs, Gg^Es, Gs, Gs^Fms, Hh^Fms, Hh^Fms, Hh^Fms, Mm, Mm, Mm^Xm, Mm^Xm, Mm^Xm, Mm, Mm
Mm, Mm, Mm, Mm, Mm, Mm^Xm, Mm^Xm, Mm, Mm, Mm, Mm, Mm, Mm, Hh^Fms, Gs^Fms, Gs^Fms, Gg^Ve, Gll^Es, Gs^Fms, Gg, Gll, Gs^Fms, Gs^Fms, Gs^Fms, Hh^Fms, Hh^Fms, Hh^Fms, Gs^Fms, Gll, Gll, Gg^Efm, Gs^Fms, Gg, Gll, Gs^Efm, Gg^Efm, Gs, Gg, Gll, Gs^Fms, Gs^Fms, Hh^Fms, Hh^Fms, Hh^Fms, Mm, Mm, Mm^Xm, Mm^Xm, Mm^Xm, Mm, Mm
Mm, Mm, Mm, Mm, Mm, Mm, Mm, Mm^Xm, Mm, Mm, Mm, Mm, Hh^Fms, Hh^Fms, Gs^Fms, Gs^Fms, Gll, Gs^Fms, Gg^Fet, Gll^Es, Gll^Es, Gs^Fms, Hh^Fms, Hh^Fms, Mm, Mm, Mm, Hh^Fms, Gs^Fms, Gg, Gg, Gs^Efm, Gll, Gs^Efm, Gs^Fms, Gg^Es, Gg, Gs^Fms, Gs^Fms, Gs^Fms, Gs^Fms, Hh^Fms, Hh^Fms, Hh^Fms, Mm, Mm, Mm^Xm, Mm^Xm, Mm^Xm, Mm, Mm
Hh^Fms, Mm, Mm, Mm, Mm, Mm, Mm, Mm^Xm, Mm^Xm, Mm, Mm, Mm, Hh^Fms, Gs^Fms, Gll, Gs, Gg^Efm, Gs^Fms, Gg, Gg^Es, Gs^Fms, Hh^Fms, Mm, Mm, Mm^Xm, Mm, Mm, Hh^Fms, Gll, Gs^Fms, Gs^Fms, Gg, Gll, Gs^Fms, Gs^Fms, Gs^Es, Gg, Gll, Ww, Ww, Ww, Gs^Fms, Ww, Hh^Fms, Hh^Fms, Mm, Mm^Xm, Mm^Xm, Mm, Mm, Mm
Gs^Fms, Hh^Fms, Hh^Fms, Mm, Mm, Mm, Mm, Mm, Mm^Xm, Mm, Mm, Mm, Hh^Fms, Gs^Fms, Gs^Fms, Gs^Efm, Gll^Efm, Gll, Gll, Gs^Fms, Gg^Ve, Hh^Fms, Mm, Mm, Mm, Mm, Hh^Fms, Hh^Fms, Gll^Es, Gll^Es, Gs^Fms, Gs^Fms, Gll, Gll^Es, Gg^Fet, Gg, Ww, Ww, Ww, Ww, Ww, Ww, Ww, Ww, Hh^Fms, Mm, Mm^Xm, Mm^Xm, Mm, Mm, Mm
Gg, Gs^Fms, Hh^Fms, Mm, Mm, Mm, Mm, Mm, Mm, Mm, Mm, Mm, Hh^Fms, Gs^Fms, Gg^Fet, Gg, Gg, Gs^Fms, Gll, Gs^Fms, Hh^Fms, Hh^Fms, Mm, Mm, Mm, Mm, Hh^Fms, Gs^Fms, Gll^Es, Gs^Fms, Gs^Fms, Gs^Fms, Gs^Fms, Gs^Fms, Gg^Ve, Ww, Ww, Ww, Gs^Fms, Gs^Fms, Gs^Fms, Ww, Hh^Fms, Ww, Ww, Ww, Mm^Xm, Mm, Mm, Mm, Mm
Gg, Gs^Fms, Gs^Fms, Hh^Fms, Hh^Fms, Hh^Fms, Hh^Fms, Mm, Mm, Mm, Mm, Mm, Hh^Fms, Gs^Fms, Gs^Fms, Gll, Gs^Fms, Gs^Fms, Gll, Gs^Fms, Hh^Fms, Mm, Mm, Mm, Mm, Mm, Hh^Fms, Gs^Fms, Gll, Gs^Fms, Gs^Fms, Gs^Fms, Ww, Gs, Ww, Ww, Ww, Gs^Fms, Gll^Efm, Gll, Gs^Fms, Hh^Fms, Hh^Fms, Mm, Mm, Mm^Xm, Mm^Xm, Mm, Mm, Mm, Mm
Rrc, Gg, Gs, Gs^Fms, Gs^Fms, Gs^Fms, Ce, Hh^Fms, Hh^Fms, Mm, Mm, Mm, Mm, Hh^Fms, Gs^Fms, Gll, Gs^Fms, Gll, Gg, Gs^Fms, Gg, Hh^Fms, Mm, Mm, Mm, Mm, Hh^Fms, Gs^Fms, Gg^Efm, Gg, Ww, Ww, Ww, Ww, Ww, Ww, Gg, Gg^Es, Gs^Fms, Gg^Ve, Hh^Fms, Hh^Fms, Hh^Fms, Mm, Mm, Mm^Xm, Mm^Xm, Mm^Xm, Mm, Mm, Mm
Rrc, Rrc, Rrc, Gg, Gg, Ce, 1 Ke, Ce, Hh^Fms, Mm, Hh^Fms, Mm, Hh^Fms, Hh^Fms, Gs^Fms, Gg, Gg^Es, Gg^Efm, Gs^Efm, Gs^Fms, Gs^Fms, Hh^Fms, Hh^Fms, Mm, Mm, Mm, Hh^Fms, Gg, Gs^Efm, Gg^Fet, Ww, Ww, Gs^Fms, Gs^Fms, Gll, Gs, Gg^Efm, Gs, Gg, Gs^Fms, Hh^Fms, Hh^Fms, Hh^Fms, Hh^Fms, Mm, Mm^Xm, Mm^Xm, Mm, Mm, Mm, Mm
Gg, Rrc, Rrc, Rrc, Rrc, Ce, Ce, Ce, Gs^Fms, Hh^Fms, Gs^Fms, Hh^Fms, Gs^Fms, Gs^Fms, Gs, Gg^Es, Gg, Gs, Gg, Gg, Gg, Gll, Gs^Fms, Hh^Fms, Hh^Fms, Hh^Fms, Gs^Fms, Gg, Ww, Ww, Ww, Ww, Hh^Fms, Hh^Fms, Hh^Fms, Gs^Fms, Gg^Efm, Gg^Fet, Gll, Gs^Fms, Gs^Fms, Hh^Fms, Hh^Fms, Hh^Fms, Mm, Mm^Xm, Mm^Xm, Mm^Xm, Mm, Mm, Mm
Gg, Gs, Gg^Efm, Rrc, Rrc, Rrc, Rrc, Gs^Es, Gg, Gs^Fms, Gll, Gll, Rrc, Gg, Rrc, Rrc, Rrc, Rrc, Rrc, Gs, Gg, Gs^Fms, Gg^Fet, Gll, Gs^Fms, Gs^Fms, Gg^Es, Ww, Ww, Ww, Gs^Fms, Hh^Fms, Mm, Mm, Hh^Fms, Gs^Fms, Gll, Gs^Fms, Gs^Fms, Gll, Gs^Fms, Gs^Fms, Hh^Ve, Mm, Mm, Mm^Xm, Mm^Xm, Mm^Xm, Mm, Mm, Mm
Gs^Fms, Gg, Gg, Re^Vct, Gs, Rrc, Rrc, Rrc, Rrc, Re^Vct, Rrc, Rrc, Rrc, Rrc, Rrc, Rrc, Rrc, Rrc, Rrc, Rrc, Rrc, Gg, Gg^Es, Gg, Gg, Gs^Fms, Gg, Ww, Ww, Gg^Es, Gs^Fms, Hh^Fms, Mm, Mm, Hh^Fms, Gs^Fms, Gll, Gs^Fms, Gs^Fms, Gll, Gll, Gs^Fms, Hh^Fms, Mm, Mm^Xm, Mm^Xm, Mm^Xm, Mm^Xm, Mm, Mm, Mm
Gg, Gs^Fms, Gs^Fms, Gs^Fms, Gg, Gg, Gg, Rrc, Rrc, Rrc, Rrc, Rrc, Gg, Rrc, Gll, Gg, Gs^Fms, Gg, Gg, Rrc, Rrc, Rrc, Gg^Ve, Gs^Es, Gg^Efm, Gg^Efm, Gg, Ww, Ww, Gg, Gs^Fms, Hh^Fms, Mm, Mm, Mm, Hh^Fms, Gs^Fms, Gll, Gg^Es, Gg, Gs^Fms, Hh^Fms, Hh^Fms, Mm, Mm^Xm, Mm^Xm, Mm^Xm, Mm, Mm, Mm, Mm
Gg, Gll, Gll, Gs^Fms, Gs^Fms, Gg^Efm, Gs^Es, Gg, Gg^Es, Rrc, Gs, Gg, Gs^Fms, Gs^Fms, Hh^Fms, Hh^Fms, Hh^Fms, Gs^Fms, Gs^Fms, Gg^Es, Rrc, Rrc, Rrc, Gs, Gs, Gg^Efm, Ww, Ww, Ww, Gs^Efm, Gll, Hh^Fms, Mm, Mm, Mm, Hh^Fms, Hh^Fms, Gs, Gg, Gs, Gs^Fms, Hh^Fms, Mm, Mm, Mm^Xm, Mm^Xm, Mm, Mm, Mm, Mm, Mm
Gs^Fms, Gg^Fet, Gs^Fms, Gs^Fms, Gll, Gg, Gg, Gs^Efm, Gg^Efm, Gg, Gg^Ve, Gs^Fms, Hh^Fms, Hh^Fms, Mm, Mm, Hh^Fms, Gll, Gg^Efm, Gg^Es, Gg, Rrc, Rrc, Gg, Gg^Efm, Gs, Ww, Ww, Gg, Gg, Gs^Fms, Hh^Fms, Mm, Mm^Xm, Mm, Hh^Fms, Hh^Fms, Gs^Fms, Gg, Gs, Cv, Kv, Mm, Mm^Xm, Hh^Fms, Mm^Xm, Hh^Fms, Mm, Hh^Fms, Mm, Mm
Gg, Gs^Fms, Gll, Gs^Fms, Gg, Gg^Es, Gg^Fet, Gg, Gll, Gs^Fms, Gs^Fms, Gs^Fms, Hh^Fms, Mm, Mm, Mm, Hh^Fms, Gs^Fms, Gg^Efm, Gs^Es, Gs, Rrc, Rrc, Gg, Rrc, Gg, Ww, Ww, Gg^Efm, Gg^Ve, Gs^Fms, Hh^Fms, Hh^Fms, Mm, Mm, Mm, Hh^Fms, Gg^Ve, Gs^Efm, Gg^Efm, Kv, Hh^Fms, Hh^Fms, Hh^Fms, Gg^Fet, Hh^Fms, Gg^Fet, Hh^Fms, Gg^Fet, Hh^Fms, Gg^Fet
Hh^Fms, Hh^Fms, Hh^Fms, Gll, Gs^Fms, Gll, Gg, Gs^Fms, Gg, Gll, Hh^Fms, Hh^Fms, Mm, Mm, Mm, Mm, Hh^Fms, Gll, Gg^Efm, Gs, Gg, Rrc, Rrc, Rrc, Rrc, Rrc, Ww^Bsb\, Ww, Gg, Gs^Efm, Gs^Efm, Gs^Fms, Gs^Fms, Hh^Fms, Hh^Fms, Hh^Fms, Gs^Fms, Gg, Gs, Gg, Gs, Cv, 3 Kv, Gg^Fet, Gg^Fet, Gg^Fet, Gg^Fet, Gg^Fet, Gg^Fet, Gg^Fet, Gg
Mm, Mm, Mm, Hh^Fms, Gll, Gs, Gg^Es, Gll, Gg, Gs^Fms, Hh^Fms, Mm, Mm, Mm, Mm, Mm, Hh^Fms, Gs^Fms, Gs^Fms, Gg, Gs, Gg, Gg, Rrc, Gg, Ww^Bsb\, Ww^Bsb\, Ww^Bsb\, Rrc, Gg, Gg, Gg, Gs, Gg, Gg, Gs^Fms, Gg, Gg^Es, Gg^Es, Gg, Gg, Gg, Rrc^Cov, Rrc, Rrc, Rrc, Rrc, Rrc, Rrc, Rrc, Rrc
Mm, Mm, Mm, Hh^Fms, Gs^Fms, Gg^Es, Gg, Gs^Fms, Gg, Gll, Hh^Fms, Mm, Mm, Mm, Mm^Xm, Mm^Xm, Mm, Hh^Fms, Hh^Fms, Gg, Gg, Gs, Gg, Gg, Ww, Ww, Ww, Rrc, Rrc, Rrc, Rrc, Gg, Rrc, Rrc, Rrc, Gg, Rrc, Rrc, Rrc, Rrc, Rrc, Rrc, Rrc^Cov, Rrc, Rrc, Rrc, Rrc, Rrc, Rrc, Rrc, Rrc
Mm, Mm, Mm, Hh^Fms, Gs^Fms, Gs, Gll^Es, Gs^Fms, Gg, Gll, Hh^Fms, Mm, Mm, Mm^Xm, Mm, Mm, Mm, Hh^Fms, Gll, Gs^Fms, Gg, Gg, Ww, Ww, Ww, Ww, Gs^Fms, Gg^Ve, Gg, Rrc, Rrc, Rrc, Rrc, Rrc, Rrc, Rrc, Rrc, Rrc, Rrc, Rrc, Rrc, Rrc, Kv, Gg^Fet, Gg^Fet, Gg^Fet, Gg^Fet, Gg^Fet, Gg^Fet, Gg^Fet, Gg
Gg, Mm, Mm, Hh^Fms, Hh^Ve, Gs^Fms, Gg, Gs^Es, Gg, Gs^Fms, Hh^Fms, Mm, Mm, Mm, Mm, Mm, Hh^Fms, Hh^Fms, Gs^Fms, Gll, Ww, Ww, Ww, Ww, Gg, Gs, Gll^Efm, Gg, Gg^Efm, Gs, Gg, Rrc, Gg^Fet, Gg^Fet, Gg^Fet, Rrc, Gg, Gg, Gg, Gs, Kv, Cv, Hh^Fms, Hh^Fms, Hh^Fms, Gg^Fet, Hh^Fms, Gg^Fet, Hh^Fms, Gg^Fet, Hh^Fms
Mm, Mm, Mm, Mm, Hh^Fms, Gg^Fet, Gll, Gg^Efm, Gs^Fms, Gll, Gs^Fms, Hh^Fms, Hh^Fms, Mm, Mm, Mm, Hh^Fms, Gs^Fms, Gs^Fms, Gg^Ve, Ww, Ww, Gs^Fms, Hh^Fms, Gs^Fms, Gg, Gg^Efm, Gs^Fms, Gll, Gs^Efm, Gs^Fms, Gg, Gll, Gg, Gg, Gs^Efm, Gg^Efm, Gg^Efm, Gg^Efm, Gg, Cv, Hh^Fms, Mm, Mm^Xm, Mm^Xm, Hh^Fms, Mm, Hh^Fms, Mm, Hh^Fms, Mm
Mm, Mm, Mm, Mm, Hh^Fms, Gs^Fms, Gg, Gs^Fms, Gs^Fms, Gll, Gs^Fms, Hh^Fms, Mm, Mm, Mm, Mm, Mm, Hh^Fms, Ww, Ww, Ww, Ww, Hh^Fms, Hh^Fms, Hh^Fms, Hh^Fms, Hh^Fms, Gg, Gg^Es, Gs^Fms, Gs^Fms, Gll, Gll, Gs^Fms, Gg, Gg, Gg, Gs, Gg^Efm, Gs^Fms, Gll, Kv, Mm, Mm^Xm, Mm^Xm, Mm^Xm, Mm, Mm, Mm, Mm, Mm
Hh^Fms, Mm, Mm, Mm, Mm, Hh^Fms, Gg, Gs^Efm, Gg, Gg, Gs^Fms, Hh^Fms, Mm, Mm, Mm, Mm, Mm, Hh^Fms, Ww, Ww, Gg^Efm, Gs^Fms, Hh^Fms, Hh^Fms, Hh^Fms, Hh^Fms, Gs^Fms, Gg, Gg^Efm, Gs^Fms, Hh^Fms, Hh^Fms, Hh^Fms, Gs^Fms, Gll, Gg^Efm, Gg, Gs^Es, Gg, Gs^Fms, Gll, Hh^Fms, Mm, Mm^Xm, Mm^Xm, Mm^Xm, Mm^Xm, Mm, Mm, Mm, Mm
Hh^Fms, Hh^Fms, Hh^Fms, Mm, Hh^Fms, Hh^Fms, Gg, Gs^Es, Hh^Ve, Gg, Gg^Es, Hh^Fms, Hh^Fms, Mm, Mm, Mm, Hh^Fms, Hh^Fms, Ww, Ww, Gg^Efm, Hh^Fms, Hh^Fms, Hh^Ve, Hh^Fms, Gs^Fms, Gs^Fms, Gg, Gll, Hh^Fms, Mm, Mm, Mm, Hh^Fms, Gs^Fms, Gs^Fms, Gs^Fms, Gg^Es, Gg^Es, Gs^Fms, Hh^Fms, Hh^Fms, Mm, Mm^Xm, Mm^Xm, Mm^Xm, Mm^Xm, Mm, Mm, Mm, Mm
Gs^Fms, Hh^Fms, Hh^Fms, Hh^Fms, Gs^Fms, Gg, Gs^Fms, Hh^Fms, Hh^Fms, Gs^Fms, Gg, Gs, Ww, Hh^Fms, Hh^Fms, Hh^Fms, Ww, Ww, Ww, Ww, Gs, Gs^Fms, Hh^Fms, Hh^Fms, Gs^Fms, Gll, Gll, Gs^Fms, Gll, Hh^Fms, Mm, Mm, Mm, Hh^Fms, Gll, Gs^Fms, Gs^Fms, Gll, Gs^Fms, Gg^Ve, Hh^Fms, Hh^Fms, Mm, Mm^Xm, Mm^Xm, Mm^Xm, Mm^Xm, Mm, Mm, Mm, Mm
Gs^Fms, Gll, Gs^Fms, Gs^Fms, Ww, Ww, Ww, Gll, Gs^Fms, Gll, Ww, Ww, Ww, Ww, Ww, Ww, Ww, Ww, Gs^Fms, Gs^Fms, Gg, Gg, Gll, Gs^Fms, Gll, Gll, Gg, Gll, Gs^Fms, Hh^Fms, Mm, Mm^Xm, Mm, Hh^Fms, Hh^Fms, Gll, Gs^Fms, Gll, Gs^Fms, Gs^Fms, Hh^Fms, Hh^Fms, Mm, Mm, Mm^Xm, Mm^Xm, Mm^Xm, Mm^Xm, Mm, Mm, Mm
Hh^Fms, Gs^Fms, Gll, Gs, Ww^Ewf, Ww^Ewf, Gg^Fet, Ww, Ww, Ww, Ww, Ww^Ewf, Gs^Fms, Ww, Ww, Ww, Gs^Fms, Gg, Gs, Gs^Fms, Gg, Gs, Gll, Gs^Fms, Gg, Gs, Gs^Fms, Gg, Gll, Hh^Fms, Hh^Fms, Mm, Mm^Xm, Mm, Hh^Fms, Gs, Gll, Gs^Fms, Hh^Fms, Hh^Fms, Hh^Fms, Hh^Fms, Mm, Mm, Mm^Xm, Mm^Xm, Mm^Xm, Mm^Xm, Mm, Mm, Mm
Mm, Hh^Fms, Hh^Fms, Gs^Fms, Ww^Ewf, Ww, Gg^Fet, Gg^Fet, Ww^Ewf, Ww^Ewf, Gg^Ve, Gg^Efm, Gs^Fms, Gs^Fms, Hh, Hh^Fms, Hh, Gs^Fms, Gd^Fetd, Gll, Gg, Gs^Fms, Gd, Gs, Gs, Gll, Gs, Gll, Gg, Gs^Fms, Hh^Fms, Mm, Mm, Mm, Hh^Fms, Gs^Fms, Gll, Gs^Fms, Gll^Efm, Hh^Fms, Hh^Fms, Hh^Fms, Mm, Mm, Mm^Xm, Mm^Xm, Mm^Xm, Mm, Mm, Mm, Mm
Mm, Mm, Hh^Fms, Gs^Fms, Gs^Fms, Ww, Ww, Ww^Ewf, Ww, Ww, Gs^Fms, Gll^Efm, Gll, Hh, Hh^Fms, Hh^Fms, Gd^Fetd, Gs^Fms, Gll, Gll, Gd^Fetd, Gg, Gd, Gg^Ve, Gs^Fms, Gs^Fms, Gd, Gs, Gll, Gll, Gll, Hh^Fms, Hh^Fms, Hh^Fms, Gg^Fet, Gs^Fms, Gg, Gs^Fms, Gll, Gs^Efm, Hh^Fms, Hh^Fms, Mm, Mm, Mm^Xm, Mm^Xm, Mm^Xm, Mm^Xm, Mm, Mm, Mm
Mm, Mm^Xm, Mm^Xm, Hh^Fms, Hh^Fms, Gll, Hh^Fms, Ww, Gll, Ww, Gg, Gg^Efm, Gd^Fetd, Gll, Gd^Fetd, Hh, Hh, Hh, Gg, Gd^Fetd, Gd, Gd, Gd, Gg, Gg, Gs^Fms, Gd, Gg, Gs^Fms, Gg, Gg, Gg, Gll, Gs^Fms, Gg, Gg^Efm, Gg^Efm, Gs^Fms, Gs^Fms, Hh^Fms, Hh^Fms, Hh^Fms, Hh^Fms, Mm, Mm^Xm, Mm^Xm, Mm^Xm, Mm^Xm, Mm, Mm, Mm
Mm, Mm, Mm, Mm^Xm, Mm, Hh^Fms, Mm, Hh^Fms, Hh^Fms, Gs^Fms, Gs^Fms, Gg, Gs^Fms, Gd^Fetd, Gll, Gs, Gll, Gd^Fetd, Gd^Cov, Gd, Gd, Gd, Gll, Gll, Hh^Fms, Gd, Hh^Fms, Gll, Gg, Gs^Fms, Gll, Gs^Fms, Gs^Fms, Gll, Gll^Efm, Gs, Gg^Efm, Gll, Gs^Fms, Hh^Fms, Hh^Fms, Hh^Fms, Hh^Fms, Mm, Mm, Mm^Xm, Mm^Xm, Mm^Xm, Mm, Mm, Mm
Mm, Mm, Mm^Xm, Mm, Mm, Mm, Mm, Mm, Mm, Hh^Fms, Hh^Fms, Gll, Hh^Fms, Hh^Fms, Hh^Fms, Gd^Fetd, Gd^Fetd, Gd^Cov, 2 Gd^Kov, Gd^Cov, Gd, Hh, Hh^Fms, Hh^Fms, Mm, Hh^Fms, Mm^Xm, Hh^Fms, Hh^Fms, Gs^Fms, Gll, Gg, Gs^Fms, Gs^Fms, Hh^Fms, Gg, Gg, Gs^Fms, Gll, Hh^Ve, Hh^Fms, Hh^Fms, Hh^Fms, Mm, Mm^Xm, Mm^Xm, Mm^Xm, Mm^Xm, Mm^Xm, Mm, Mm
Mm, Mm, Mm, Mm^Xm, Mm^Xm, Mm, Mm, Mm, Mm, Mm, Mm, Hh^Fms, Mm, Mm, Mm, Hh, Hh, Gd^Cov, Gll^Cov, Gd^Cov, Gd^Fetd, Gll, Hh^Fms, Mm, Mm, Mm, Mm, Mm, Hh^Fms, Gs^Fms, Gll, Gg^Fet, Gs^Fms, Gll, Hh, Gll, Gs^Fms, Gll, Gs^Fms, Gll, Hh^Fms, Hh^Fms, Hh^Fms, Mm, Mm, Mm^Xm, Mm^Xm, Mm^Xm, Mm^Xm, Mm, Mm
Mm, Mm, Mm, Mm, Mm, Mm, Mm, Mm, Mm, Mm, Mm^Xm, Mm, Mm, Mm, Mm, Mm, Hh, Gd, Gd, Gd^Fetd, Gll, Hh, Mm, Mm, Mm, Mm, Mm, Mm, Hh^Fms, Gs^Fms, Gs^Fms, Gg, Hh, Hh^Fms, Hh^Fms, Gg^Fms, Gs^Fms, Gg, Gs^Fms, Hh^Fms, Hh^Fms, Hh^Fms, Hh^Fms, Hh^Fms, Mm, Mm^Xm, Mm^Xm, Mm^Xm, Mm^Xm, Mm, Mm
Mm, Mm, Mm, Mm, Mm^Xm, Mm^Xm, Mm, Mm^Xm, Mm, Mm, Mm, Mm^Xm, Mm^Xm, Mm, Mm, Mm, Hh^Fms, Gg, Gs^Fms, Gd^Fetd, Gll, Hh^Fms, Mm, Mm, Mm, Mm, Mm, Mm, Mm, Hh^Fms, Gll, Gs^Fms, Hh, Hh^Fms, Hh^Fms, Hh, Gll, Gs, Gll, Hh^Fms, Hh^Fms, Hh^Fms, Hh^Fms, Hh^Fms, Mm, Mm, Mm^Xm, Mm^Xm, Mm^Xm, Mm^Xm, Mm^Xm
Mm, Mm, Mm, Mm, Mm, Mm, Mm, Mm, Mm, Mm, Mm, Mm, Mm^Xm, Mm, Mm, Mm, Mm, Hh^Fms, Gg, Gs^Fms, Gg, Hh^Fms, Mm, Mm, Mm, Mm, Mm, Mm, Mm, Hh^Fms, Gg, Gll, Gg, Hh, Hh, Hh, Gg, Gg, Gs^Fms, Hh^Fms, Hh^Fms, Hh^Fms, Hh^Fms, Hh^Fms, Gg, Mm, Gg, Mm^Xm, Mm^Xm, Mm^Xm, Gg
