Mm, Mm, Mm, Mm, Mm, Mm, Mm, Mm, Mm, Mm, Hh^Fms, Gs^Fms, Gs^Fms, Gg, Gg, Gg, Gs^Fms, Gg, Gs, Gg, Gg, Gg, Hh, Hh, Hh^Fms, Gg, Hh^Fms, Hh, Hh, Hh, Hh^Fms, Hh, Hh^Fms, Hh, Hh, Hh^Fms, Hh, Gg, Gs^Fms, Gs^Fms, Gs^Fms, Gs^Fms, Gg, Gg, Gs^Fms, Gg, Gg, Gg, Gs^Fms, Gg, Gg, Gg, Gg, Gs^Fms, Gs^Fms, Gg, Gg, Gs^Fms, Gg, Gg, Gg, Gg, Hh^Fms, Gg, Mm, Mm, Mm, Mm, Mm, Mm, Mm, Mm, Mm, Mm
Mm, Mm, Mm, Mm, Mm, Mm, Hh^Fms, Hh^Fms, Hh^Fms, Hh^Fms, Hh^Fms, Gs^Fms, Gs^Fms, Gll, Gs^Fms, Gs^Fms, Gs^Fms, Gs^Fms, Gs^Fms, Gs, Gg^Fms, Hh^Fms, Hh, Hh^Fms, Hh, Hh^Fms, Hh^Fms, Hh^Fms, Hh, Hh^Fms, Hh, Hh^Fms, Hh^Fms, Hh^Fms, Hh^Fms, Hh^Fms, Hh, Hh, Gs^Fms, Gs^Fms, Gs^Fms, Gs^Fms, Gs^Fms, Gs^Fms, Gg, Gs^Fms, Gs^Fms, Gg^Fet, Gg, Gs^Fms, Gs^Fms, Gs^Fms, Gs^Fms, Gs^Fms, Gs^Fms, Gs^Fms, Gg^Fet, Gs^Fms, Gs^Fms, Gs^Fms, Gs^Fms, Gs, Gg, Hh^Fms, Hh^Fms, Mm, Hh^Fms, Hh^Fms, Wwt, Mm, Mm, Mm, Mm, Mm
Mm, Mm, Mm, Mm, Hh^Fms, Mm, Hh^Fms, Hh^Ve, Gll, Hh^Fms, Gs^Fms, Gs^Fms, Gs^Fms, Gs^Fms, Gll, Gs^Fms, Gll, Gs^Fms, Gs^Fms, Gll, Hh^Fms, Hh, Hh^Fms, Hh, Gll, Gll, Gs^Fms, Gs^Fms, Gs, Gs^Fms, Gs^Fms, Hh^Fms, Gll, Hh, Gll, Hh^Fms, Hh, Gs^Fms, Gg^Fet, Gs^Fms, Gll, Gs^Fms, Gs^Fms, Gs^Fms, Gll, Gs, Gs^Fms, Gll, Gs^Fms, Gs^Fms, Gg^Fet, Gs^Fms, Gs^Fms, Gg^Fet, Gs^Fms, Gs^Fms, Gs^Fms, Gll, Gs^Fms, Gg^Fet, Gs^Fms, Gs^Fms, Gs, Hh^Fms, Hh^Fms, Hh^Fms, Hh^Fms, Hh^Fms, Wwt, Mm, Mm, Mm, Mm, Mm
Mm, Mm, Hh^Fms, Hh^Fms, Hh^Fms, Hh^Fms, Hh^Fms, Gll, Gg^Kov, Gs^Fms, Gg, Gs, Gll, Gs^Fms, Gg, Gs^Fms, Gs^Fms, Gs^Fms, Gs^Fms, Gll, Hh^Fms, Hh^Fms, Hh, Hh^Fms, Gs^Fms, Gs^Fms, Gs^Fms, Gll, Gg^Fet, Gll, Gg, Gs^Fms, Gs^Fms, Gs^Fms, Gs^Fms, Gs^Fms, Gll, Gs^Fms, Gs^Fms, Gs^Fms, Gs^Fms, Gll, Gg^Fet, Gs^Fms, Gs^Fms, Gg, Gs^Fms, Gs^Fms, Gs^Fms, Gs^Fms, Gll, Gll, Gs^Fms, Gg^Fet, Gs^Fms, Gll, Gs^Fms, Gs^Fms, Gg, Gs^Fms, Gs, Gg, Wwg, Gs, Wwg, Wwg, Wwg, Wwt, Hh^Fms, Hh^Fms, Hh^Fms, Mm, Mm, Mm
Mm, Mm, Hh^Fms, Hh^Fms, Gll, Gll, Gs^Fms, Gs^Kov, Gs^Kov, Gs^Kov, Gg^Fet, Gs^Fms, Gs^Fms, Gg^Fet, Gll, Gs^Fms, Gll, Gs^Fms, Gs^Fms, Gll, Gs^Fms, Hh, Hh^Ve, Gll, Gll, Gs^Fms, Gll, Gs^Fms, Gs^Fms, Gs^Fms, Gs^Fms, Gs^Fms, Gll, Gs^Fms, Gll, Gg^Fet, Gs^Fms, Gg, Gll, Gs^Fms, Gll, Gg, Gs, Gs^Fms, Gs^Fms, Gs^Fms, Gg^Fet, Gll, Gs^Fms, Gg, Gg^Ve, Gs^Fms, Hh^Fms, Gll, Gs^Fms, Gs^Fms, Gs, Gs, Wwt, Gg, Wwt, Wwt, Gs, Wwg, Gd^Kov, Gd^Kov, Gd^Kov, Gd^Fetd, Gd^Fetd, Hh^Fms, Hh^Fms, Mm, Mm, Mm
Mm, Mm, Hh^Fms, Hh^Fms, Gs^Fms, Gs^Fms, Gll, Gg^Kov, Gs^Kov, Gs^Kov, Gs^Fms, Gll, Gs^Fms, Gs, Gg, Gs^Fms, Gg^Fet, Gs^Fms, Gg^Efm, Gg, Gg^Fet, Gs^Fms, Gs^Fms, Gs^Fms, Gs^Fms, Gs^Fms, Gs, Gg, Gll, Gs^Fms, Gg, Gg^Fet, Gg^Efm, Gs^Fms, Gs^Fms, Gll, Gs, Gg, Gs^Fms, Gs^Fms, Hh^Ve, Gs^Fms, Gll, Gg, Gs^Fms, Gll, Gs^Fms, Gll, Gll, Hh^Fms, Hh^Fms, Hh^Fms, Hh^Fms, Gll, Gs^Fms, Gg, Wwt, Wwt, Gs, Wwt, Gg, Gs, Gd^Fetd, Gd^Fetd, Gd^Kov, 2 Gd^Kov, Gd^Kov, Gd^Fetd, Gll, Hh^Fms, Hh^Fms, Mm, Mm, Mm
Mm, Mm, Hh^Fms, Gll, Gs^Fms, Gs^Fms, Gs^Fms, Gs^Fms, Gll, Gs^Fms, Gs^Fms, Gll, Gs^Fms, Gs^Fms, Gg^Efm, Gs, Gg, Gg^Efm, Gs^Fms, Gs, Gs, Gg, Gll, Gll, Gs^Fms, Gll, Gs^Fms, Gs^Fms, Gs^Fms, Gs^Fms, Gll, Gs, Gs, Gll, Gs^Fms, Gs^Fms, Gs, Gs^Fms, Hh^Fms, Hh, Hh, Hh^Fms, Hh, Gs^Fms, Gg, Gll, Gg, Gs^Fms, Gg, Gs^Fms, Gg, Hh, Gg^Fet, Gs^Fms, Wwt, Wwt, Wwt, Gg, Gs^Fms, Gs^Fms, Gs^Fms, Gs^Fms, Gd^Fetd, Gd^Fetd, Gd, Gd^Kov, Gd, Gd^Fetd, Gs^Fms, Gll, Hh^Fms, Hh^Fms, Mm, Mm
Hh, Hh^Fms, Hh^Fms, Gg, Gs^Efm, Gg^Syt, Gs^Fms, Gs, Gg^Fet, Gs^Fms, Gs^Fms, Gs^Fms, Gg^Efm, Gg, Gs, Gs^Efm, Gg, Gs^Fms, Gll, Gs^Fms, Gs^Fms, Gs^Fms, Gg^Efm, Gs^Fms, Gll, Gs^Fms, Gg, Gll, Gs^Efm, Gs^Fms, Gg^Fet, Gs, Gs^Fms, Gg, Gg^Fet, Gs^Fms, Gg, Gg, Hh^Fms, Hh^Fms, Hh^Fms, Hh^Fms, Gs^Fms, Gs^Fms, Gg^Fet, Gs, Wwt, Gs, Wwt, Wwt, Wwt, Gg^Fet, Wwt, Wwt, Wwt, Wwt, Gs, Gll, Gs^Fms, Gll, Gll, Gs^Fms, Gs^Fms, Gd, Gd, Gd, Gd, Gd, Gll, Gs^Fms, Hh^Fms, Hh^Fms, Hh^Fms, Mm
Hh, Hh^Fms, Gg, Gg^Efm, Gs^Efm, Gs^Fms, Gs^Fms, Gll, Gg, Gs, Gg, Gg^Fet, Gg^Efm, Gg^Ve, Gg, Gg^Efm, Gg^Fet, Gs^Fms, Gg^Fet, Gll, Gs^Fms, Gll, Gg, Gll, Gs^Fms, Gg^Fet, Gs^Efm, Gg^Efm, Gs, Gg, Gg^Efm, Gg, Gg, Gs^Fms, Gs^Fms, Gs^Fms, Gg^Fet, Gll, Gs^Fms, Hh, Hh^Fms, Hh, Gs^Fms, Gll, Wwt, Wwt, Ww^Ewf, Wwt, Ww^Ewf, Wwt, Wwt, Wwt, Ww^Ewf, Ww^Ewf, Wwt, Wwt, Wwt, Gs^Fms, Hh^Fms, Gg^Fet, Hh, Gll, Gs^Fms, Gll, Gs, Gg, Gs^Fms, Gg, Gg, Gs^Fms, Gs^Fms, Gll, Hh^Fms, Hh^Fms
Gg, Gll, Gs^Fms, Gs^Fms, Gg, Gs^Fms, Gll, Gs^Fms, Gs^Fms, Gs, Gg, Gs^Fms, Gg^Efm, Gg, Gs, Gs^Efm, Gs^Efm, Gs^Fms, Gs^Fms, Gs^Fms, Gs^Fms, Gs^Fms, Gs, Gs^Fms, Gg, Gg, Gs, Gg^Efm, Gs^Fms, Gs^Fms, Gll, Gs^Fms, Gs^Fms, Gs^Fms, Gs^Fms, Gll, Gs, Gs^Fms, Gll, Hh^Fms, Gll, Gg, Gs^Fms, Gll, Wwt, Ww^Ewf, Wwt, Ww^Ewf, Wwt, Wwt, Gg^Fet, Wwt, Gs^Fms, Wwt, Wwt, Ww^Ewf, Wwt, Gll, Hh^Fms, Hh^Fms, Hh^Fms, Hh^Fms, Gs^Fms, Gs^Fms, Gg, Gs, Gs^Fms, Gll, Gg, Gll, Gs^Fms, Gll, Gs^Fms, Gg
Gg, Gs^Fms, Gs^Fms, Gll, Gs^Fms, Gg, Gs^Fms, Gg^Fet, Gs, Gs^Fms, Gs^Fms, Gg^Ve, Gs^Efm, Gg^Efm, Rrc, Gg, Gg^Ve, Gs^Fms, Gs^Fms, Gll, Gs, Gg, Gg^Efm, Gg^Efm, Gs, Gs, Gs^Fms, Gs^Fms, Gll, Gll, Gs^Fms, Gs^Fms, Gll, Gll, Gg, Gs^Fms, Gg, Gs^Fms, Gs^Fms, Gg, Gs, Gg, Gs^Fms, Gs^Fms, Gg, Wwt, Gs^Fms, Wwt, Wwt, Gg^Fet, Gs^Fms, Gs^Fms, Gg^Fet, Gs^Fms, Wwt, Ww^Ewf, Wwt, Gs^Fms, Gs^Fms, Hh^Ve, Hh^Fms, Gs^Fms, Gs^Fms, Gg^Syt, Gs, Gs, Gg, Gs^Fms, Gs^Fms, Gg, Gll, Gs^Fms, Gll, Gs^Fms
Gg, Gs^Fms, Gg^Fet, Gs^Fms, Gs^Fms, Gg, Gs, Gg^Efm, Gs^Efm, Gg, Gs^Fms, Gg, Gs, Gg, Rrc, Gg, Gg, Gll, Gs^Fms, Gg, Gg, Gs^Efm, Gg, Gg^Fet, Gs^Fms, Gs^Fms, Hh^Fms, Gll, Hh, Hh, Hh^Fms, Hh, Hh^Fms, Gll, Gs^Fms, Gg^Fet, Gs^Efm, Gg^Efm, Gs^Fms, Gg^Fet, Gg, Gs^Fms, Gg, Gll, Gs^Fms, Gs^Fms, Gg^Fet, Wwt, Ww^Ewf, Ww^Ewf, Wwt, Gg^Fet, Ww^Ewf, Gg^Fet, Wwt, Ww^Ewf, Ww^Ewf, Wwt, Wwt, Gs^Fms, Gs^Fms, Gll, Gs^Fms, Gs^Fms, Gg, Gg, Gll, Gs^Fms, Gs^Fms, Gg^Ve, Gg, Gg^Fet, Gs^Fms, Gg
Gs^Fms, Gs^Fms, Gll, Gg, Gs, Gg, Gs^Fms, Gs, Gs^Fms, Gg^Fet, Gs^Efm, Gg, Gs, Gg, Rrc, Gs, Gs, Gs^Fms, Gll, Gll, Gs^Fms, Gs^Fms, Gg, Gs^Fms, Gll, Hh^Fms, Hh^Fms, Hh, Hh, Hh^Fms, Hh^Fms, Hh^Fms, Hh, Gs^Fms, Gg^Efm, Gg^Efm, Gg, Gll^Efm, Gs^Fms, Gs^Fms, Gg, Gg^Fet, Gs^Fms, Gs, Gs^Fms, Gll, Hh^Fms, Hh, Hh, Ww^Ewf, Hh^Fms, Ww^Ewf, Wwt, Ww^Ewf, Wwt, Wwt, Wwt, Ww^Ewf, Ww^Ewf, Wwt, Wwt, Gs^Fms, Gs^Fms, Gll, Gll, Gs^Fms, Gs, Gg, Gll, Gg, Gs^Fms, Gs^Fms, Gs^Fms, Gs^Fms
Gg, Gs^Fms, Gll, Gg, Gg^Fet, Gs^Fms, Gs^Fms, Gs^Fms, Gs, Gg^Efm, Gg, Gs, Rrc, Rrc, Gg, Gs, Gg, Gs^Fms, Gs^Fms, Gs^Fms, Gs^Fms, Gll, Gg, Gg, Hh^Fms, Hh^Fms, Hh^Ve, Hh^Fms, Hh, Hh, Hh^Fms, Hh^Fms, Hh^Fms, Hh^Fms, Gs^Fms, Gs^Fms, Gs^Fms, Gs^Fms, Gs^Efm, Gs^Fms, Ww^Syt, Gs^Fms, Gs^Fms, Gg, Gll, Gs^Fms, Hh, Hh^Fms, Hh, Hh^Fms, Hh^Fms, Hh^Fms, Wwt, Wwt, Wwt, Ww^Ewf, Wwt, Wwt, Wwt, Wwt, Wwt, Gg^Fet, Gs^Fds, Gll, Gs^Fms, Gs^Fms, Gg^Fet, Gg, Gs^Fms, Gs^Fms, Gs^Fms, Gg^Fet, Hh, Gs^Fms
Gs^Fms, Gs^Fms, Gs^Fms, Gs^Fms, Gll, Gll, Gll, Gs^Fms, Gs, Gg^Efm, Gg^Efm, Rrc, Gg, Gg, Gs^Fms, Gs^Fms, Gs^Fms, Gs^Fms, Gs^Fms, Gs^Fms, Gll, Gs^Fms, Gs^Fms, Gll, Gs, Hh^Fms, Gs^Fms, Gs^Fms, Gs^Fms, Hh^Fms, Gll, Hh^Fms, Hh^Fms, Hh^Fms, Gs^Fms, Gs^Fms, Gll^Efm, Gg^Fet, Ww^Ii, Ww^Ii, Gll^Efm, Gll, Gs^Fms, Gg^Fet, Gs^Fms, Gg^Efm, Gg, Hh^Fms, Wwt, Wwt, Wwt, Wwt, Wwt, Ww^Ewf, Gs^Fms, Wwt, Wwt, Ww^Ewf, Ww^Ewf, Ww^Ewf, Ww^Ewf, Wwt, Gll, Gs^Fds, Gll, Gs^Fms, Gll, Gs^Fms, Gll, Gll, Hh, Hh^Fms, Hh^Fms, Hh
Gs^Fms, Gll, Gll, Gs^Fms, Gs^Fms, Gs^Fms, Gll, Gs^Fms, Gs, Gg, Gg^Efm, Rrc, Rrc, Gg, Gg, Gs^Fms, Gg^Fet, Gs^Fms, Gs^Fms, Gs^Fms, Gs^Fms, Gll, Gll, Gs^Fms, Gll, Gll, Gs^Fms, Gll, Gs^Fms, Gs^Fms, Gs^Fms, Gll, Hh^Ve, Hh, Gs, Gs^Fms, Gs^Fms, Ww^Ii, Ww^Ii, Gll^Efm, Gs^Efm, Ww^Syt, Ww^Ii, Gs^Fms, Gs^Fms, Gll^Efm, Gs^Fms, Wwt, Wwt, Ww^Ewf, Ww^Ewf, Wwt, Gs^Fms, Gg^Fet, Gs^Fms, Gs^Fms, Wwt, Wwt, Ww^Ewf, Wwt, Ww^Ewf, Wwt, Gll, Gs^Fds, Gs^Fms, Gs^Fms, Gll, Gs^Fms, Gs^Fms, Gs^Fms, Hh^Fms, Hh^Fms, Hh^Fms, Hh
Gg, Gs^Fms, Gll, Gs^Fms, Gg^Fet, Gs^Fms, Gs^Fms, Gg, Gs^Fms, Gs^Fms, Gs^Fms, Gs, Gg^Ve, Rrc, Gg^Efm, Gll, Gg, Gs^Fms, Gs^Fms, Gs^Fms, Gll, Gs^Fms, Gs^Fms, Gs^Fms, Gs^Fms, Gs^Fms, Gs^Fms, Gll, Gg, Gs, Gs^Fms, Gs^Fms, Gs^Fms, Gs, Gll, Gs^Fms, Gs^Fms, Gg^Fet, Gs^Fms, Ww^Syt, Gs^Efm, Gs^Efm, Ww^Ii, Ww^Ii, Gs, Gs^Fms, Ww^Ewf, Wwt, Wwt, Gg^Ve, Gs^Fms, Gs^Fms, Gs^Fms, Gg^Fet, Gs^Efm, Gs^Fms, Wwt, Wwt, Ww^Ewf, Ww^Ewf, Wwt, Gs^Fds, Gs^Fds, Gg^Fet, Gs^Fms, Gll, Gg^Ve, Gs^Fms, Gs^Fms, Hh, Hh^Fms, Hh, Hh^Fms, Hh^Fms
Gg, Gll, Gs^Fms, Gs^Fms, Gs^Fms, Gs^Fms, Gs^Fms, Gg, Gs^Fms, Gg^Fet, Gs^Fms, Gs, Gs, Rrc, Gg, Gll^Efm, Gs, Gs^Fms, Gs^Fms, Gll, Gs^Fms, Gs^Fms, Gs^Fms, Gs^Fms, Gg, Gs^Fms, Cv, Cv, Kv, Gs^Fms, Gs^Fms, Gs^Fms, Gs^Fms, Gs^Fms, Gs^Fms, Gs^Fms, Gll, Gs^Fms, Gll, Gll^Efm, Ww^Syt, Ww^Ii, Gs, Gll, Wwt, Wwt, Ww^Ewf, Ww^Ewf, Gs, Gs^Fms, Gs^Fms, Gs^Fms, Gs^Fms, Gll, Gg^Efm, Gg^Fet, Gg, Wwt, Wwt, Wwt, Wwt, Gg, Gll, Gs^Fms, Gll, Gs, Gs^Fms, Gs^Fms, Hh^Fms, Hh, Hh, Hh^Fms, Gs^Fms, Hh^Fms
Gs^Fms, Gs^Fms, Gll, Gs, Gs^Fms, Gll, Gs^Fms, Gg^Fet, Gg^Efm, Gs^Fms, Gg, Gs, Rrc, Rrc, Gs, Gg, Gg^Fet, Gs^Fms, Gll, Gs^Fms, Gg, Gg^Fet, Gg, Gg^Efm, Gs^Fms, Kv, Gg^Fet, Gg^Fet, Cv, Gg, Kv, Gg^Fet, Gg^Fet, Gll, Gll, Gs^Fms, Gs^Fms, Gs^Fms, Gg, Gs, Wwf, Gg^Efm, Ww^Ewf, Wwf, Wwt, Wwt, Gs^Fms, Gs^Fms, Cv, Cv, Kv, Cv, Cv, Gs^Fms, Gg^Efm, Gs^Fms, Gg, Gs, Gg, Gg^Fet, Gs, Gg^Fet, Gll, Gs^Fms, Gg^Efm, Gg, Gs^Fms, Gll, Gs^Fms, Hh^Fms, Hh^Fms, Hh^Fms, Hh, Hh
Gs^Fms, Gs, Gg, Gs^Fms, Gg^Fet, Gs^Fms, Gs^Fms, Gg^Efm, Gs^Efm, Gg, Rrc, Rrc, Gg, Gg, Gs, Gs^Fms, Gg, Gg, Gg, Gg, Gs^Fms, Gs^Fms, Gll^Efm, Gll^Efm, Gs^Fms, Cv, Gg^Fet, 5 Kv, Gg^Fet, Cv, Gg^Fet, Cv, Gs, Gg^Fet, Gg^Fet, Gs^Fms, Gs^Fms, Gs^Fms, Gs, Wwt, Wwt, Wwt, Gs^Fms, Gg, Gs^Fms, Gll, Gs^Fms, Cv, Gg^Fet, Gg^Fet, Cv, Gg^Fet, Gg^Fet, Cv, Gs^Fms, Gg^Fet, Gg, Gs^Fms, Gs^Fms, Gg^Fet, Gs^Fms, Gs^Fms, Gs^Fms, Gs^Fms, Gg^Efm, Gg^Efm, Gg, Gll, Gll, Gs^Fms, Gll, Hh, Hh^Fms, Hh
Gs^Fms, Gs^Fms, Gs^Fms, Gll, Gs^Fms, Gs^Fms, Gg, Gg, Gg, Rrc, Gs^Efm, Gg^Efm, Gg^Fet, Gg^Fet, Gs^Efm, Gg^Fet, Gg^Efm, Gg^Efm, Gll, Gs^Fms, Gg^Fet, Gll, Gs^Fms, Gg^Efm, Gs^Fms, Cv, Kv, Cv, Cv, Gg^Fet, Gg^Fet, Cv, Gs^Efm, Gs^Fms, Gs^Fms, Gs^Fms, Gg^Fet, Gll, Gg^Fet, Wwt, Ww^Ewf, Gg^Fet, Gs^Fms, Gs^Fms, Gg^Fet, Gs^Fms, Gg, Cv, Gg^Fet, Gg^Fet, Kv, Gg^Fet, Gg^Fet, Cv, Gg, Gs^Fms, Gs^Fms, Gs^Fms, Gs^Fms, Gs^Fms, Gs^Fms, Gs^Fms, Gg^Fet, Gg, Gg^Efm, Gg^Efm, Gs^Efm, Gg^Fet, Gs^Fms, Gs^Fms, Gs^Fms, Gll, Hh^Fms, Hh
Gs^Fms, Gg^Fet, Gll, Gll, Gs^Fms, Gg, Gs^Fms, Gg^Fet, Gs, Rrc, Rrc, Gg, Gg, Gs, Gs^Efm, Gg, Gg, Gs^Fms, Gll, Gs^Fms, Gs^Fms, Gg, Gll, Gg^Efm, Gs^Fms, Gs^Fms, Gs^Fms, Gs^Fms, Kv, Gg^Fet, Cv, Cv, Gs, Gll^Efm, Gs^Fms, Gs^Fms, Gg^Fet, Gs^Fms, Wwf, Ww^Ewf, Wwt, Gg^Fet, Gs^Fms, Gs^Fms, Gs^Fms, Gs^Fms, Gg, Cv, Kv, Cv, Gg^Fet, Cv, Kv, Cv, Rp, Gs, Gg^Efm, Gs^Fms, Gs^Fms, Gll, Gg, Gs^Fms, Gs, Gs^Efm, Gg, Gg, Gg, Gs^Efm, Gg^Ve, Gll, Gll, Gs^Fms, Gs^Fms, Hh^Fms
Gg, Gll, Gs^Fms, Gs^Fms, Gll, Gg^Fet, Gll, Gs^Fms, Gs, Gg, Gg, Rrc, Rrc, Gg, Gg, Gs, Gs^Fms, Gs^Fms, Gs^Fms, Gg^Ve, Gs^Fms, Gs^Fms, Gs^Fms, Gs^Fms, Gs^Fms, Gll, Gll, Gs^Fms, Gll, Cv, Gg, Rrc, Rrc, Gg^Efm, Gs^Fms, Gll, Ww^Ewf, Wwt, Gg^Fet, Ww^Ewf, Gg^Fet, Wwt, Wwt, Gs^Fms, Gg^Fet, Gg, Rrc, Rrc, Cv, Gg^Fet, Gg^Fet, Gg^Fet, Cv, Rrc, Rrc, Rp^Efm, Rp, Gs^Fms, Gg^Fet, Gll, Gg^Fet, Gs^Fms, Gg^Ve, Gs, Rrc, Rrc, Gs, Gg^Efm, Gg^Efm, Gs, Gg^Fet, Gs^Fms, Gs^Fms, Gs^Fms
Gg, Gll, Gs^Fms, Gs^Fms, Gs^Fms, Gll, Gs^Fms, Re^Vct, Gs^Fms, Gs^Fms, Gg, Gg^Fet, Rrc, Gg^Efm, Gg, Gs^Fms, Gg^Fet, Gll, Gs^Fms, Gg^Fet, Gs^Fms, Gll, Gll, Gs^Fms, Gll, Gs^Fms, Gs^Fms, Gs^Fms, Gs^Fms, Gll^Efm, Gs^Fms, Gs^Fms, Gg, Rrc, Wwt^Bsb\, Ww^Ewf, Gg^Fet, Gg^Fet, Gg^Fet, Wwt, Gg^Fet, Gg^Fet, Gg^Fet, Ww^Ewf, Wwt^Bsb/, Rrc, Gg^Fet, Gg, Gs^Fms, Cv, Cv, Cv, Gs^Fms, Rp, Rp, Rrc, Rp, Gs^Fms, Gll, Gll, Gs^Fms, Gs^Fms, Gg^Fet, Gg, Rrc, Gg^Ve, Gs^Efm, Gg^Efm, Gg^Fet, Gll, Gll, Gll, Gll, Gs^Fms
Gg, Gs^Fms, Gs^Fms, Gs^Fms, Ce, Ce, Ce, Gs^Fms, Gs, Gg, Rrc, Rrc, Gs, Gg, Gs^Efm, Gs^Fms, Gs^Fms, Gll, Gll, Gll, Gg, Gs, Gs^Fms, Gg^Fet, Gs, Gll, Gll, Gs^Fms, Gg^Ve, Gs^Fms, Gll, Gs^Fms, Ww^Ewf, Wwt, Gg^Fet, Rrc, Gg^Fet, Gg^Ve, Ww^Ewf, Ww^Ewf, Ww^Ewf, Gg^Ve, Gg^Fet, Rrc, Gg^Fet, Wwt, Ww^Ewf, Gg, Gg^Fet, Gs^Fms, Gll, Gs^Fms, Gs^Fms, Gg, Rp, Rrc, Rp, Gs^Fms, Gs^Fms, Gll, Gs^Fms, Gs^Fms, Gs^Fms, Gg, Gg, Rrc, Gg, Gg, Gs^Fms, Gs^Fms, Gs^Fms, Gs^Fms, Gll, Gg
Gg, Gs^Fms, Gs, Gs^Fms, Ce, 1 Ke, Ce, Gs, Rrc, Rrc, Gg, Gg, Gs, Gg^Efm, Gs, Gg, Gg, Gs^Fms, Gs^Fms, Gs^Fms, Gg, Gs^Fms, Gs, Gs^Fms, Gg, Gs^Fms, Gs^Fms, Gs^Fms, Gs^Fms, Gs^Fms, Gg^Fet, Ww^Ewf, Ww^Ewf, Gg^Ve, Gg^Fet, Rrc, Wwt^Bsb\, Ww^Ewf, Cv^Efm, Kv, Cv^Efm, Wwt, Wwt^Bsb/, Rrc, Gg^Fet, Gg^Fet, Ww^Ewf, Ww^Ewf, Gs^Fms, Gs^Fms, Gs^Fms, Gll, Gs^Fms, Gs^Fms, Rp, Rrc, Rp, Gg^Fet, Gs^Fms, Gs^Fms, Gs^Fms, Gg^Fet, Gs^Fms, Gs^Fms, Gg^Fet, Rrc, Gg^Fet, Gs^Fms, Gll, Gll^Kov, Gs^Fms, Gs^Fms, Gs^Fms, Gg
Gg, Gs, Gg^Fet, Gg, Gg^Fet, Ce, Gg^Fet, Gg, Rrc, Gs, Gg^Fet, Gg, Gg^Fet, Gg, Gg^Fet, Gs, Gg^Fet, Gs, Gg^Fet, Gg, Gg^Fet, Gs, Gg^Fet, Gs, Gg^Fet, Gg, Gg^Fet, Gg, Gg^Fet, Gg, Rrc, Ww^Ewf, Gg^Fet, Wwt, Wwt, Wwt, Cv^Efm, Cv^Efm, Gg^Syt, Cv^Efm, Gg^Syt, Cv^Efm, Cv^Efm, Wwt, Wwt, Wwt, Gg^Fet, Ww^Ewf, Rrc, Gs^Fms, Gg^Fet, Gs^Fms, Gg^Fet, Gg, Rp, Rrc, Rp, Gg, Gg^Fet, Gs^Fms, Gg^Fet, Gs^Fms, Gg^Fet, Gg, Rrc, Rrc, Gg, Gs^Fms, Gs^Kov, Gs^Kov, Gs^Kov, Gll, Gll, Gg
Rrc, Rp, Rrc, Rp, Rrc, Rp, Rrc, Rp, Rrc, Rp, Rrc, Rp, Rrc, Rp, Rrc, Rp, Rrc, Rp, Rrc, Rp, Rrc, Rp, Rrc, Rp, Rrc, Rp, Rrc, Rp, Rrc, Rrc, Gg^Fet, Wwt^Bsb\, Rrc, Rrc, Wwt^Bsb\, Kv, Gg^Syt, Gg^Syt, Cv^Efm, Cv^Efm, Cv^Efm, Gg^Syt, Gg^Syt, Kv, Wwt^Bsb/, Rrc, Rrc, Wwt^Bsb/, Gg^Fet, Rrc, Rrc, Rp, Rrc, Rp, Rrc, Rrc, Rrc, Rp, Rrc, Rp, Rrc, Rp, Rrc, Rrc, Gg^Fet, Gll, Gs, Gs^Kov, Gs^Kov, Gg^Kov, Gs^Kov, Gll^Kov, Gs^Fms, Gg
Rrc, Rrc, Rrc, Rrc, Rrc, Rrc, Rrc, Rrc, Rrc, Rrc, Rrc, Rrc, Rrc, Rrc, Rrc, Rrc, Rrc, Rrc, Rrc, Rrc, Rrc, Rrc, Rrc, Rrc, Rrc, Rrc, Rrc, Rrc, Rrc, Rrc, Gg^Fet, Ww^Ewf, Rrc, Gg^Fet, Wwt^Bsb/, Cv, Gg^Syt, Gg^Syt, Cv^Efm, Kv, Cv^Efm, Gg^Syt, Gg^Syt, Cv^Efm, Wwt^Bsb\, Gg^Fet, Rrc, Wwt, Gg^Fet, Rrc, Rrc, Rrc, Rrc, Rrc, Rrc, Rrc, Rrc, Rrc, Rrc, Rrc, Rrc, Rrc, Rrc, Gg^Fet, Gg^Fet, Gs, Gg, Gg, Gg^Kov, Gs^Kov, Gs^Fms, Gs^Fms, Gs^Fms, Gg
Gg, Rp, Gg^Fet, Rp, Gg^Fet, Rp, Gg^Fet, Rp, Gg, Rp, Gg^Fet, Rp, Gg^Fet, Rp, Rrc, Rp, Gg^Fet, Rp, Gg^Fet, Rp, Gg^Fet, Rp, Gg^Fet, Rp, Gg^Fet, Rp, Gg^Fet, Rp, Gg^Fet, Rrc, Rrc, Wwt^Bsb/, Gg^Fet, Rrc, Wwt, Kv, Cv^Efm, Gg^Syt, Gg^Syt, Cv^Efm, Gg^Syt, Gg^Syt, Cv^Efm, Kv, Wwt, Rrc, Gg^Fet, Wwt^Bsb\, Rrc, Rrc, Gg^Fet, Rp, Gg^Fet, Rp, Rp, Rrc, Rp, Rp, Gg^Fet, Rp, Gg^Fet, Rp, Gg^Fet, Rrc, Rrc, Rrc, Rrc, Gg^Fet, Gg, Gs, Gs^Fms, Gll, Gll, Gg
Gg, Gs^Fms, Gs^Fms, Gs^Fms, Gs^Fms, Re^Vct, Gll, Gs^Fms, Hh^Fms, Gll, Hh^Fms, Gs^Fms, Hh, Gs, Gs, Rrc, Gs, Gs^Fms, Hh, Gs^Fms, Hh^Fms, Gs^Fms, Hh, Gll, Gg^Efm, Gs, Gs^Fms, Gll, Gg, Gs, Gg^Fet, Ww^Ewf, Wwt, Ww^Ewf, Gg^Fet, Ww^Ewf, Wwt^Bsb/, Cv^Efm, Cv^Efm, Cv^Efm, Cv^Efm, Cv^Efm, Wwt^Bsb\, Wwt, Gg^Fet, Wwt, Wwt, Ww^Ewf, Gs, Gs, Gs^Fms, Gs^Fms, Gs^Fms, Gs, Rp, Rrc, Rp, Gg, Gs^Fms, Gs^Fms, Gs^Fms, Gs^Fms, Gs^Fms, Gs, Gs, Gg^Fet, Gg, Rrc, Gs, Gs^Efm, Gs^Fms, Gll, Gs^Fms, Gs^Fms
Gs^Fms, Gll, Gs^Fms, Hh, Hh, Hh, Hh^Fms, Hh^Fms, Hh^Fms, Hh^Fms, Gs^Fms, Hh^Fms, Hh^Fms, Hh^Fms, Gg, Rrc, Gs^Efm, Gs^Fms, Hh, Hh^Fms, Hh^Fms, Hh^Fms, Hh^Fms, Gs^Fms, Gg, Gs^Efm, Gs^Fms, Gs^Fms, Gs^Fms, Gs, Wwt, Ww^Ewf, Ww^Ewf, Gg^Ve, Gg^Fet, Rrc, Gg^Fet, Wwt, Ww^Ewf, 4 Kv, Wwt, Wwt, Gg^Fet, Rrc, Gg^Fet, Gg^Ve, Ww^Ewf, Ww^Ewf, Gs^Fms, Gs^Fms, Gs^Fms, Gs^Fms, Gs^Fms, Gg, Rp, Rrc, Rp, Gll, Gg, Gg, Gg, Gll, Gll, Gs^Fms, Gs^Fms, Gg, Gg^Fet, Rrc, Gg, Gs^Efm, Gs^Fms, Gg, Gs^Fms, Gg
Gg, Gll, Gs^Fms, Hh^Fms, Hh^Fms, Hh^Fms, Hh^Fms, Hh^Fms, Hh^Fms, Hh, Gg^Efm, Gs^Fms, Gg, Gs, Rrc, Rrc, Gg^Efm, Hh^Fms, Hh^Fms, Hh^Fms, Hh^Fms, Gll, Gll, Gs^Fms, Gll, Gs^Efm, Gll, Gs^Fms, Wwt, Wwt, Ww^Ewf, Wwt, Gs^Fms, Wwt, Ww^Ewf, Rrc, Gg^Fet, Gg^Ve, Gg^Fet, Ww^Ewf, Gg^Fet, Gg^Ve, Gg^Fet, Rrc, Ww^Bsb\, Ww^Ewf, Gs, Gg, Gs^Fms, Gs^Fms, Gg^Fet, Gs^Fms, Gll, Gg, Cv, Rrc, Cv, Gg^Fet, Cv, Kv, Gs, Gg, Gs^Fms, Gs^Fms, Gs, Gs, Rrc, Rrc, Gg, Gs^Efm, Gs^Fms, Gg^Fet, Gs^Fms, Gg
Gg, Gs^Fms, Gs^Fms, Hh, Hh^Fms, Hh^Fms, Gs^Fms, Gs^Fms, Gs^Efm, Gs^Efm, Rrc, Rrc, Rrc, Rrc, Gg, Gg^Efm, Gs^Fms, Gs^Fms, Hh^Ve, Hh, Gll, Gs^Fms, Gs^Fms, Gs^Fms, Gg^Fet, Gg^Fet, Wwt, Ww^Ewf, Wwt, Ww^Ewf, Gg, Gs^Fms, Gg^Fet, Gg, Gg^Fet, Wwt^Bsb|, Ww^Ewf, Gg^Fet, Gg^Fet, Ww^Ewf, Gg^Fet, Gg^Fet, Wwt, Ww^Ewf, Gg, Rrc, Gs^Efm, Gg^Fet, Gs^Fms, Gs^Fms, Gs^Fms, Gs^Fms, Gg, 6 Kv, Gg^Fet, Cv, Gg^Fet, Kv, Gg, Gg, Gs^Fms, Gg^Ve, Gll, Gll, Gs^Fms, Gg, Rrc, Gg^Fet, Gll, Gs^Fms, Gs^Fms, Gs^Fms, Gs^Fms, Gg
Gg, Gg^Fet, Gll, Gs^Fms, Gs^Fms, Gs^Fms, Gll, Gg, Rrc, Rrc, Gg^Efm, Gg^Fet, Gg, Gg, Gs^Fms, Gll, Gg^Fet, Gll, Gg, Gs, Gs^Fms, Gs^Fms, Gs^Fms, Gll, Gg^Fet, Wwt, Wwt, Ww^Ewf, Gg^Fet, Gg, Gs^Fms, Gs^Fms, Cv, Kv, Cv, Rrc, Gg^Fet, Ww^Ewf, Wwt, Ww^Ewf, Ww^Ewf, Wwt, Gs^Fms, Gs, Gs, Rrc, Rrc, Gg, Gs, Gs^Fms, Gs, Gg, Gg^Fet, Cv, Cv, Gg^Fet, Gg^Fet, Cv, Gg^Fet, Gg, Gs^Fms, Gs^Fms, Gs^Fms, Gs^Fms, Gs^Fms, Gg^Fet, Rrc, Gg^Fet, Gg, Gg^Fet, Gs^Fms, Gg, Gs^Fms, Gg
Gg, Gs^Fms, Gll, Gll, Gs^Fms, Gll, Gg^Fet, Rrc, Gg^Efm, Gg^Efm, Gg^Fet, Gg, Gg^Efm, Gg, Gs, Gs^Fms, Gll, Gs^Fms, Gs^Fms, Gs^Fms, Gs^Fms, Gll, Gs^Fms, Gll, Gg, Ww^Ewf, Wwt, Gg^Fet, Gs^Fms, Gs^Fms, Gll, Gg, Cv, Gg^Fet, Cv, Rrc, Gg^Efm, Gg^Efm, Gg, Ww^Ewf, Wwt, Gll, Gs^Fms, Gs^Fms, Gs^Fms, Gs^Efm, Gs, Rrc, Rrc, Gg, Rrc, Rrc, Rrc, Rrc, Cv, Gg^Fet, Cv, Cv, Gg^Efm, Gg, Gll, Gll, Gll, Gll, Gg, Gg, Rrc, Gg^Fet, Gs, Gs^Fms, Gs^Fms, Gg^Fet, Gs^Fms, Gg
Gs^Fms, Gs^Fms, Gs^Fms, Gs^Fms, Gs, Gg^Fet, Rrc, Rrc, Gg^Efm, Gg^Efm, Gg^Fet, Gg^Fet, Gg, Gg^Efm, Gs, Gs^Fms, Gs^Fms, Gll, Gll, Gs^Fms, Gg^Fet, Gll, Gll, Gs^Fms, Gs, Wwt, Wwt, Gs^Fms, Gg^Fet, Gg^Efm, Gll, Kv, Gg^Fet, Kv, Gg^Fet, Kv, Gs^Efm, Gg^Fet, Gs, Wwt, Ww^Ewf, Wwt, Ww^Ewf, Gs^Fms, Gg^Fet, Gll^Efm, Gs^Fms, Gs, Gg, Rrc, Gll, Gg, Gs, Gll, Gll, Kv, Gg^Fet, Gg, Gg^Efm, Gg, Gs^Fms, Gs^Fms, Gs^Fms, Gs^Fms, Gll, Gs, Gg^Fet, Rrc, Gs, Gs^Fms, Gs^Fms, Gll, Gll, Gg
Gg, Gs^Fms, Gg^Fet, Gs, Gs, Gg, Rrc, Gg, Gg^Efm, Gg, Gg, Gg, Gs^Fms, Gg^Efm, Wwt, Gs, Gg, Gs, Gll, Gs^Fms, Gs^Fms, Gg^Fet, Gs^Fms, Gs^Fms, Gs, Ww^Ewf, Wwt, Gs^Fms, Gs^Fms, Gll^Efm, Gs^Fms, Kv, Cv, Cv, Cv, Kv, Gg^Efm, Gs^Fms, Gs^Fms, Gg, Gg^Ve, Ww^Ewf, Wwt, Wwt, Wwt, Gll, Gll, Gs^Fms, Gll, Rrc, Gg, Gs^Fms, Gs^Fms, Gg, Gg, Cv, Gg, Gg^Fet, Gll, Gs^Fms, Gll, Gll, Gs^Fms, Gs^Fms, Gs^Fms, Gg, Gs, Rrc, Gs, Gs^Fms, Gs^Fms, Gll, Gs, Gs^Fms
Gs^Fms, Gs^Fms, Gs^Efm, Gg, Gg^Efm, Gg, Rrc, Gg, Gg^Efm, Gg^Efm, Gg^Fet, Gs^Fms, Gg^Fet, Gs^Fms, Wwt, Wwt, Wwt, Gs^Fms, Gs, Gs^Fms, Gs^Fms, Gs^Fms, Gs^Fms, Gll, Gg^Fet, Ww^Ewf, Wwt, Gg^Ve, Gs^Fms, Gll, Gs^Fms, Gg, Cv, Gg^Fet, Cv, Gll, Gg^Efm, Gs^Fms, Gs^Fms, Gg^Fet, Gs^Fms, Gs^Fms, Gs^Fms, Wwt, Ww^Ewf, Wwt, Gg^Fet, Gs^Fms, Gll, Rrc, Gll, Gg^Fet, Gs^Fms, Gg, Gs, Kv, Gg^Efm, Gg^Efm, Gs^Fms, Gs^Fms, Hh^Fms, Hh, Hh, Hh, Gs^Fms, Gs^Fms, Gs^Fms, Rrc, Gg^Fet, Gg, Gs, Gs^Fms, Gg^Fet, Gg
Gg, Gs^Fms, Gs^Efm, Gg^Ve, Gg^Efm, Gg, Gg, Gg, Gg^Efm, Gg^Ve, Gs^Fms, Gs^Fms, Gg, Wwt, Ww^Ewf, Ww^Ewf, Ww^Ewf, Wwt, Wwt, Gs, Gs, Gs^Fms, Gll, Gll, Gg^Fet, Wwt, Wwt, Gg^Fet, Gs^Fms, Gs^Fms, Gll, Gs^Fms, Gg, Kv, Gg, Gg^Efm, Gs^Fms, Gll, Gll, Gs^Fms, Gll, Gll, Gg^Fet, Gs, Ww^Ewf, Wwt, Gll, Gs^Fms, Gll, Rrc, Gll, Gs^Fms, Gs^Fms, Gs^Fms, Gs, Gg, Gg, Gs^Fms, Gll, Hh^Fms, Hh, Hh^Fms, Hh^Fms, Hh^Fms, Gs^Fms, Gs^Fms, Gll, Rrc, Rrc, Gg, Gg^Fet, Gs^Fms, Gs^Fms, Gg
Gs^Fms, Gs^Fms, Gs, Gs^Efm, Gs^Efm, Gg^Efm, Gg^Efm, Gg^Efm, Gs, Gs, Gs^Fms, Gs^Fms, Gs^Fms, Wwt, Wwt, Wwt, Gs^Fms, Ww^Ewf, Ww^Ewf, Wwt, Gs, Gg^Fet, Gg^Fet, Gg, Gg^Ve, Wwt, Ww^Ewf, Gg^Fet, Gg^Fet, Gs^Fms, Gll, Gs^Fms, Gs, Gs^Efm, Gg^Efm, Gs, Gg^Fet, Gs^Fms, Gs^Fms, Gs^Fms, Gs^Fms, Gs, Gs^Fms, Gs, Wwt, Wwt, Gs^Fms, Gs^Fms, Gg, Rrc, Rrc, Gg, Gs, Gg^Fet, Gs, Gg, Gs^Fms, Gs^Fms, Gll, Hh^Fms, Hh^Fms, Hh^Fms, Hh, Hh, Gll, Gs^Fms, Gs^Fms, Gll, Gg^Fet, Rrc, Gg, Gs^Fms, Gs^Fms, Gg
Gg^Fet, Gs^Fms, Gg^Fet, Gs, Gg^Fet, Gg^Ve, Gg, Gs^Efm, Gg^Fet, Gs, Gll, Gg^Fet, Gs^Fms, Wwt, Wwt, Gs^Fms, Gs^Fms, Wwt, Ww^Ewf, Wwt, Wwt, Gs, Ww^Ewf, Wwt, Wwt, Ww^Ewf, Wwt, Wwt, Gs, Gll, Gs^Fms, Gs^Fms, Gg, Gs, Gg^Ve, Gg^Efm, Gll, Gs^Fms, Gs^Fms, Gll, Gll, Gs^Fms, Gg^Fet, Gs^Fms, Wwt, Wwt, Gg^Fet, Gg, Gg^Fet, Gg^Ve, Rrc, Gg, Gg, Gs^Efm, Gg^Efm, Gg, Gg, Gs^Fms, Gg^Ve, Gs^Fms, Hh^Fms, Hh, Gs^Fms, Gg^Fet, Gg, Gs^Fms, Gs^Fms, Gs^Fms, Gg, Rrc, Gll, Gg^Fet, Gll, Gg
Gs^Fms, Gll, Gs^Fms, Gs^Fms, Gs^Fms, Gs, Gs, Gs, Gs^Fms, Gs^Fms, Gs^Fms, Gs^Fms, Gs^Fms, Ww^Ewf, Ww^Ewf, Gs^Fms, Wwt, Wwf, Ww^Ewf, Wwt, Ww^Ewf, Wwf, Wwt, Ww^Ewf, Wwt, Ww^Ewf, Wwt, Wwt, Gg, Gs^Fms, Gs^Fms, Gll, Hh, Hh^Fms, Hh^Fms, Hh^Fms, Hh^Fms, Hh, Hh^Fms, Gs^Fms, Gll, Gs^Fms, Gs^Fms, Gll, Wwt, Wwt, Gs^Fms, Gs^Fms, Gs, Gg, Gs, Rrc, Rrc, Gg^Efm, Gg, Gll^Efm, Gg, Gs, Gs^Fms, Gs^Fms, Gg, Gs^Fms, Gg, Gs^Fms, Rrc, Gs, Gg, Gll, Rrc, Rrc, Gg^Fet, Gs^Fms, Gll, Gg
Gll, Gs^Fms, Gs^Fms, Gs^Fms, Gg^Fet, Gs^Fms, Gs, Gs^Fms, Gll, Gg^Fet, Wwt, Wwt, Wwt, Wwt, Ww^Ewf, Wwt, Wwt, Wwt, Ww^Ewf, Gg^Fet, Gs^Fms, Ww^Ewf, Ww^Ewf, Ww^Ewf, Gs^Fms, Ww^Ewf, Ww^Ewf, Wwf, Wwt, Gg^Fet, Wwt, Gs^Fms, Hh^Fms, Hh^Fms, Hh^Fms, Hh^Fms, Gll, Hh^Fms, Gs^Fms, Gs^Fms, Gll, Gs^Fms, Wwt, Ww^Ewf, Ww^Ewf, Ww^Ewf, Gs, Gs^Fms, Gs, Gs, Gs^Efm, Gg, Gll, Rrc, Rrc, Gg, Gll, Gg, Gg^Efm, Gg^Efm, Gg^Efm, Gg, Rrc, Rrc, Gg^Fet, Rrc, Rrc, Rrc, Gs, Gs, Gs^Fms, Gll, Gs^Fms, Gg
Gs^Fms, Gll, Gll, Gs^Fms, Gll, Gs^Fms, Gs, Gs, Wwt, Wwt, Gg^Ve, Wwt, Gll, Gg, Gs^Fms, Ww^Ewf, Wwt, Wwt, Ww^Ewf, Ww^Ewf, Gs^Fms, Gs^Fms, Gs^Efm, Gs^Fms, Gs^Fms, Gs^Efm, Gg^Fet, Ww^Ewf, Wwt, Wwt, Wwt, Gs^Fms, Gs^Fms, Hh^Fms, Gs^Fms, Gs^Fms, Wwt, Gg^Fet, Wwt, Gg^Fet, Wwt, Wwt, Wwt, Ww^Ewf, Gs^Fms, Gs, Gs^Fms, Gll, Gll, Gs^Fms, Gs^Fms, Gll^Efm, Gg^Efm, Gs, Rrc, Gg, Gll, Gs, Gs, Gs, Gs, Gg^Ve, Gg, Gs, Gs^Fms, Gg, Gg, Gg, Gs^Fms, Gs^Fms, Gll, Gs^Fms, Gs^Fms, Gg
Gll, Gs^Fms, Gs^Fms, Gs^Fms, Gs^Fms, Gs, Gg, Gs, Wwt, Gs, Gll, Gs^Fms, Gs^Fms, Gg^Fet, Gs^Fms, Gg, Gg^Efm, Wwt, Ww^Ewf, Ww^Ewf, Ww^Ewf, Gg^Fet, Ww^Ewf, Gg^Fet, Ww^Ewf, Gs^Fms, Gg^Fet, Ww^Ewf, Ww^Ewf, Wwt, Ww^Ewf, Wwt, Wwt, Gs^Fms, Wwt, Wwt, Ww^Ewf, Wwt, Wwt, Ww^Ewf, Ww^Ewf, Ww^Ewf, Gg, Gs^Fms, Gs, Gs^Fms, Gg^Fet, Gs^Fms, Gll, Gg^Fet, Gll, Gll, Gs, Gg^Efm, Gg, Rrc, Gs, Gs, Gs, Gs^Fms, Gs^Fms, Gs, Gs^Fms, Gs^Fms, Gg^Fet, Gs^Fms, Gll, Gs, Gg^Fet, Gll, Gg^Fet, Gs^Fms, Gll, Gg
Gs^Fms, Gll, Gll, Gs^Fms, Gs^Fms, Gll, Gll, Wwt, Gs^Fms, Gll, Gs^Fms, Gs^Fms, Gs^Fms, Gll, Gs^Fms, Gg^Efm, Gg^Efm, Gg, Wwt, Ww^Ewf, Ww^Ewf, Wwt, Ww^Ewf, Ww^Ewf, Wwt, Gs^Efm, Gs^Fms, Gs^Fms, Ww^Ewf, Wwt, Wwt, Wwt, Ww^Ewf, Wwt, Wwt, Ww^Ewf, Gg, Wwt, Gs, Gg^Fet, Gg^Efm, Gg^Efm, Gg, Gg^Fet, Gg, Gll, Gs^Fms, Gg, Gs^Fms, Gs^Fms, Gs^Fms, Gs^Fms, Gs^Fms, Gs, Gg, Rrc, Rrc, Gg, Gg^Efm, Gs, Gs, Gg^Fet, Gs, Gg, Gll, Gs^Fms, Gs^Fms, Gg, Gg, Gs^Fms, Gll, Gs^Fms, Gg, Gg
Gll, Gs^Fms, Gs^Fms, Gg^Fet, Gs^Fms, Gs^Fms, Gs, Wwt, Gs^Fms, Gs^Fms, Gll, Gll, Gs^Fms, Gg^Fet, Gs, Gs^Fms, Gs^Fms, Gg^Efm, Gg, Wwf, Gg, Wwt, Wwt, Wwf, Ww^Ewf, Ww^Ewf, Ww^Ewf, Gs^Fms, Wwf, Ww^Ewf, Wwt, Wwt, Ww^Ewf, Wwt, Gs, Gg^Efm, Gg^Fet, Gs, Gg, Gs, Gs^Fms, Gs^Fms, Gs, Gs^Fms, Gs^Fms, Gs, Gll, Gg, Gg, Gll, Hh, Gll, Gll, Gs^Fms, Gg, Gg^Efm, Gg^Efm, Gg^Ve, Gs, Gs^Efm, Gg^Efm, Gs, Gg, Gs^Fms, Gs^Fms, Gg, Gll, Gs^Fms, Gg, Gg, Gs^Fms, Gll, Gs, Gs
Hh^Fms, Gs^Fms, Gs^Fms, Gs^Fms, Gs^Fms, Gll, Gs^Fms, Wwt, Wwt, Gs^Fms, Gs^Fms, Gs, Gd^Fetd, Gs, Gg, Gs, Gd, Gd^Fetd, Gs^Fms, Gg, Gs^Fms, Gg^Fet, Gs^Fms, Gs, Wwf, Wwt, Wwt, Ww^Ewf, Ww^Ewf, Wwt, Ww^Ewf, Wwt, Wwt, Gs, Gs^Efm, Gg^Efm, Gs^Fms, Gs^Fms, Gs^Fms, Gs^Fms, Gs^Fms, Gll, Gs, Gs^Fms, Gs^Fms, Gs^Fms, Hh, Gs, Hh^Fms, Hh, Hh^Fms, Hh, Hh, Gs^Fms, Gll, Gs^Fms, Gg^Fet, Gs^Efm, Gg, Gg, Gg^Efm, Gg^Ve, Gg^Fet, Gs^Fms, Gs^Fms, Gg, Gs^Fms, Gs^Fms, Gg^Fet, Gs^Fms, Gg, Gg, Hh^Fms, Hh^Fms
Hh^Fms, Hh^Fms, Hh^Fms, Gs^Fms, Gs^Fms, Gs^Fms, Gs^Fms, Gll, Wwt, Gll, Gs^Fms, Gs, Gd^Fetd, Gd^Fetd, Gd^Kov, Gd, Gd, Gd^Fetd, Gs^Fms, Gs^Fms, Gll, Gs^Fms, Gll, Gs^Fms, Gs, Wwf, Wwt, Ww^Ewf, Wwf, Ww^Ewf, Gg^Fet, Wwt, Gs, Gs^Efm, Gs^Fms, Gs^Fms, Gs^Fms, Gs^Fms, Gll, Gs^Fms, Gll, Gg, Gs^Fms, Gs^Fms, Hh, Hh, Hh^Fms, Hh, Hh^Fms, Hh^Fms, Hh^Fms, Hh^Fms, Hh, Hh^Fms, Gll, Gs^Fms, Gs^Fms, Gg^Efm, Gg^Efm, Gg^Efm, Gs^Efm, Gg, Gs^Fms, Gs^Fms, Gll, Gg^Fet, Gs^Fms, Gs, Gs^Fms, Gll, Gs^Fms, Gs, Hh^Fms, Mm
Mm, Hh^Fms, Hh^Fms, Gs^Fms, Hh^Fms, Hh^Fms, Gs^Fms, Wwt, Gg^Ve, Gll, Gs^Fms, Gs, Gd, Gd^Kov, 3 Gd^Kov, Gd^Kov, Gd, Gd^Fetd, Gd^Fetd, Gll, Gs^Fms, Gs^Fms, Gs^Fms, Gg, Gg^Fet, Gs, Gll, Wwt, Gg, Gg^Fet, Gs^Fms, Gg, Gs^Fms, Gs^Fms, Gs^Fms, Gll, Gll, Gs^Fms, Gs^Fms, Gg^Fet, Gs^Fms, Gg^Fet, Gs^Fms, Gll, Hh^Fms, Hh^Fms, Hh^Fms, Hh, Hh, Hh, Hh^Fms, Hh^Fms, Hh, Hh^Fms, Hh^Fms, Gll, Gg^Fet, Gg^Fet, Gg^Ve, Gs, Gs^Fms, Gll, Gs^Fms, Gs^Fms, Gll, Gs^Fms, Gll, Gg, Gll, Gs^Fms, Hh^Fms, Hh^Fms, Mm, Mm
Mm, Hh^Fms, Hh^Fms, Hh^Fms, Hh^Fms, Hh^Fms, Wwt, Wwt, Gs^Fms, Gll, Gs^Fms, Gd^Fetd, Gd^Fetd, Gd^Kov, Gd^Kov, Gd^Kov, Gs^Fms, Gd^Fetd, Gg^Syt, Gs^Fms, Gg^Fet, Gll, Gs^Fms, Gll, Gs^Fms, Gs^Fms, Gs^Fms, Gll, Gs^Fms, Gs^Fms, Gll, Gg^Fet, Gll, Gs^Fms, Gll, Gs^Fms, Gs^Fms, Gll, Gs^Fms, Gll, Gs^Fms, Gll, Gs^Fms, Gs^Fms, Gll, Hh^Fms, Hh^Fms, Hh, Hh, Hh^Fms, Hh^Fms, Hh^Fms, Hh^Fms, Hh^Fms, Hh, Gs^Fms, Gs^Fms, Gll, Gs^Fms, Gs^Fms, Gg^Fet, Gs^Fms, Gll, Gll, Gs^Fms, Gs, Hh^Fms, Hh^Ve, Hh^Fms, Hh^Fms, Mm, Mm, Mm, Mm
Mm, Hh^Fms, Hh^Fms, Hh^Fms, Wwt, Wwt, Hh^Fms, Gs^Fms, Hh^Fms, Gs^Fms, Gs^Fms, Gs^Fms, Gd, Gd^Fetd, Gd^Fetd, Gg, Gll, Gs^Fms, Gll, Gs^Fms, Gll, Gll, Gs^Fms, Gll, Hh, Gll, Gll, Gs^Fms, Gll, Gs^Fms, Hh, Hh^Fms, Hh, Gll, Gg, Gg^Fet, Gs^Fms, Gll, Gs^Fms, Gll, Gll, Gll, Gll, Gll, Gs^Fms, Gs^Fms, Gs^Fms, Hh^Fms, Hh^Fms, Hh, Hh^Fms, Hh^Fms, Hh^Fms, Hh^Fms, Hh^Fms, Hh, Gll, Gs^Fms, Gs^Fms, Gll, Gs^Kov, Gs^Fms, Gs^Fms, Gs^Fms, Gll, Hh^Fms, Hh^Fms, Hh^Fms, Hh^Fms, Mm, Mm, Mm, Mm, Mm
Mm, Mm, Mm, Wwt, Mm, Hh^Fms, Hh^Fms, Hh^Fms, Hh^Fms, Gll, Gs^Fms, Gs^Fms, Gs^Fms, Gd^Fetd, Gg^Fet, Gs^Fms, Gs^Fms, Gg, Gg, Gg, Gg, Gs^Fms, Gll, Gll, Gg^Fms, Hh^Fms, Hh^Fms, Gs^Fms, Hh^Fms, Hh, Hh^Fms, Hh^Fms, Hh^Fms, Hh, Gs, Gll, Gs^Fms, Gll, Gs^Fms, Gs^Fms, Gll, Gs^Fms, Gs^Fms, Gs^Fms, Gll, Gs^Fms, Hh, Hh, Hh, Hh^Fms, Hh, Hh^Fms, Hh^Fms, Hh, Hh, Hh^Fms, Gll, Gs^Fms, Gg^Fet, Gll^Kov, Gs^Kov, Gs^Kov, Gs^Fms, Gll, Hh^Fms, Hh^Fms, Hh^Fms, Hh^Fms, Mm, Mm, Mm, Mm, Mm, Mm
Mm, Mm, Mm, Mm, Mm, Mm, Hh^Fms, Hh^Fms, Hh^Fms, Hh^Fms, Hh^Fms, Gs^Fms, Gs^Fms, Gs^Fms, Gll, Gll, Gs^Fms, Gs, Gs, Gg^Ve, Gll, Gs^Fms, Gs^Fms, Gs^Fms, Gs^Fms, Hh^Fms, Hh^Fms, Hh^Fms, Hh^Fms, Hh^Fms, Hh, Hh, Hh^Fms, Hh, Gg, Gs^Fms, Gs^Fms, Gs^Fms, Gs^Fms, Gll, Gs^Fms, Gs^Fms, Gll, Gg^Fet, Gs, Gg, Hh^Fms, Hh^Fms, Hh^Fms, Hh^Fms, Hh^Fms, Hh^Fms, Hh^Fms, Hh^Fms, Gll, Gs^Fms, Gs^Fms, Gs^Fms, Gs^Fms, Gll^Kov, Gs^Kov, Hh^Kov, Hh^Fms, Hh^Fms, Hh^Fms, Hh^Fms, Hh^Fms, Hh^Fms, Mm, Mm, Mm, Mm, Mm, Mm
Mm, Mm, Mm, Mm, Mm, Mm, Mm, Hh^Fms, Mm, Hh^Fms, Hh^Fms, Gll, Gs^Fms, Gs^Fms, Gll, Gs^Fms, Gs, Gs, Gg, Gg, Gg, Gll, Gs^Fms, Gs^Fms, Gs^Fms, Hh, Gs^Fms, Hh^Fms, Gg^Fms, Hh^Fms, Hh^Fms, Hh^Fms, Gs, Gll, Gs^Fms, Gll, Gg, Gs^Fms, Gs, Gg, Gs^Fms, Gs^Fms, Gs^Fms, Gg, Gs^Fms, Hh, Hh^Fms, Hh^Fms, Hh, Hh, Hh, Hh, Gs^Fms, Gs^Fms, Gs, Gg^Syt, Gs, Gs^Fms, Gll, Hh^Fms, Hh^Fms, Hh^Fms, Hh^Fms, Hh^Fms, Hh^Fms, Hh^Fms, Mm, Mm, Mm, Mm, Mm, Mm, Mm, Mm
Mm, Mm, Mm, Mm, Mm, Mm, Mm, Mm, Mm, Hh^Fms, Hh^Fms, Gs^Fms, Gg, Gs^Fms, Gg, Gs^Fms, Gs, Gs, Gg, Gg, Gg, Gs^Fms, Gg, Gg, Gg, Gs^Fms, Gg, Gg, Gg, Gg, Gg, Gs, Gg, Gg, Gg, Gg, Gg, Gs, Gg, Gg, Gg, Gg, Gg, Gs^Fms, Gs^Fms, Gs, Gg, Gs, Gg, Gs, Gg, Gs^Fms, Gg, Gs, Gs, Gg, Gs^Fms, Gs^Fms, Gg, Hh^Fms, Gg, Hh^Fms, Hh^Fms, Mm, Mm, Mm, Gg, Mm, Mm, Mm, Mm, Mm, Mm, Mm
