Xoi, Xoi, Xoi, Xoi, Xoi, Irs, Xoi, Irs, Xoi, Irs, Xoi, Irs, Xoi, Irs, Xoi, Xoi, Xoi
Xoi, Xoi, Xoi, Xoi, Xoi^Efs, Xoi, Xoi^Efs, Xoi, Xoi, Xoi, Xoi^Efs, Xoi, Xoi^Efs, Xoi, Xoi, Xoi, Xoi
Xoi, Xoi, Xoi^Efs, Xoi^Efs, Irs^Ii, Irs^Ii, Irs^Ii, Xoi, Xoi^Efs, Xoi, Irs^Ii, Irs^Ii, Irs^Ii, Xoi^Efs, Xoi^Efs, Xoi, Xoi
Xoi^Efs, Xoi^Efs, Irs^Ii, Irs^Ii, Icr, Icr, Xoi^Efs, Irs^Zs, Irs^Ii, Irs^Vs, Xoi^Efs, Icr, Icr, Irs^Ii, Irs^Ii, Xoi^Efs, Xoi^Efs
Xoi, Irs^Ii, Icr, Icr, Xoi^Efs, Icr, Icr, Irs^Ii, Icr, Irs^Ii, Icr, Icr, Xoi^Efs, Icr, Icr, Irs^Ii, Xoi
Xoi, Irs^Ii, Icr, Irs^Ii, Irs^Ii, Irs^Ii, Irs^Ii, Icr, Icr, Icr, Irs^Ii, Irs^Ii, Irs^Ii, Irs^Ii, Icr, Irs^Ii, Xoi
Xoi, Irs^Ii, Icr, Irs^Ii, Xoi^Efs, Irs, Irs, Irs^Ii, Icr, Irs^Ii, Irs, Irs, Xoi^Efs, Irs^Ii, Icr, Irs^Ii, Xoi
Xoi, Irs^Ii, Icr, Irs^Ii, Irs, Irs, Irs, Irs^Ii, Icr, Irs^Ii, Irs, Irs, Irs, Irs^Ii, Icr, Irs^Ii, Xoi
Xoi, Irs^Ii, Irs^Ii, Irs, Xoi^Efs, Irs, Irs^Ii, Irs^Ii, Icr, Irs^Ii, Irs^Ii, Irs, Xoi^Efs, Irs, Irs^Ii, Irs^Ii, Xoi
Icr, Xoi, Icr, Irs^Ii, Icr, Irs^Ii, Icr, Irs^Ii, Icr, Irs^Ii, Icr, Irs^Ii, Icr, Irs^Ii, Icr, Xoi, Icr
Icr, Icr, Irs, Icr, Irs, Icr, Irs, Icr, Icr, Icr, Irs, Icr, Irs, Icr, Irs, Icr, Icr
Xoi, Xoi, Irs, Irs, Xoi^Efs, Irs, Irs^Ii, Irs, Icr, Irs, Irs^Ii, Irs, Xoi^Efs, Irs, Irs, Xoi, Xoi
Xoi, Irs, Irs^Ii, Irs^Ii, Icr, Irs^Ii, Icr, Irs^Ii, Icr, Irs^Ii, Icr, Irs^Ii, Icr, Irs^Ii, Irs^Ii, Irs, Xoi
Xoi, Irs, Irs^Ii, Icr, Xoi^Efs, Icr, Irs^Ii, Icr, Icr, Icr, Irs^Ii, Icr, Xoi^Efs, Icr, Irs^Ii, Irs, Xoi
Xoi, Irs, Icr, Icr, Irs^Ii, Irs^Ii, Irs, Irs^Ii, Icr, Irs^Ii, Irs, Irs^Ii, Irs^Ii, Icr, Icr, Irs, Xoi
Xoi, Irs, Irs, Irs^Ii, Xoi^Efs, Irs, Irs, Irs^Ii, Icr, Irs^Ii, Irs^Ii, Irs^Ii, Xoi^Efs, Irs, Irs, Irs, Xoi
Icr, Xoi, Icr, Irs^Ii, Icr, Irs, Icr, Irs^Ii, Icr, Irs^Ii, Icr, Irs, Icr, Irs, Icr, Xoi, Icr
Icr, Icr, Irs^Ii, Icr, Irs^Ii, Icr, Irs^Ii, Icr, Icr, Icr, Irs^Ii, Icr, Irs^Ii, Icr, Irs^Ii, Icr, Icr
Xoi, Xoi, Irs, Irs^Ii, Xoi^Efs, Irs^Ii, Irs, Irs^Ii, Icr, Irs^Ii, Irs, Irs^Ii, Xoi^Efs, Irs^Ii, Irs, Xoi, Xoi
Xoi, Irs, Irs, Irs, Irs, Irs, Irs, Irs^Ii, Icr, Irs^Ii, Irs, Irs, Irs, Irs, Irs, Irs, Xoi
Xoi, Irs, Xoi, Irs, Xoi, Irs, Xoi, Irs^Ii, Icr, Irs^Ii, Xoi, Irs, Xoi, Irs, Xoi, Irs, Xoi
Xoi, Xoi, Xoi, Xoi, Xoi, Xoi, Xoi, Irs^Ii, Icr, Irs^Ii, Xoi, Xoi, Xoi, Xoi, Xoi, Xoi, Xoi
