Xoi, Xoi, Xoi, Xoi, Xoi, Xoi, Xoi, Xoi, Xoi, Xoi, Xoi, Xoi, Xoi, Xoi, Xoi, Xoi, Xoi
Xoi, Xoi, Xoi, Xoi, Xoi, Xoi, Xoi, Xoi, Xoi, Xoi, Xoi, Xoi, Xoi, Xoi, Xoi, Xoi, Xoi
Xoi, Xoi, Xoi, Xoi, Xoi, Xoi, Xoi, Xoi, Xoi, Xoi, Xoi, Xoi, Xoi, Xoi, Xoi, Xoi, Xoi
Xoi, Xoi, Xoi, Xoi, Xoi, Xoi, Xoi, Xoi, Xoi, Xoi, Xoi, Xoi, Xoi, Xoi, Xoi, Xoi, Xoi
Xoi, Xoi, Xoi, Xoi, Xoi, Xoi, Xoi, Xoi, Xoi, Xoi, Xoi, Xoi, Xoi, Xoi, Xoi, Xoi, Xoi
Xoi, Xoi, Xoi, Xoi, Xoi, Xoi, Xoi, Xoi, Xoi, Xoi, Xoi, Xoi, Xoi, Xoi, Xoi, Xoi, Xoi
Xoi, Xoi, Xoi, Xoi, Xoi, Xoi, Xoi, Xoi, Xoi, Xoi, Xoi, Xoi, Xoi, Xoi, Xoi, Xoi, Xoi
Xoi, Xoi, Xoi, Xoi, Xu, Xu, Xu, Xoi, Xoi, Xoi, Xu, Xu, Xu, Xoi, Xoi, Xoi, Xoi
Xoi, Xoi, Xu, Xu, Wwt, Wwt, Wwt, Xu, Xu, Xu, Wwt, Wwt, Wwt, Xu, Xu, Xoi, Xoi
Xoi, Xu, Wwt, Wwt, Qxua, Qxua, Qxua, Wwt, Wwt, Wwt, Qxua, Qxua, Qxua, Wwt, Wwt, Xu, Xoi
Xoi, Xu, Wwt, Qxua, Qxua, Qxua, Qxua, Qxua, Qxua, Qxua, Qxua, Qxua, Qxua, Qxua, Wwt, Xu, Xoi
Xoi, Xu, Wwt, Qxua, Qxua, Qxua, Qxua, Qxua, Kw, Qxua, Qxua, Qxua, Qxua, Qxua, Wwt, Xu, Xu
Xoi, Xu, Wwt, Qxua, Qxua, Qxua, Qxua, Qxua, Qxua, Qxua, Qxua, Qxua, Qxua, Qxua, Wwt, Xu, Xu
Xoi, Xu, Wwt, Qxua, Qxua, Kw, Qxua, Qxua, 1 Irs, Qxua, Qxua, Kw, Qxua, Qxua, Wwt, Xu, Xu
Xoi, Xu, Wwt, Qxua, Qxua, Qxua, Qxua, Qxua, Irs, Qxua, Qxua, Qxua, Qxua, Qxua, Wwt, Xu, Xoi
Xoi, Xu, Wwt, Qxua, Qxua, Qxua, Qxua, Qxua, Irs, Qxua, Qxua, Qxua, Qxua, Qxua, Wwt, Xu, Xoi
Xoi, Xu, Wwt, Qxua, Qxua, Kw, Qxua, Qxua, Irs, Qxua, Qxua, Kw, Qxua, Qxua, Wwt, Xu, Xoi
Xoi, Xu, Xoi, Wwt, Qxua, Qxua, Qxua, Qxua, Irs, Qxua, Qxua, Qxua, Qxua, Wwt, Xoi, Xu, Xoi
Xoi, Xoi, Xoi, Xoi, Xoi, Qxua, Qxua, Qxua, Irs, Qxua, Qxua, Qxua, Xoi, Xoi, Xoi, Xoi, Xoi
Xoi, Xoi, Xoi, Xoi, Xoi, Xoi, Irs, Irs, Irs, Irs, Irs, Xoi, Xoi, Xoi, Xoi, Xoi, Xoi
Xoi, Xoi, Xoi, Xoi, Xoi, Xoi, Irs, Irs, Irs, Irs, Irs, Xoi, Xoi, Xoi, Xoi, Xoi, Xoi
Xoi, Xoi, Xoi, Xoi, Xoi, Xoi, Irs, Irs, Irs, Irs, Irs, Xoi, Xoi, Xoi, Xoi, Xoi, Xoi
