Xu, Xu, Xu, Xu, Xu, Xu, Xu, Xu, Xu, Xu, Xu, Xu, Xu, Xu, Xu, Xu, Xu, Xu, Xu, Xu, Xu, Xu, Xu, Xu, Xu, Xu, Xu, Xu, Xu, Xu, Xu, Xu, Xu, Xu, Xu, Xu, Xu, Xu, Xu, Xu, Xu, Xu, Xu, Xu, Xu, Xu, Xu, Xu, Xu, Xu, Xu, Xu, Uh, Xu, Wog, Uu, Uu, Xu, Uu, Ur, Uu, Xu, Uu^Br|, Uu, Uu, Xu, Uu, Xu, Xu, Xu, Xu, Xu, Xu, Xu, Xu, Xu, Xu, Xu, Xu, Xu
Xu, Xu, Xu, Xu, Xu, Xu, Xu, Xu, Xu, Xu, Xu, Xu, Xu, Xu, Xu, Xu, Xu, Xu, Xu, Xu, Xu, Xu, Xu, Xu, Xu, Xu, Xu, Xu, Xu, Xu, Xu, Xu, Xu, Xu, Xu, Xu, Xu, Xu, Xu, Xu, Xu, Xu, Xu, Xu, Xu, Xu, Xu, Xu, Xu, Xu, Xu, Uh, Tb, Wog, Wog, Uu, Uh, Uh, Uu, Ur, Uu, Uu, Uu^Br|, Uh, Uh, Uu, Uu, Uu, Xu, Xu, Xu, Xu, Xu, Xu, Xu, Xu, Xu, Xu, Xu, Xu
Xu, Xu, Xu, Xu, Xu, Xu, Xu, Xu, Xu, Xu, Xu, Xu, Xu, Xu, Xu, Xu, Xu, Xu, Xu, Xu, Xu, Xu, Xu, Xu, Xu, Xu, Xu, Xu, Xu, Xu, Xu, Xu, Xu, Xu, Xu, Xu, Xu, Xu, Xu, Xu, Xu, Xu, Xu, Xu, Xu, Xu, Xu, Xu, Xu, Xu, Xu, Uh, Tb, Wog, Wog, Tb, Uh, Uu, Uu, Ur, Uu, Uu, Uu^Br|, Uh, Uu, Uh, Uh, Uu, Xu, Xu, Xu, Xu, Xu, Xu, Xu, Xu, Xu, Xu, Xu, Xu
Xu, Xu, Xu, Xu, Xu, Xu, Xu, Xu, Xu, Xu, Xu, Xu, Xu, Xu, Xu, Xu, Xu, Xu, Xu, Xu, Xu, Xu, Xu, Xu, Xu, Xu, Xu, Xu, Xu, Xu, Xu, Xu, Xu, Xu, Xu, Xu, Xu, Xu, Xu, Xu, Xu, Xu, Xu, Xu, Xu, Xu, Xu, Xu, Xu, Xu, Xu, Tb, Wog, Wog, Wog, Tb, Cud, Cud, Cud, Ur, Uu, Uu, Uu^Br|, Uu, Uu, Uh, Uu, Uu, Xu, Xu, Xu, Xu, Xu, Xu, Xu, Xu, Xu, Xu, Xu, Xu
Xu, Xu, Xu, Xu, Xu, Xu, Xu, Xu, Xu, Xu, Xu, Xu, Xu, Xu, Xu, Xu, Xu, Xu, Xu, Xu, Xu, Xu, Xu, Xu, Xu, Xu, Xu, Xu, Xu, Xu, Xu, Xu, Xu, Xu, Xu, Xu, Xu, Xu, Xu, Xu, Xu, Xu, Xu, Xu, Xu, Xu, Xu, Xu, Xu, Xu, Wog, Wog, Wog, Wog, Uu, Uh, Cud, 2 Kud, Cud, Ur, Uu, Uu^Vud, Uu^Br|, Uu, Uh, Uh^Vud, Uu, Uu, Xu, Xu, Xu, Xu, Xu, Xu, Xu, Xu, Xu, Xu, Xu, Xu
Xu, Xu, Xu, Xu, Xu, Xu, Xu, Xu, Xu, Xu, Xu, Xu, Xu, Xu, Xu, Xu, Xu, Xu, Xu, Xu, Xu, Xu, Xu, Xu, Xu, Xu, Xu, Xu, Xu, Xu, Xu, Xu, Xu, Xu, Xu, Xu, Xu, Xu, Xu, Xu, Xu, Xu, Xu, Xu, Xu, Xu, Xu, Xu, Wog, Wog, Wog, Wog, Rr^Pr\, Uu, Uu, Uu, Uu, Cud, Uu, Ur, Uu^Br|, Uu^Br/, Uu, Uu, Uh, Uu, Xu, Xu, Xu, Xu, Xu, Xu, Xu, Xu, Xu, Xu, Xu, Xu, Xu, Xu
Xu, Xu, Xu, Xu, Xu, Xu, Xu, Xu, Xu, Xu, Xu, Xu, Xu, Xu, Xu, Xu, Xu, Xu, Xu, Xu, Xu, Xu, Xu, Xu, Xu, Xu, Xu, Xu, Xu, Xu, Xu, Xu, Xu, Xu, Xu, Xu, Xu, Xu, Xu, Uh, Uh, Uh, Uh, Xu, Uh, Xu, Wog, Wog, Wog, Wog, Uu, Ur, Xuc, Xuc, Xu, Uu, Uh^Vud, Uu, Uu, Ur, Uu^Br|, Uu, Uh, Uu, Xu, Xu, Xu, Xu, Xu, Xu, Xu, Xu, Xu, Xu, Xu, Xu, Xu, Xu, Xu, Xu
Xu, Xu, Xu, Xu, Xu, Xu, Xu, Xu, Xu, Xu, Xu, Xu, Xu, Xu, Xu, Xu, Xu, Xu, Xu, Xu, Xu, Xu, Xu, Xu, Xu, Xu, Xu, Xu, Xu, Xu, Xu, Xu, Xu, Xu, Xu, Xu, Uh, Uh, Wog, Wog, Wog, Wog, Wog, Wog, Wog, Wog, Wog, Wog, Ur, Ur, Xuc, Xuc, Xu, Xu, Xu, Uu, Uu, Tb, Uu, Ur, Uu^Br|, Uh, Uu, Uu, Xu, Xu, Xu, Xu, Xu, Xu, Xu, Xu, Xu, Xu, Xu, Xu, Xu, Xu, Xu, Xu
Xu, Xu, Xu, Xu, Xu, Xu, Xuc, Xu, Xu, Xu, Xu, Xu, Xu, Xu, Xu, Xu, Xu, Xu, Uh, Xu, Xu, Xu, Xu, Xu, Xu, Xu, Xu, Xu, Xu, Xu, Xu, Xu, Xu, Xu, Wog, Xu, Wog, Wog, Wog, Wog, Wog, Wog, Uh, Wog, Wog, Wog, Uu, Ur, Xuc, Xuc, Xu, Xu, Xu, Xu, Xu, Uh, Uu, Uh, Uu, Ur, Uu^Br|, Uh, Uu, Tb, Xu, Xu, Xu, Xu, Xu, Xu, Xu, Xu, Xu, Xu, Xu, Xu, Xu, Xu, Xu, Xu
Xu, Xu, Xu, Xu, Xu, Xu, Xuc, Xuc, Xuc, Xu, Xu, Xu, Xu, Xu, Xu, Xu, Uh, Uh, Wog, Uh, Uh, Xu, Wog, Xu, Wog, Wog, Wog, Wog, Wog, Wog, Wog, Xu, Wog, Wog, Wog, Wog, Wog, Wog, Xuc, Xuc, Xuc, Uh, Xuc, Xuc, Xuc, Ur, Xuc, Xuc, Xu, Xu, Xu, Xu, Xu, Xu, Xu, Tb, Uh, Cud, Uu, Ur, Uu^Br|, Cud, Uh, Tb, Xu, Xu, Xu, Xu, Xu, Xu, Xu, Xu, Xu, Xu, Xu, Xu, Xu, Xu, Xu, Xu
Xu, Xu, Xu, Xuc, Xuc, Xuc, Uh, Uh, Uh, Uh, Uh, Uh, Uh, Uh, Uh, Uh, Wog, Wog, Wog, Wog, Wog, Wog, Xu, Wog, Xu, Xu, Xu, Wog, Xu, Wog, Wog, Wog, Wog, Wog, Ur, Wog, Uu, Xuc, Uu, Xuc, Uu, Ur, Ur, Uu, Ur, Ur, Xuc, Xu, Xu, Xu, Xu, Xu, Xu, Xu, Xu, Xu, Xu, Xu, Uu, Ur, Uu^Br|, Xu, Xu, Xu, Xu, Xu, Xu, Xu, Xu, Xu, Xu, Xu, Xu, Xu, Xu, Xu, Xu, Xu, Xu, Xu
Xu, Xu, Xu, Xuc, Uh, Xuc, Uu, Wog, Wog, Wog, Wog, Wog, Wog, Wog, Wog, Wog, Wog, Wog, Wog, Wog, Wog, Uh, Uh, Xu, Xu, Xu, Xu, Xu, Xu, Wog, Wog, Wog, Ur, Uu, Uh, Ur, Xuc, Ur, Uu, Ur, Xuc, Xuc, Xuc, Xuc, Xuc, Xuc, Xu, Xu, Xu, Xu, Xu, Xu, Xu, Xu, Xu, Xu, Xu, Xu, Uu, Ur, Uu^Br|, Xu, Xu, Xu, Xu, Xu, Xu, Xu, Xu, Xu, Xu, Xu, Xu, Xu, Xu, Xu, Xu, Xu, Xu, Xu
Xu, Xuc, Xuc, Xuc, Uh, Uh, Wog, Wog, Wog, Wog, Wog, Wog, Wog, Wog, Wog, Wog, Wog, Wog, Wog, Wog, Wog, Wog, Wog, Uh, Xu, Xu, Xu, Xu, Wog, Wog, Ur, Uu, Xuc, Xuc, Uu^Vud, Xuc, Xu, Xuc, Xuc, Xuc, Xu, Xu, Xu, Xu, Xu, Xu, Xu, Xu, Xu, Xu, Xu, Xu, Xu, Xu, Xu, Xu, Xu, Xu, Uu^Vud, Ur, Uu^Br|, Xu, Xu, Xu, Xu, Xu, Xu, Xu, Xu, Xu, Xu, Xu, Xu, Xu, Xu, Xu, Xu, Xu, Xu, Xu
Xuc, Xuc, Uh, Uh, Uu, Wog, Wog, Wog, Wog, Wog, Wog, Wog, Wog, Wog, Wog, Wog, Wog, Wog, Wog, Wog, Wog, Wog, Wog, Uh, Xu, Xu, Wog, Wog, Wog, Wog, Uu, Xuc, Uu^Vud, Xu, Xu, Xu, Xu, Xu, Xu, Xu, Xu, Xu, Xu, Xu, Xu, Xu, Xu, Xu, Xu, Xu, Xu, Xu, Xu, Xu, Xu, Xu, Xu, Xu, Ur, Ur, Uu^Br|, Xu, Xu, Xu, Xu, Xu, Xu, Xu, Xu, Xu, Xu, Xu, Xu, Xu, Xu, Xu, Xu, Xu, Xu, Xu
Xu, Xuc, Uh, Uh, Uu, Wog, Wog, Wog, Ur, Ur, Uu, Ur, Uu, Ur, Ur, Wog, Wog, Wog, Wog, Wog, Uu, Wog, Ur, Wog, Wog, Wog, Uu, Wog, Ur, Ur, Xuc, Uu, Xu, Xu, Xu, Xu, Xu, Xu, Xu, Xu, Xu, Xu, Xu, Xu, Xu, Xu, Xu, Xu, Xu, Xu, Xu, Xu, Xu, Xu, Xu, Xu, Uu, Uu, Ur, Uu^Br/, Uu, Uu, Rr^Pr/o, Xu, Xu, Xu, Xu, Xu, Xu, Xu, Xu, Xu, Xu, Xu, Xu, Xu, Xu, Xu, Xu, Xu
Xu, Xuc, Xuc, Uh, Uu, Uu, Wog, Wog, Ur, Xuc, Xuc, Xuc, Xuc, Xuc, Xuc, Ur, Uu, Ur, Ur, Ur, Xuc, Ur, Xuc, Uu, Ur, Ur, Xuc, Ur, Xuc, Xuc, Xu, Xu, Xu, Xu, Xu, Xu, Xu, Xu, Xu, Xu, Xu, Xu, Xu, Xu, Xu, Xu, Xu, Xu, Xu, Xu, Xu, Xu, Xu, Xu, Uu, Uu, Ur, Ur, Uu^Br/, Uu^Br|, Rr^Pr/o, Xu, Xu, Uu, Ur, Xu, Xu, Xu, Xu, Xu, Xu, Xu, Xu, Xu, Xu, Xu, Xu, Xu, Xu, Xu
Xu, Xu, Xuc, Uh, Uh, Uu, Uu, Wog, Wog, Ur, Uu, Xuc, Xuc, Xu, Xu, Xuc, Xuc, Xuc, Xuc, Xuc, Xu, Xuc, Xu, Xuc, Xuc, Xuc, Xu, Xuc, Xu, Xu, Xu, Xu, Xu, Xu, Xu, Xu, Xu, Xu, Xu, Xu, Xu, Xu, Tb, Uh^Vud, Uu, Xu, Xu, Xu, Xu, Xu, Xu, Xu, Uu, Uu^Vud, Ur, Ur, Uu^Br/, Uu^Br/, Xu, Xu, Xu, Uu, Ur, Xu, Ur, Xu, Xu, Xu, Xu, Xu, Xu, Xu, Xu, Xu, Xu, Xu, Xu, Xu, Xu, Xu
Xu, Xu, Xu, Xuc, Xuc, Uh, Xu, Uu, Uu, Wog, Wog, Uu, Xuc, Xu, Xu, Xu, Xu, Xu, Xu, Xuc, Xu, Xu, Xu, Xu, Xu, Xu, Xu, Xu, Xu, Xu, Xu, Xu, Xu, Xu, Xu, Xu, Xu, Xu, Xu, Xu, Tb, Uu, Uu, Tb, Uh, Uu, Uu, Xu, Xu, Xu, Uu, Uu, Ur, Ur, Uu^Br/, Uu^Br/, Xu, Xu, Xu, Xu, Xu, Xu, Uu, Xu, Uu, Xu, Xu, Xu, Xu, Xu, Xu, Xu, Xu, Xu, Xu, Xu, Xu, Xu, Xu, Xu
Xu, Xu, Xu, Xuc, Xu, Xu, Xu, Xu, Xu, Uu, Wog, Ur, Xu, Xu, Xu, Xu, Xu, Xu, Xu, Xu, Xu, Xu, Xu, Xu, Xu, Xu, Xu, Xu, Xu, Xu, Xu, Xu, Xu, Xu, Xu, Xu, Xu, Xu, Xu, Tb, Uu, Uu, Uh, Uh, Tb, Uh, Uu, Cud, Cud, Uu, Ur, Ur, Uu^Br/, Uu^Br/, Xu, Xu, Xu, Xu, Xu, Xu, Xu, Xu, Ur, Xu, Ur, Xu, Tb, Xu, Xu, Xu, Xu, Xu, Xu, Xu, Xu, Xu, Xu, Xu, Xu, Xu
Xu, Xu, Xu, Xu, Xu, Xu, Xu, Xu, Xu, Uu, Wog, Ur, Xu, Xu, Xu, Xu, Xu, Xu, Xu, Xu, Xu, Xu, Xu, Xu, Xu, Xu, Xu, Xu, Xu, Xu, Xu, Xu, Xu, Xu, Xu, Xu, Xu, Xu, Xu, Uh, Uu, Uh, Ur, Ur, Ur, Uu, Ur, Cud, Ur, Ur, Uu^Br/, Uu^Br/, Xu, Xu, Xu, Xu, Xu, Xu, Tb^Tf, Tb^Tf, Uu, Ur, Uh, Uu, Xu, Ur, Uu, Xu, Xu, Xu, Xu, Xu, Xu, Xu, Xu, Xu, Xu, Xu, Xu, Xu
Xu, Xu, Xu, Xu, Xu, Xu, Xu, Xu, Xu, Uu, Wog, Ur, Xu, Xu, Xu, Xu, Xu, Xu, Xu, Xu, Xu, Xu, Tb, Tb, Ur, Uu, Uu, Uu, Uu, Uu, Uu^Vud, Xu, Xu, Xu, Xu, Xu, Xu, Xu, Uh, Tb^Tf, Uu, Uu, Ur, Uu^Vud, Uh, Ur, Uu, Ur, Uu^Br/, Uu^Br/, Xu, Xu, Xu, Xu, Xu, Xu, Xu, Xu, Tb^Tf, Xu, Uu, Ur, Uu^Vu, Uu, Uu, Xu, Xu, Uu, Xu, Xu, Xu, Xu, Xu, Xu, Xu, Xu, Xu, Xu, Xu, Xu
Xu, Xu, Xu, Xu, Xu, Xu, Xu, Xu, Xu, Uu, Wog, Ur, Xu, Xu, Xu, Xu, Xu, Xu, Xu, Xu, Xu, Xu, Uu, Ur, Uu, Ur, Ur, Ur, Ur, Ur, Ur, Xu, Xu, Xu, Xu, Xu, Xu, Xu, Tb^Tf, Tb^Tf, Uu, Uu, Ur, Uh, Tb^Tf, Uh, Uu^Br/, Uu^Br/, Uu, Tb^Tf, Xu, Xu, Xu, Xu, Xu, Xu, Xu, Xu, Ur, Ur, Xu, Xu, Xu, Xu, Uu, Xu, Uu, Uu, Xu, Xu, Xu, Xu, Xu, Xu, Xu, Xu, Xu, Xu, Xu, Xu
Xu, Xu, Xu, Xu, Xu, Xu, Xu, Xu, Xu, Uu, Wog, Ur, Xu, Xu, Xu, Xu, Xu, Xu, Xu, Xu, Uu^Vud, Uu, Ur, Ur, Xu, Uu, Xu, Uu, Xu, Uu, Uu, Ur, Ur, Xu, Uu, Xu, Uu^Vud, Xu, Uu, Uu, Ur, Ur, Ur, Tb^Tf, Uu^Br/, Uu^Br/, Uu, Uu, Tb^Tf, Xu, Xu, Xu, Xu, Xu, Xu, Xu, Xu, Xu, Uu, Tb^Tf, Xu, Xu, Xu, Xu, Uu, Uu, Xu, Xu, Xu, Xu, Xu, Xu, Xu, Xu, Xu, Xu, Xu, Xu, Xu, Xu
Uh, Tb, Tb, Uh, Uh, Uh, Tb, Ce, Ce, Uu, Wog, Uu, Xu, Xu, Xu, Xu, Xu, Xu, Xu, Xu, Uu, Ur, Uu, Xu, Xu, Xu, Xu, Xu, Xu, Cud, Cud, Uh, Ur, Ur, Ur, Ur, Ur, Ur, Ur, Ur, Uu^Br/, Uu^Br/, Uu^Br\, Uu^Br/, Uu, Uu, Uu, Tb^Tf, Tb^Tf, Xu, Xu, Xu, Xu, Xu, Xu, Xu, Xu, Xu, Ur, Xu, Uu, Xu, Xu, Xu, Uu, Uu, Uu, Xu, Xu, Xu, Xu, Xu, Xu, Xu, Xu, Xu, Xu, Xu, Xu, Xu
Ur, Uu, Ur, 4 Ke, Ur, Uu, 1 Ke, Uu, Ce, Uu, Wog^Bcx/, Ur, Ur, Tb, Ur, Tb, Ur, Tb, Ur, Uu, Ur, Ur, Cud, Xu, Xu, Xu, Xu, Xu, Xu, Xu, Cud, Uh, Ur^Br/, Uu^Br/, Uu^Br\, Uu^Br/, Uu^Br\, Uu^Br/, Uu^Br\, Uu^Br/, Tb^Tf, Uu, Uu, Tb^Tf, Tb^Tf, Uh, Uh, Tb^Tf, Uu, Xu, Xu, Xu, Xu, Xu, Xu, Xu, Xu, Xu, Xu, Ur, Xu, Uu, Uu, Xu, Uu, Xu, Uu, Uu, Xu, Xu, Xu, Xu, Xu, Xu, Xu, Xu, Xu, Xu, Xu, Xu
Ur, Ur, Ur, Ur, Ur, Ur, Ur, Ce, Ur, Ur, Wog^Bcx\, Uu, Ur, Ur, Ur^Br\, Ur, Ur^Br/, Ur, Ur^Br/, Ur, Ur, Kud, Cud, Xu, Xu, Xu, Xu, Xu, Xu, Cud, Ur^Br/, Ur^Br/, Xu, Xu, Xu, Xu, Xu, Xu, Tb^Tf, Uu, Uu, Uh, Uu, Uu, Uu, Uh^Vud, Uu, Uu, Tb, Xu, Xu, Xu, Xu, Xu, Xu, Xu, Xu, Xu, Uu, Uu, Uu, Uu, Xu, Uu, Uu^Vu, Uu, Uu, Uu, Xu, Xu, Xu, Xu, Xu, Xu, Xu, Xu, Xu, Xu, Xu, Xu
Uu, Uu^Br\, Uu^Br/, Uu^Br\, Uu^Br/, Uu^Br\, Uu^Br/, Uu^Br\, Uu^Br/, Uu, Wog, Ur, Uu^Br/, Uu^Br/, Xu, Uu^Br/, Xu, Uu^Br\, Xu, Uu^Br\, Uu^Br\, Ur, Uu, Xu, Xu, Xu, Xu, Xu, Uu, Ur^Br|, Uu, Uu, Xu, Xu, Xu, Xu, Xu, Xu, Xu, Uu, Uu, Uu, Uu, Uu, Uu, Uu, Uu, Uu, Xu, Xu, Xu, Xu, Xu, Xu, Uu, Tb^Tf, Uu, Ur, Ur, Xu, Uu, Xu, Xu, Xu, Xu, Xu, Uu, Uu, Xu, Xu, Xu, Xu, Xu, Xu, Xu, Xu, Xu, Xu, Xu, Xu
Uh, Uu, Uh, Uu, Uh, Uu, Tb, Uu, Uu, Uu^Br\, Wog^Br/, Uu^Br|, Xu, Xu, Xu, Xu, Xu, Xu, Xu, Xu, Uu^Br|, Ur, Uu, Xu, Tb, Xu, Uh, Xu, Uu, Ur^Br|, Uu, Xu, Xu, Xu, Xu, Xu, Xu, Xu, Xu, Xu, Rr^Pr\o, Uu, Xu, Xu, Xu, Uu, Xu, Rr^Pr/o, Uu, Xu, Xu, Xu, Xu, Uu, Xu, Uu, Xu, Xu, Xu, Uu, Xu, Uu, Uu, Xu, Xu, Xu, Xu, Uu, Uh, Xu, Xu, Xu, Xu, Xu, Xu, Xu, Xu, Xu, Xu, Xu
Xu, Tb, Xu, Uh, Xu, Tb, Xu, Uh, Xu, Uu, Wog, Ur, Xu, Xu, Xu, Xu, Xu, Xu, Xu, Xu, Xu, Ur^Br\, Ur^Br\, Uu, Ur, Uu, Ur^Br/, Uu, Ur^Br/, Ur^Br/, Xu, Xu, Xu, Xu, Xu, Xu, Xu, Xu, Xu, Uu, Xu, Xu, Xu, Xu, Xu, Xu, Xu, Xu, Ur, Xu, Ur, Ur, Uu, Uu, Xu, Xu, Xu, Xu, Ur, Uu, Xu, Xu, Xu, Uu, Uu, Xu, Uu, Uu, Uh, Xu, Xu, Xu, Xu, Xu, Xu, Xu, Xu, Xu, Xu, Xu
Xu, Xu, Xu, Xu, Xu, Xu, Xu, Xu, Xu, Ur, Wog, Ur, Xu, Xu, Xu, Xu, Xu, Xu, Xu, Xu, Xu, Uu, Uu, Ur^Br\, Uu^Br\, Ur^Br/, Uh^Vud, Ur^Br\, Uh, Uh, Xu, Xu, Xu, Xu, Xu, Xu, Xu, Xu, Xu, Ur, Ur, Xu, Xu, Xu, Uu^Vu, Xu, Uu, Uu, Ur, Xu, Uu, Xu, Xu, Uu, Ur, Ur, Uu, Uu, Xu, Xu, Xu, Xu, Xu, Uu, Uu, Uu, Uh, Uh, Xu, Xu, Xu, Xu, Xu, Xu, Xu, Xu, Xu, Xu, Xu, Xu
Xu, Xu, Xu, Xu, Xu, Xu, Xu, Xu, Xu, Ur, Wog, Ur, Xu, Xu, Xu, Xu, Xu, Xu, Xu, Xu, Xu, Uu, Uu, Uu, Xu, Xu, Xu, Xu, Xu, Xu, Xu, Xu, Uu, Xu, Ur, Ur, Ur, Xu, Uu, Xu, Ur, Uu, Xu, Tb, Xu, Ur, Ur, Uh, Uh, Uu, Uu, Uh, Uu, Uu, Xu, Uu, Uu, Xu, Xu, Xu, Xu, Uh, Uu, Uu, Xu, Uu, Xu, Xu, Xu, Xu, Xu, Xu, Xu, Xu, Xu, Xu, Xu, Xu, Xu, Xu
Xu, Xu, Xu, Xu, Xu, Xu, Xu, Xu, Xu, Uu, Wog, Ur, Xu, Xu, Xu, Xu, Xu, Xu, Xu, Xu, Xu, Uu, Ur, Xu, Xu, Xu, Xu, Xu, Xu, Xu, Ur, Ur, Xu, Uu, Xu, Xu, Uu, Uu, Uu, Xu, Wwf, Uu, Wwf, Xu, Uu, Xu, Uu, Uh, Ur, Ur, Uu, Uu, Xu, Uu, Uu^Vu, Xu, Uu, Xu, Ur, Xu, Uu, Uu, Xu, Xu, Xu, Xu, Uu, Xu, Uu, Xu, Xu, Xu, Xu, Xu, Xu, Xu, Xu, Xu, Xu, Xu
Xu, Xu, Xu, Xu, Xu, Xu, Xu, Xu, Xu, Uu, Wog, Ur, Xu, Xu, Xu, Xu, Xu, Xu, Xu, Xu, Xu, Xu, Ur, Uh, Xu, Xu, Xu, Xu, Xu, Xu, Uu, Xu, Xu, Xu, Uu, Ur, Uh^Vu, Xu, Wwf, Wwf, Wwf, Wwf, Wwf, Wwf, Tb, Uu, Xu, Uu, Xu, Uu, Xu, Uu, Uu, Uu, Xu, Xu, Uu, Uu, Uu, Uu, Ur, Uu, Uu, Uu, Uu, Uu, Xu, Uu, Xu, Uu, Uu, Xu, Xu, Xu, Xu, Xu, Xu, Xu, Xu, Xu
Xu, Xu, Xu, Xu, Xu, Xu, Xu, Xu, Uh, Uu, Wog, Uu, Xu, Xu, Xu, Xu, Xu, Xu, Xu, Xu, Xu, Xu, Uu, Uu, Xu, Xu, Xu, Xu, Xu, Ur, Xu, Xu, Xu, Uu, Xu, Ur, Wwf, Wwf, Wwf, Uh, Xu, Tb, Ur, Wwf, Wwf, Xu, Xu, Uu, Xu, Uu, Xu, Tb^Tf, Xu, Ur, Uu, Uu, Xu, Xu, Xu, Xu, Xu, Xu, Xu, Ur, Xu, Uu, Uu, Xu, Uh^Vu, Xu, Tb, Uu, Uu, Xu, Xu, Xu, Xu, Xu, Xu, Xu
Xu, Xu, Xu, Xu, Tb^Tf, Tb^Tf, Uu, Uu, Uu, Uu, Wog, Ur, Tb^Tf, Xu, Xu, Xu, Xu, Xu, Xu, Xu, Tb^Tf, Uh, Uu, Uu, Ur, Xu, Xu, Xu, Xu, Ur, Xu, Xu, Xu, Xu, Uu, Tb^Tf, Wwf, Wwf, Tb^Tf, Wwf, Xu, Tb, Xu, Uu, Wwf, Uu, Uu, Uu, Xu, Xu, Xu, Xu, Uu, Ur, Tb^Tf, Uu, Uu, Xu, Uh, Xu, Xu, Xu, Xu, Xu, Xu, Xu, Xu, Uu, Uu, Xu, Xu, Xu, Uu, Xu, Xu, Xu, Xu, Xu, Xu, Xu
Xu, Xu, Tb^Tf, Tb^Tf, Wog, Wwg, Wog, Wwg, Wog, Wog, Wog, Ur, Ur, Uh, Xu, Xu, Xu, Xu, Xu, Xu, Uh, Uh, Uu, Ur, Uu, Tb^Tf, Uh, Xu, Tb^Tf, Uu, Ur, Xu, Uh, Xu, Xu, Wwf, Uh, Xu, Uu, Xu, Uh^Vu, Wwf, Wwf, Wwf, Wwf, Xu, Xu, Xu, Xu, Uh, Uu, Uu, Ur, Uu, Uu, Uu, Uu, Uh, Uh, Xu, Xu, Xu, Uu, Xu, Xu, Xu, Xu, Xu, Xu, Uu, Uu, Uu, Xu, Xu, Xu, Xu, Xu, Xu, Xu, Xu
Xu, Xu, Tb^Tf, Wwg, Wog, Wog, Wog, Wog, Wog, Wog, Wog, Wog, Wog, Uu, Uu, Xu, Xu, Xu, Ur, Xu, Uu, Ur, Wwf, Wwg, Wwf, Ur, Uu, Xu, Ur, Uu, Ur, Uu, Ur, Uu, Ur, Wwf, Tb^Tf, Uu, Wwf, Wwf, Wwf, Wwf, Xu, Wwf, Wwf, Ur, Uu, Uh, Uu, Ur, Uu, Uu, Uu, Xu, Xu, Xu, Xu, Uu, Uu, Xu, Uu, Uu, Xu, Uu, Uu, Xu, Uu, Xu, Uu, Uu, Uu, Uu, Xu, Xu, Xu, Xu, Xu, Xu, Xu, Xu
Xu, Xu, Tb^Tf, Wog, Wog, Wog, Uh, Wog, Uh, Tb^Tf, Uh, Wog, Wog, Wog, Wog, Uu, Ur, Uu, Wog, Ur, Uu, Ur, Wwg, Uu^Vud, Wwg, Wwg, Wwg, Uu, Wwg, Xu, Wwf, Wwf, Wwf, Wwg, Wwf, Wwf, Wwg, Wwf, Tb^Tf, Xu, Xu, Xu, Uu^Vu, Wwf, Xu, Wwf, Wwf, Uu, Ur, Ur, Xu, Xu, Xu, Ur, Ur, Xu, Xu, Xu, Uu, Uu, Uu, Xu, Xu, Uu, Uu, Uu, Uu, Uu, Uu, Uu, Uh, Uu, Uu, Uu, Uu, Xu, Xu, Xu, Xu, Xu
Xu, Xu, Tb^Tf, Wwg, Wog, Wog, Tb, Uu, Uu, Uu^Vu, Uu, Wog, Wwg, Wwg, Wwg, Wog, Wog, Wog, Wwg, Wog, Wwg, Wwg, Wwg, Wwg, Wwg, Wwg, Wwg, Wwf, Wwg, Wwg, Wwg, Uu, Xu, Wwg, Wwg, Uu, Uh, Wwf, Wwf, Wwf, Wwf, Wwf, Wwf, Wwf, Uu, Xu, Wwf, Wwf, Xu, Uu, Uu, Uh, Xu, Ur, Ur, Tb, Uu, Uu, Uu, Xu, Xu, Uu, Uu, Uu, Uh, Uh, Uh, Uh, Uu, Uh, Uu^Vu, Uh, Uh, Uu, Uu, Uu, Uu, Xu, Xu, Xu
Xu, Xu, Xu, Tb^Tf, Wog, Wog, Wog, Uu, Tb^Tf, Tb^Tf, Wog, Wwg, Wwg, Wwg, Wog, Wwg, Wwg, Wwg, Wwg, Wog, Wwg, Xu, Xu, Wwg, Xu, Wwg, Xu, Wwf, Wwg, Wwg, Wwg, Wwg, Wwg, Uh, Uu, Wwf, Wwg, Wwf, Wwf, Wwg, Uh, Uu, Wwf, Xu, Uh, Uu, Uu, Wwf, Xu, Uu, Uu^Vu, Uh, Xu, Xu, Uu^Vu, Uu, Uu, Xu, Uu, Xu, Xu, Xu, Uu, Uu, Uu, Uu, Uu, Uu, Uu, Uu, Uu, Uu, Uh, Uu, Uu, Uu, Xu, Uu, Xu, Xu
Xu, Xu, Xu, Tb^Tf, Wog, Wog, Wog, Wog, Wog, Wog, Wog, Wog, Wog, Wog, Wog, Wog, Wog, Wwg, Wwg, Uh, Wog, Wwg, Wwg, Wwg, Wwg, Uu, Uu, Ur, Uu, Wwg, Uu, Wwg, Xu, Wwf, Wwg, Wwg, Wwg, Wwf, Wwf, Wwg, Wwf, Xu, Wwf, Xu, Xu, Xu, Wwf, Wwf, Xu, Uh, Xu, Xu, Xu, Xu, Xu, Xu, Xu, Uu, Ur, Uu, Uu, Xu, Uu, Uu, Uu, Uu^Vu, Uu, Uu, Cte, Cte, Cte, Uu, Uu, Uh, Uu, Uu, Xu, Uu, Uu, Xu
Xu, Xu, Tb^Tf, Tb^Tf, Xu, Wog, Wog, Wog, Wog, Wog, Wwg, Wog, Wog, Wog, Wwg, Wwg, Wwg, Wwg, Wwg, Wog, Wog, Wog, Xu, Wwg, Wwg, Xu, Xu, Tb^Tf, Xu, Xu, Uu, Xu, Uu, Ur, Xu, Ur, Ur, Wwg, Ur, Uu, Xu, Xu, Wwf, Wwf, Wwf, Wwf, Tb, Uu, Ur, Xu, Xu, Xu, Xu, Xu, Xu, Xu, Xu, Xu, Ur, Uu, Uu, Uu, Uu, Uh, Uh, Uu, Uu, Uu, Cte, 3 Kte, Cte, Uu, Uu, Uu, Uu, Uu, Xu, Xu, Uu, Xu
Xu, Xu, Tb^Tf, Xu, Wog, Wog, Xu, Wog, Wog, Wwg, Xu, Wwg, Wwg, Wwg, Xu, Xu, Wwg, Wwg, Wwg, Wwg, Xu, Wwg, Wwg, Xu, Wwg, Xu, Xu, Xu, Xu, Uh, Uh, Uu, Uu, Xu, Uu, Uu, Xu, Wwg, Wwf, Xu, Wwf, Xu, Wwf, Uh, Xu, Xu, Xu, Uu, Tb, Ur, Uu, Uu, Ur, Uu, Uu, Ur, Uu, Ur, Xu, Uu, Uu, Uu, Uh, Uh, Uu^Vu, Uu, Uu, Uu, Uu, Cte, Uu, Uu, Uu, Uu, Uu, Uu^Vu, Xu, Xu, Uu, Xu
Xu, Xu, Xu, Tb^Tf, Wog, Wog, Wog, Wog, Tb, Xu, Tb, Xu, Xu, Wwg, Tb^Tf, Xu, Wwg, Wwg, Wwg, Wwg, Xu, Wwg, Wwg, Xu, Wwg, Xu, Xu, Xu, Xu, Xu, Xu, Xu, Xu, Uu, Xu, Tb^Tf, Xu, Wwg, Uu^Vu, Wwf, Uu, Wwf, Xu, Xu, Xu, Xu, Xu, Xu, Xu, Tb, Xu, Tb, Xu, Xu, Xu, Xu, Xu, Xu, Xu, Xu, Xu, Uu, Uu, Uh, Uh, Uh, Uh, Uu, Uh, Uh, Uu, Uh, Uh, Uu, Uu, Xu, Xu, Uu^Vu, Xu, Xu
Xu, Xu, Xu, Xu, Wog, Wog, Wog, Xu, Xu, Uh, Xu, Uh, Uh, Tb^Tf, Uu, Uh^Vu, Uh, Wwg, Xu, Wwg, Xu, Xu, Wwg, Wog, Wog, Xu, Xu, Xu, Xu, Xu, Xu, Xu, Xu, Xu, Xu, Xu, Xu, Wwg, Wwg, Xu, Xu, Xu, Xu, Xu, Xu, Xu, Xu, Xu, Xu, Xu, Xu, Xu, Xu, Xu, Xu, Xu, Xu, Xu, Xu, Xu, Xu, Tb^Tf, Tb^Tf, Uu, Uu, Uu, Uu, Uu, Uu, Uu, Uu, Uu, Uh, Uu, Uu, Uu, Xu, Xu, Xu, Xu
Xu, Xu, Xu, Xu, Wog, Wog, Wog, Xu, Xu, Xu, Xu, Xu, Xu, Xu, Xu, Tb^Tf, Xu, Wog, Wog, Wog, Xu, Xu, Xu, Xu, Xu, Wog, Wog, Xu, Xu, Xu, Xu, Xu, Xu, Xu, Xu, Xu, Xu, Xu, Wwg, Wwg, Xu, Xu, Xu, Xu, Xu, Xu, Xu, Xu, Xu, Xu, Xu, Xu, Xu, Xu, Xu, Xu, Xu, Xu, Xu, Xu, Xu, Uh, Tb^Tf, Tb^Tf, Xu, Uu, Xu, Uu, Uu^Vu, Uu, Uu, Uu, Uh, Uu, Uu, Uu, Uu, Xu, Xu, Xu
Xu, Xu, Xu, Wog, Wog, Wog, Xu, Xu, Xu, Xu, Xu, Xu, Xu, Xu, Xu, Xu, Xu, Xu, Wog, Xu, Xu, Xu, Xu, Xu, Xu, Xu, Wog, Xu, Xu, Xu, Xu, Xu, Xu, Xu, Xu, Xu, Xu, Xu, Xu, Wwg, Wwg, Xu, Xu, Xu, Xu, Xu, Xu, Xu, Xu, Xu, Xu, Xu, Xu, Xu, Xu, Xu, Xu, Xu, Xu, Xu, Xu, Uh, Uh, Uh, Xu, Xu, Xu, Xu, Xu, Xu, Xu, Uu, Xu, Uu, Uu, Uu, Uu, Xu, Xu, Xu
Xu, Xu, Xu, Wog, Wog, Wog, Xu, Xu, Xu, Xu, Xu, Xu, Xu, Xu, Xu, Xu, Xu, Xu, Wog, Xu, Xu, Xu, Xu, Xu, Xu, Xu, Wog, Xu, Xu, Xu, Xu, Xu, Xu, Xu, Xu, Xu, Xu, Xu, Xu, Xu, Wwg, Xu, Xu, Xu, Xu, Xu, Xu, Xu, Xu, Xu, Xu, Xu, Xu, Xu, Xu, Xu, Xu, Xu, Xu, Xu, Xu, Xu, Xu, Xu, Xu, Xu, Xu, Xu, Xu, Xu, Xu, Xu, Xu, Uu, Uu, Uu, Uu, Uu, Xu, Xu
