Gg, Gg, Rp, Rp, Gg, Gg, Gg, Gg, Gs^Fms, Gg, Hh, Hh, Hh, Hh, Hh, Hh, Hh, Hh, Hh, Hh, Hh, Hh, Gs^Fms, Gs, Gg, Gg, Gg, Gg, Gs, Gg, Hh^Fms, Hh^Fms, Hh, Hh, Hh^Fms, Hh, Mm, Mm, Mm, Mm, Mm, Hh, Hh, Hh, Hh^Fms, Hh, Hh, Hh, Hh^Fms, Gg^Fms, Gll, Gs, Gg, Gg, Gs, Hh, Hh^Fms, Hh, Hh, Hh, Hh, Hh, Hh^Fms, Hh, Hh, Hh, Gs, Gg, Gg, Gg, Wwt, Wot, Wwt
Gs, Gg, Rp, Rp, Rp, Gg, Gg^Es, Gs, Gs^Fms, Hh, Gll, Hh, Hh^Fms, Hh, Hh^Fms, Hh^Fms, Hh^Fms, Hh, Hh^Fms, Hh, Hh^Fms, Gs^Fms, Gs^Fms, Gs, Gs, Gg, Gg, Gs, Hh, Hh^Fms, Hh^Fms, Hh^Fms, Hh^Fms, Hh^Fms, Hh, Hh^Fms, Mm, Mm, Mm, Mm, Mm, Mm, Hh, Hh, Hh^Fms, Hh^Fms, Hh, Hh^Fms, Hh^Fms, Gs^Fms, Gs^Fms, Gs, Gg^Es, Gg, Gs, Hh, Hh^Fms, Hh^Fms, Hh^Fms, Hh^Fms, Hh, Hh^Fms, Hh, Hh^Fms, Hh, Gs, Gg, Gg^Es, Gg^Es, Gg, Wwt, Wot, Wwt
Gs^Fms, Gs, Gg, Rp, Rp, Rp, Gg, Gs, Gs, Gs^Fms, Gs^Fms, Gs^Fms, Gs^Fms, Hh^Fms, Hh, Hh, Hh^Fms, Hh^Fms, Hh^Fms, Hh, Hh, Gll, Gs^Fms, Gs^Fms, Gs^Es, Gg^Es, Gs, Gs, Hh^Fms, Hh^Fms, Hh^Fms, Hh, Hh^Fms, Hh, Hh^Fms, Hh, Mm, Mm, Mm, Mm, Mm, Mm, Hh, Hh, Hh^Fms, Hh^Fms, Hh^Fms, Hh^Fms, Gll, Gs^Fms, Gs, Gs, Gg, Gg, Gg, Gs, Gs^Fms, Hh^Fms, Gs^Fms, Hh, Gs, Hh, Gs^Fms, Hh^Fms, Gs^Fms, Gs, Gg, Gg, Wwt, Wwt, Wot, Wot, Wwt
Gs^Fms, Gs, Gg^Es, Gg, Rp, Rp, Rp, Gs, Gg^Es, Gs, Gg, Gll, Gll, Gs^Fms, Hh, Hh, Hh^Fms, Hh, Hh, Hh^Fms, Hh^Fms, Gs^Fms, Gs, Gs, Gg, Gg, Gs, Hh, Hh^Fms, Hh, Hh^Fms, Hh^Fms, Hh^Fms, Hh^Fms, Hh^Fms, Hh^Fms, Hh^Fms, Hh, Hh^Fms, Hh, Hh^Fms, Hh^Fms, Hh^Fms, Hh^Fms, Hh^Fms, Hh^Fms, Gs^Fms, Hh^Fms, Gs^Fms, Gs^Fms, Gs, Gg, Gs, Gs^Es, Gg, Gs, Gs, Gs^Fms, Gs, Gs, Gg, Gs, Gs, Gs^Fms, Wwt, Gg, Wwt, Wwt, Wot, Wot, Wwt, Wwt, Gg
Gs^Fms, Gs, Gs, Gg^Es, Gg^Es, Rp, Rp, Rp, Rp, Gg, Gg, Gs, Gg, Gs^Fms, Gll, Hh, Hh, Hh^Fms, Hh^Fms, Hh, Hh, Gs, Gg, Gg, Gg^Es, Gg, Gs, Gs^Fms, Hh, Hh^Fms, Hh, Hh^Fms, Hh^Fms, Hh^Fms, Hh, Hh^Fms, Hh^Fms, Hh^Fms, Hh^Fms, Hh^Fms, Hh^Fms, Hh^Fms, Hh^Fms, Hh^Fms, Gll, Gs^Fms, Gs^Fms, Gs^Fms, Gs, Gs, Gs^Es, Gg, Gg, Gg, Gg^Es, Gg, Gg, Gs, Gg, Gg, Wwt, Wwt, Wwt, Wwt, Wot, Wwt, Wot, Wot, Wwt, Wwt, Gg^Es, Gg^Es, Gg
Gg, Gs^Fms, Gs^Fms, Gs, Gs, Gg, Gs, Rp, Rp, Rp, Rp, Gg, Gg, Gs, Gs, Hh, Hh, Hh^Fms, Hh^Fms, Hh, Hh, Gs, Gg, Gg^Es, Gg, Gs, Gs^Fms, Gs^Fms, Gs^Vc, Hh^Fms, Hh^Fms, Hh, Hh^Fms, Hh^Fms, Hh^Fms, Hh^Fms, Hh^Fms, Hh, Hh^Fms, Hh^Fms, Hh^Fms, Hh^Fms, Hh^Fms, Hh^Fms, Gll, Gs^Fms, Gs, Gs, Gg, Gg, Gs, Gg, Gs, Gg, Gg^Es, Gs, Gg, Gg, Gg, Wwt, Wot, Wot, Wot, Wot, Wwt, Wot, Wwt, Wwt, Gs, Gs, Gs^Es, Gs, Gg
Gs^Fms, Gll, Gs^Fms, Gs^Fms, Gs^Fms, Gs, Gs, Gg^Es, Gg, Rp, Rp, Rp, Rp, Gg, Gg^Es, Re^Vct, Gs, Hh, Gs^Fms, Hh, Gs, Gs, Gg, Gg, Re^Vct, Gs, Gs, Gs^Fms, Gs^Fms, Gs^Fms, Hh^Fms, Hh^Fms, Hh^Fms, Hh^Fms, Hh^Fms, Hh, Hh, Hh^Fms, Hh^Fms, Hh^Fms, Hh^Fms, Hh^Fms, Hh^Fms, Hh^Fms, Hh^Fms, Gs^Fms, Gll, Gs, Gg, Gg^Es, Gg, Gg, Gs, Gg^Es, Gs, Gg, Gg, Gg, Wwt, Wwt, Wot, Wot, Wwt, Wwt, Gll, Wwt, Gs, Gg, Gs, Gs^Fms, Gs^Fms, Gs^Fms, Hh
Hh^Fms, Gs^Fms, Gll, Gs^Fms, Gll, Gs^Fms, Gs^Fms, Gs, Gg, Gg, Gs, Rp, Rp, Rp, Rp, Gg, Gs, Gs^Fms, Gs, Gs^Fms, Ce, Gg, Gg, Gg, Gg, Gg, Gg, Gs, Gs, Gll, Gs^Fms, Hh^Fms, Gll, Hh^Fms, Hh, Hh^Fms, Hh^Fms, Hh^Fms, Hh^Fms, Hh^Fms, Hh, Hh^Fms, Hh^Fms, Hh, Hh^Fms, Gs^Fms, Gs^Fms, Gs, Gg, Gg^Es, Gs, Gg, Gg, Gg^Es, Gs, Gg, Gg^Es, Gg, Wwt, Wot, Wwt, Wwt, Gll, Gll, Gs^Fms, Gs, Gs^Fms, Gs, Gll, Gs^Fms, Hh^Fms, Hh^Fms, Hh
Hh, Hh^Fms, Hh^Fms, Gs^Fms, Gll, Gs^Fms, Gs^Fms, Gs, Gs, Gg, Gg, Gg, Gs, Rp, Rp, Rp, Rp, Gs, Gg, Ce, 4 Ke, Ce, Gg^Es, Gg, Gg, Gg^Es, Gg, Gg, Gg, Gs, Gs, Gs^Fms, Gll, Gs, Gll, Gg^Fms, Gs^Fms, Hh^Fms, Hh^Fms, Hh^Fms, Hh^Fms, Hh^Fms, Hh^Fms, Hh^Fms, Gll, Gll, Gs^Fms, Gs, Gs, Gg^Es, Gg, Gg, Gg, Gg, Gs, Gs, Gg, Gg^Es, Wwt, Wot, Wwt, Gll, Gs^Fms, Gs^Fms, Hh^Fms, Hh, Hh, Hh, Hh^Fms, Hh, Hh^Fms, Hh^Fms, Hh
Hh, Hh, Hh^Fms, Hh^Fms, Hh, Gs^Fms, Gll, Gs, Gll, Gs, Gs, Gg, Ce, Gs, Gg, Rp, Rp, Rp, Rp, Ce, Ce, Ce, Rp, Gg, Rp, Rp, Rp, Rp, Rp, Gg, Gs, Gs^Fms, Gs^Fms, Gg, Gs^Fms, Gll, Gs^Fms, Gll, Gs^Fms, Gll, Gs^Fms, Hh, Hh^Fms, Hh^Vc, Gll, Gs^Fms, Gll, Gs, Gg, Gg, Gs^Es, Gg, Gs^Es, Gs, Gs, Gg, Gg, Gg, Wwt, Wot, Wwt, Gll, Gs^Fms, Hh^Fms, Hh, Hh^Fms, Hh^Fms, Hh^Fms, Hh^Fms, Hh^Fms, Hh, Hh, Hh
Hh, Hh, Hh, Hh, Hh^Fms, Gs^Fms, Gs^Fms, Gs^Fms, Gs^Fms, Gs^Fms, Gs^Fms, Ce, 1 Ke, Ce, Gg, Gg, Gs, Rp, Rp, Rp, Rp, Rp, Rp, Rp, Rp, Rp, Rp, Rp, Rp, Rp, Rp, Gs, Gs, Gs, Gs, Gs, Gs, Gg, Gs, Gs, Gs, Gs^Fms, Gs^Fms, Gll, Gs^Fms, Gs^Fms, Gs, Gs, Gs, Gs, Gg, Gg, Gg, Gg, Gg, Gg, Gg, Gg^Es, Wwt, Wot, Wwt, Gll, Gs^Fms, Hh^Fms, Hh, Hh^Fms, Hh^Fms, Hh^Fms, Hh, Hh, Hh, Hh, Hh
Hh, Hh, Hh, Hh, Hh^Fms, Gll, Gll, Gll, Gll, Gll, Gs^Fms, Ce, Ce, Ce, Gg, Gg^Es, Gg, Gs, Gg, Rp, Rp, Rp, Gg, Rp, Gs, Gg, Gg, Gg, Gg, Rp, Rp, Rp, Rp, Gg, Gg, Gg, Gs, Gs, Gs, Gg, Gg, Gs, Gs, Gs^Fms, Gs, Gs, Gg, Gg^Es, Gs, Gg, Gg, Gg, Wwt, Wwt, Wwt, Gg, Wwt, Wwt, Wot, Wot, Wwt, Gs, Gs, Hh^Fms, Hh^Fms, Hh^Fms, Hh^Fms, Hh, Hh, Hh, Hh, Hh, Hh
Hh, Hh^Fms, Hh^Fms, Hh, Hh^Fms, Hh, Gll, Gs^Fms, Gs^Fms, Gs^Fms, Gs^Fms, Gs^Fms, Gs, Gs, Gs, Gg^Es, Gg, Re^Vct, Gg, Gg, Gg, Gg, Gg, Gg, Gg^Es, Re^Vct, Gg, Gs, Gg^Es, Gg, Gg, Rp, Rp, Rp, Rp, Gg, Gg, Gg, Gg, Gs^Es, Gg, Gg, Gg, Gs, Gg, Gg, Gg, Gg, Gs, Gg, Wwt, Wwt, Wot, Wot, Wot, Wwt, Wot, Wot, Wwt, Wwt, Gg, Gg, Gs, Hh, Hh^Fms, Hh, Hh^Fms, Hh, Hh, Hh, Hh, Hh, Hh
Hh, Hh^Fms, Hh^Fms, Hh^Fms, Hh^Fms, Hh^Fms, Hh^Fms, Gll, Hh^Fms, Hh^Fms, Gs, Gs, Gg, Gg, Gg, Gs^Es, Gs, Gg, Gg, Gg, Gs, Gs^Es, Gs, Gg, Gs, Gg, Gs, Gs^Es, Gs, Gs^Es, Gs^Es, Gg, Gg, Rp, Rp, Rp, Rp, Gs, Gg, Gs, Gs, Gg^Es, Gs, Gg, Gg, Gg, Gg^Es, Gg^Es, Gs, Gs, Wwt, Wot, Wwt, Wwt, Wwt, Wot, Wwt, Wwt, Gg, Gg, Gs, Gs, Hh^Fms, Hh^Fms, Hh, Hh^Fms, Hh, Hh^Fms, Hh^Fms, Hh, Hh^Fms, Hh, Hh
Hh, Hh^Fms, Hh^Fms, Hh, Hh^Fms, Hh, Hh, Hh^Fms, Hh, Hh, Hh, Re^Vct, Gg, Gg, Gs, Gg^Es, Gg, Gg, Gg, Gs, Hh, Hh, Hh, Gs, Gs, Gs, Hh, Hh, Hh, Gs, Gs, Gs, Gg, Gg, Gs, Rp, Rp, Rp, Rp, Gg, Gg, Gs, Gs, Gg, Gs, Gs, Gg, Gs, Gg, Gs^Vc, Wwt, Wot, Wwt, Gs^Vc, Gg, Wwt, Gg, Gg, Gg, Gs, Gs^Fms, Hh^Fms, Hh, Hh, Hh^Fms, Hh, Hh^Fms, Hh^Fms, Hh^Fms, Hh^Fms, Hh^Fms, Hh^Fms, Hh^Fms
Hh, Hh, Hh^Fms, Hh^Fms, Hh^Fms, Hh^Fms, Hh^Fms, Hh^Fms, Hh^Fms, Hh, Hh, Gs, Gg, Gg^Es, Gg, Gg, Gs, Gs, Gg, Gs, Gs, Hh, Hh, Hh, Hh^Fms, Hh, Hh^Fms, Hh, Hh, Hh, Hh, Gs, Gg, Gg^Es, Gg, Gs, Gg, Rp, Rp, Gg, Gg, Gg, Gg^Es, Gg, Gg, Gg, Wwt, Gg, Wwt, Wwt, Wwt, Wwt, Gg, Gg, Gg, Gg, Gg, Gs^Es, Gs, Gs, Gs^Fms, Hh^Fms, Hh^Fms, Hh^Fms, Hh, Hh^Fms, Gll, Hh, Gll, Hh, Hh, Hh^Fms, Hh^Fms
Hh, Hh, Hh^Fms, Hh^Fms, Hh^Fms, Hh^Fms, Hh^Fms, Hh, Hh^Fms, Hh, Gs, Gs, Gs, Gg^Es, Gs, Gg, Gg, Gg, Gg, Gg, Gs, Hh^Vc, Hh, Hh, Hh^Fms, Hh^Fms, Hh^Fms, Hh, Hh, Hh, Hh, Gs, Gg, Gg, Gg, Gg^Es, Gs, Rp, Rp, Gg, Gg^Es, Gg, Gs^Es, Gg, Gg, Wwt, Wot, Wwt, Wot, Wot, Wwt, Wwt, Gg, Gg, Gs, Gs, Gg, Gg, Gg, Gs, Gs, Gll, Gs^Fms, Gs^Fms, Gs^Fms, Gll, Gs^Fms, Gs^Fms, Gs, Gll, Gs^Fms, Hh^Fms, Hh
Hh^Fms, Hh^Fms, Hh, Hh^Fms, Hh, Hh^Fms, Hh^Fms, Hh^Fms, Hh, Hh, Hh, Gs, Gg, Gg^Es, Gs, Gs, Gs, Gs, Gs, Gg^Es, Gg, Gs, Hh, Hh^Fms, Hh, Hh^Fms, Hh^Fms, Hh^Fms, Hh, Gs, Gs, Gs, Gg, Gg, Gg^Es, Gg^Es, Gs, Rp, Rp, Gg, Gg^Es, Gg, Gs, Gg, Wwt, Wwt, Wot, Wot, Wwt, Wwt, Gg^Efm, Gg, Gs, Gg, Gg, Gg, Gg^Es, Gg, Gg, Gg, Gg, Gs, Gs, Gs, Gs, Gs, Gs, Gs, Gg, Gs, Gs, Gs^Fms, Gs
Hh^Fms, Hh, Hh^Fms, Hh^Fms, Hh, Hh, Hh^Fms, Hh^Fms, Hh^Fms, Hh, Gs, Gs, Gs, Gs, Gs^Fms, Gs^Fms, Gs, Gg, Gs, Gg, Gs, Gs, Hh, Hh^Fms, Hh^Fms, Hh^Fms, Hh^Fms, Hh^Fms, Hh, Gs, Gg, Gg^Es, Gg, Gg, Gs, Gg, Gg, Rp, Rp, Gg, Gg, Gs^Es, Gg, Gg, Wwt, Wot, Wwt, Wwt, Gg^Efm, Gg^Efm, Gs^Efm, Gs, Gg, Gg, Gs, Gs^Es, Gs, Gg, Gs, Gs, Gg, Gg, Gs, Gs, Gs, Gg, Gg, Gg^Es, Gg, Gg, Gg, Gs, Gg
Hh, Hh^Fms, Hh^Fms, Hh^Fms, Hh^Fms, Hh, Hh^Fms, Hh, Hh^Fms, Hh, Hh^Vc, Gs, Gs, Gs^Fms, Gs^Fms, Gll, Gs^Fms, Gs, Gs^Fms, Gs, Gs, Hh, Hh, Hh, Hh^Fms, Hh^Fms, Hh, Hh, Gs, Gs, Gg^Es, Gg, Gg, Gs, Gg, Gg, Gg, Rp, Rp, Gg, Wwt, Gg, Wwt, Gg^Vhc, Wwt, Wot, Wwt, Gg^Efm, Wwt, Gg, Gg^Efm, Gs, Gg, Gg, Gg^Es, Gg, Gg, Gs^Vc, Gg, Gs, Gg, Gs, Gs^Fms, Gs^Fms, Gs^Fms, Gs, Gs, Gg^Es, Gg, Gg^Es, Gg^Es, Gg, Gg
Hh, Hh^Fms, Hh^Fms, Hh, Hh^Fms, Hh, Hh^Fms, Hh^Fms, Hh, Hh, Gs, Gs, Gs^Fms, Gll, Gs, Gll, Gg, Gll, Gll, Gs, Gg, Gs, Hh, Hh, Hh, Hh^Fms, Hh^Vhc, Hh, Gs, Gg^Es, Gg, Gg, Gg, Gs^Es, Gs, Gg, Wwt, Wwt^Bsb|, Wwt^Bsb|, Wwt, Cv, Wwt, Cv, Wwt, Kv, Wwt, Cv, Wwt, Kv, Wwt, Wwt, Gg, Gg, Gg, Gg, Gs, Gg, Gg, Gg, Gg, Gs, Gs, Hh^Fms, Hh^Fms, Hh^Fms, Gs^Fms, Hh, Gs, Gs, Gs, Gs^Es, Gg, Gg
Hh, Hh^Fms, Hh, Hh^Fms, Hh, Hh^Fms, Hh, Hh, Gs, Gs, Gs, Gs, Gll, Gll, Gll, Gs^Fms, Gll, Gs, Gs^Fms, Gg, Gg, Gs, Gs, Gs, Gs, Gs, Gs, Gs, Gg, Gg, Gg, Gg, Gg, Gs, Wwt, Wwt, Kv, Rp, Rp, Kv, Gs^Fms, Cv, Gs^Fms, Cv, Gg, Cv, Gg, Cv, Hh, Cv, Cv, Wwt, Wwt, Gg, Gg, Gs, Gg, Gg, Gg, Gg, Gs, Hh, Hh^Fms, Hh, Hh^Fms, Hh^Fms, Hh, Hh, Hh, Gs, Gs, Gg, Gg
Hh, Hh^Fms, Hh^Fms, Hh^Fms, Hh^Fms, Hh, Hh, Gs, Gs, Gs, Gs^Fms, Gg, Gs^Fms, Gs^Fms, Gs^Fms, Gll, Gs, Gs^Fms, Gs, Gs, Gg, Gg, Gg, Gg, Gg^Es, Gg, Gg, Gg, Gg, Gg, Wwt, Wwt, Wwt, Wwt, Cv, Cv, Gg, Rp, Rp, Gg, Gg, Gg, Gg, Gg, Gg, Gg, Cv, Hh, Hh^Fms, Hh, Hh, Cv, Kv, Wwt, Gg, Gg, Gg, Gs, Gs^Es, Gg, Gs, Hh, Hh^Fms, Hh^Fms, Hh, Hh^Fms, Hh^Fms, Hh^Fms, Hh^Fms, Hh, Gs^Fms, Gs, Gg
Hh, Hh, Hh, Hh, Hh, Hh, Hh, Hh, Gg, Gs, Gs^Fms, Gll, Gs, Gs, Gs, Gs, Gg, Gs, Gg, Gg, Gg, Gg^Es, Gg, Gg^Es, Gg, Gs^Es, Gs, Gs, Gg, Wwt, Kv, Kv, Cv, Cv, Gg, Gg, Rp, Rp, Gg, Rp, Rp, Rp, Rp, Gg, Gg, Cv, Kv, Cv, Hh, Hh^Fms, Hh^Fms, Hh, Cv, Wwt, Gg, Gg, Gg, Gg^Es, Gg, Gg, Gg, Gs, Gs, Hh, Gs^Fms, Hh, Hh^Fms, Hh, Hh^Fms, Hh, Hh, Gs, Gg
Gs, Gs, Gs, Gs, Gs, Gs, Gs, Gg, Gs, Gs, Gs^Fms, Gs, Gg, Gg, Gg^Es, Gg, Gg, Gg, Rp, Gg, Rp, Rp, Rp, Gg, Gs, Gs, Gg, Gg, Gg, Wwt, Cv, Gs^Fms, Gg, Gg, Rp, Rp, Gg, Gg, Rr^Vhc, Gg, Rp, Gs^Fms, Wwt, Rp, Rp, Cv, Cv, Cv, Hh, Hh^Fms, Hh, Hh, Cv, Wwt, Gg, Gg, Gs, Gs, Gg, Gs, Gs, Gg^Es, Gg, Gs, Gs^Fms, Hh, Hh^Fms, Hh, Hh^Fms, Hh^Fms, Hh, Gs, Gg
Gg, Gg, Gg^Es, Gg, Gg, Gg, Gg^Es, Gg, Gg, Gs^Es, Gs, Gs, Gg, Gg^Es, Rp, Rp, Rp, Rp, Rp, Rp, Rp, Rp, Rp, Rp, Rp, Gg, Wwt, Wwt, Wwt, Wwt, Cv, Gg, Rp, Rp, Gg, Gg, Gg, Gs^Fms, Wwt, Wwt, Wwt^Bsb|, Wwt, Hh^Fms, Wwt, Wwt, Rp, Rp, Hh, Hh^Fms, Hh^Fms, Hh^Fms, Hh, Cv, Wwt, Gg, Gg, Gg, Gs, Gg, Gg, Gg, Gs^Vc, Gs, Gs, Gs^Fms, Hh^Fms, Hh, Hh, Hh^Fms, Hh, Hh, Gs, Gs
Rp, Gg, Rp, Gg, Rp, Gg, Rp, Gg, Rp, Gg, Rp, Gg, Rp, Rp, Rp, Rp, Rp, Rp, Gg, Rp, Gg, Gg, Gg, Rp, Rp, Wwt^Bsb\, Gg, Kv, Cv, Cv, Rp, Rp, Cv, Cv, Cv, Hh^Fms, Wwt, Wwt, Hh^Fms, Hh, Hh^Bsb|, Hh^Fms, Hh^Fms, Wwt, Hh^Fms, Wwt, Rr^Vhc, Rp, Rp, Gg, Gg, Hh, Kv, Wwt, Wwt, Gg, Gg, Gg, Gg, Gs, Gs, Gs, Gs, Gs, Hh, Hh^Fms, Hh, Hh, Hh^Fms, Hh, Gs, Gs, Gg
Rp, Rp, Rp, Rp, Rp, Rp, Rp, Rp, Rp, Rp, Rp, Rp, Rp, Rp, Gg, Gg, Gg, Gg, Gg, Gg, Gg, Gg, Rb, Rb, Wwt, Wwt^Bsb\, Gg, Gg, Gg, Rp, Hh, Hh, Cv, 3 Kv, Cv, Wwt, Hh, Hh^Fms, Cv, Cv, Kv, Cv, Cv, Hh^Fms, Hh^Fms, Wwt, Wwt, Gg, Rp, Gg, Gg, Gg, Rr^Vhc, Cv, Cv, Wwt, Gg, Gg, Gs^Es, Gg, Gg^Es, Gs, Gs^Fms, Hh^Fms, Hh, Hh^Fms, Hh, Hh, Hh^Fms, Hh, Gs, Gg, Gg
Gg, Rp, Gg, Rp, Gg, Rp, Gg, Rp, Gg, Rp, Gg, Rp, Gs, Rb, Gg, Gg^Es, Gs, Gg^Es, Gs, Gs, Gs, Gg, Rb, Gg^Es, Wwt, Kv, Cv, Gg, Gg, Rp, Hh^Fms, Hh^Fms, Hh, Cv, Wwt, Wwt, Hh, Cv, Hh^Fms, Hh^Fms, Cv, Hh^Fms, Hh^Fms, Cv, Hh, Hh, Hh, Wwt, Gg, Rp, Rp, Gg, Gg, Gs^Fms, Kv, Wwt, Rp, Gs, Gg, Gg, Gg, Gs, Gs^Fms, Hh^Fms, Hh^Fms, Hh^Fms, Hh^Fms, Hh^Fms, Hh, Hh^Fms, Hh, Gs, Gg
Gg, Gg, Gg^Es, Gg, Gs, Gg^Es, Gs, Gg^Es, Gg, Gg^Es, Gs, Gs, Gs^Fms, Rb, Rb, Gs, Hh, Gs, Hh, Hh, Hh, Gs, Gs, Rb, Gg, Wwt, Wwt, Cv, Gg, Rp, Hh, Hh^Fms, Hh^Fms, Wwt, Hh^Fms, Hh^Fms, Cv, Kv, Cv, Hh^Ve, Cv, Hh^Ve, Cv, Kv, Cv, Hh, Hh, Wwt, Gs^Fms, Gg, Gg, Rp, Gg, Gg, Rp, Wwt^Bsb/, Gg, Rp, Rp, Gg, Gg, Gs^Es, Gs, Gs^Fms, Gs^Fms, Hh^Fms, Hh^Fms, Hh^Fms, Hh^Fms, Hh^Fms, Gs, Gs, Gg
Gg, Gg, Gs^Es, Gs, Hh, Gs, Hh, Gs, Gg, Gs, Gs^Fms, Gs^Fms, Gs^Fms, Gs, Rb, Hh, Hh, Hh^Fms, Hh^Fms, Hh, Hh, Hh^Vhc, Gs, Rb, Gg, Gg, Wwt, Cv, Gg, Rp, Rr^Vhc, Hh^Fms, Hh, Wwt, Hh^Fms, Hh, Cv, Hh^Fms, Hh^Ve, Cv, 2 Kv, Cv, Hh^Ve, Hh^Fms, Cv, Hh^Fms, Hh^Fms, Wwt, Gs^Fms, Gs^Fms, Gg, Rp, Rp, Rp, Rp, Wwt, Gg, Rp, Rp, Rp, Rp, Gg, Gg, Gs, Gll, Hh, Hh, Hh, Hh^Fms, Hh, Gs^Fms, Gs, Gg
Gg^Es, Gg, Gs, Hh, Hh, Hh, Hh, Gs, Gs, Gs, Gs^Fms, Gll, Gll, Gs, Rb, Hh, Hh, Hh^Fms, Hh^Fms, Hh^Fms, Hh^Fms, Hh, Gs, Rb, Gg^Es, Gg, Wwt, Cm^Bsb|, Wwt, Rp, Wwt, Gs^Fms, Gs^Fms, Wwt, Hh, Hh, Cv, Hh^Fms, Cv, Cv, Cv, Cv, Cv, Hh^Fms, Cv, Hh^Fms, Hh, Wwt, Hh^Fms, Gs^Fms, Gg, Rp, Rr^Vhc, Gg, Kv, Wwt^Bsb\, Rp, Rp, Gg, Rp, Rp, Rp, Rp, Gs, Gs^Fms, Hh^Fms, Hh^Fms, Hh^Fms, Hh^Fms, Hh^Fms, Gs^Fms, Gs, Gg
Gg, Gg, Gg, Gs, Gs, Hh, Hh^Fms, Hh, Hh, Gs, Gll, Gs^Fms, Gs^Fms, Gs^Fms, Rb, Hh, Hh, Hh, Hh^Fms, Hh, Hh^Fms, Hh, Gs, Rb, Gg^Es, Gg, Wwt, Cv, Gg, Wwt^Bsb|, Gg, Wwt, Wwt, Wwt, Wwt, Hh^Fms, Hh^Fms, Kv, Hh^Fms, Hh^Ve, Cv, Hh^Ve, Hh^Fms, Kv, Hh^Fms, Hh^Fms, Wwt, Wwt, Hh^Fms, Hh, Gg, Rp, Rp, Gg, Cv, Wwt, Gg, Gg, Gs, Gg, Gg, Rp, Rp, Gs, Gs^Fms, Gs^Fms, Gs^Fms, Gs^Vc, Gs^Fms, Gll, Gs^Fms, Gs, Gg
Gg, Gg^Es, Gg, Gs, Hh, Hh, Hh^Fms, Hh^Fms, Hh, Gs, Gs, Gs^Fms, Gs^Fms, Gs, Rb, Gs, Hh, Hh, Gs, Hh^Fms, Hh, Hh, Gs, Rb, Gg, Gg, Wwt, Kv, Cv, Rp, Rp, Gg, Rp, Rr^Vhc, Wwt, Hh^Fms, Hh^Fms, Cv, Cv, Hh^Fms, Kv, Hh^Fms, Cv, Cv, Hh^Fms, Hh, Wwt, Hh^Fms, Hh^Fms, Hh^Fms, Hh, Gg, Rp, Gg, Cv, Wwt, Gg, Gs, Gg, Gg^Es, Gs, Rp, Rp, Gs, Gs, Gs, Gs, Gs^Fms, Gs, Gs, Gs, Gs, Gg
Gg, Gg^Es, Gs, Gs, Hh, Hh^Fms, Hh^Fms, Hh^Fms, Hh, Gs, Gg, Gs, Gs, Gs, Rb^Gvs, Gs, Gg, Gs, Gg, Gs, Wwf, Gs, Gg, Rb, Gg^Es, Gg, Gg, Wwt, Wwt, Cv, Cv, Rp, Gg, Rp, Gs^Fms, Wwt, Hh, Hh, Hh^Fms, Cv, Hh^Bsb|, Cv, Hh^Fms, Hh, Wwt, Wwt, Hh, Hh, Cv, Cv, Cv, Gs^Fms, Rp, Gg, Cv, Wwt, Gg, Gs^Es, Gg, Gg, Gg, Rp, Rp, Rp, Gg, Gg, Gg^Es, Gs, Gg^Es, Gg, Gg, Gg, Gs
Gg, Gg, Gs, Hh, Hh, Hh, Hh, Hh, Hh, Gs, Gg, Gg, Rb^Gvs, Rb^Gvs, Rb^Gvs, Rb^Gvs, Gg^Vwm, Gg, Wwf, Wwf, Rb^Gvs, Rb^Gvs, Rb^Gvs, Rb, Gg, Gg, Wwf, Wwf, Gg, Wwt, Kv, Gg, Gg, Rp, Rp, Wwt, Wwt, Hh^Fms, Hh^Fms, Hh, Hh^Bsb|, Hh^Fms, Hh^Fms, Hh, Wwt, Hh, Hh^Fms, Hh, Cv, Kv, Cv, Gs^Fms, Rp, Gs^Fms, Kv, Wwt, Gg, Gg^Es, Gg, Gg, Gg, Gg, Rp, Rp, Rp, Gs, Gg, Gg, Gg, Gg^Es, Gs, Gs, Gg
Gs, Gs, Gs, Gs, Gs, Gs, Gs, Gs, Gs, Gs, Gg, Gg, Gg, Rb^Gvs, Rb^Gvs, Rb^Gvs, Wwf, Wwf, Wwf, Rb^Gvs, Rb^Gvs, Rb^Gvs, Rb^Gvs, Rb^Gvs, Wwf, Wwf, Rb^Gvs, Gg, Gg, Wwt, Wwt, Cv, Gs^Fms, Gg, Gg, Rp, Gg, Wwt, Wwt, Wwt, Wwt^Bsb|, Wwt, Wwt, Wwt, Hh^Fms, Hh^Fms, Hh, Hh, Hh^Fms, Cv, Rp, Rp, Rr^Vhc, Cv, Wwt, Wwt, Gg, Gg, Rb^Gvs, Rb^Gvs, Rb^Gvs, Rb, Gg, Rp, Rp, Rp, Rp, Gs, Gs, Gs, Gg, Gg^Es, Gg
Gs^Fms, Gs^Fms, Gs^Fms, Gs^Fms, Gs^Fms, Gs, Gs, Gg, Gs^Vc, Gg, Gs, Gg, Gg, Gg, Wwf, Wwf, Rb^Gvs, Gg^Vwm, Rb^Gvs, Wwf, Wwf, Gg^Vwm, Wwf, Wwf, Gg^Vwm, Rb^Gvs, Rb^Gvs, Rb^Gvs, Rb^Gvs, Gg, Wwt, Kv, Cv, Gg, Gg, Rp, Rp, Gg, Gg, Gg, Rp, Gg, Hh^Fms, Hh^Fms, Hh, Hh^Fms, Hh^Fms, Hh^Fms, Hh, Rp, Gs^Fms, Gs^Fms, Cv, Kv, Wwt, Wwf, Wwf, Rb^Gvs, Rb^Gvs, Rb^Gvs, Rb^Gvs, Rb^Gvs, Wwf, Gg, Gg, Rp, Rp, Rp, Rp, Gg, Gg, Gg^Es, Gg
Gs^Fms, Gll, Gll, Gll, Gll, Gs^Fms, Gs, Gg, Gg, Gs^Efm, Gg, Gg^Efm, Gg^Efm, Gg, Gg, Rb^Gvs, Rb^Gvs, Rb^Gvs, Rb^Gvs, Rb^Gvs, Gg, Wwf, Gg, Gg, Gs, Rb^Gvs, Rb^Gvs, Rb^Gvs, Gg, Gg, Gg, Wwt, Wwt, Cv, Gs^Fms, Rr^Vhc, Gg, Rp, Rp, Gg, Rp, Gg, Rp, Gs^Fms, Rp, Hh, Rp, Rp, Rp, Rp, Kv, Cv, Wwt, Wwt, Gg, Gg, Rb^Gvs, Wwf, Wwf, Gg^Vwm, Wwf, Wwf, Rb^Gvs, Rb^Gvs, Rb^Gvs, Gg, Rb, Rp, Rp, Rp, Rp, Gg, Gg
Gs^Fms, Gs^Fms, Gs^Fms, Gll, Gs^Fms, Gs^Fms, Gs, Gg^Efm, Gg, Gg, Gg, Gg, Gg, Gs^Efm, Gg, Gg, Gg, Rb^Gvs, Gg, Gg, Gg, Gg, Gs, Gs, Hh, Gs, Gg, Rb, Rb, Gg, Gg, Gg, Wwt, Kv, Cv, Gs^Fms, Cv, Gg, Gg, Rp, Rp, Rp, Gg, Rp, Gs^Fms, Rp, Gs^Fms, Gs^Fms, Cv, Cv, Wwt, Wwt, Gg, Gg, Rb^Gvs, Rb^Gvs, Rb^Gvs, Rb^Gvs, Gg^Vwm, Wwf, Wwf, Gg^Vwm, Rb^Gvs, Rb^Gvs, Rb^Gvs, Rb^Gvs, Gg, Gg, Gg, Rp, Rp, Gg, Gg
Gg, Gll, Gs, Gs, Gs, Gs^Fms, Gs, Gg^Efm, Gs, Gg^Efm, Gg, Gg, Gg^Efm, Gg^Efm, Gg, Gs, Gs, Gg, Gg, Gg, Gg, Gs, Gs, Hh, Hh, Gs, Gg, Gg, Gg^Es, Rb, Rb, Gg, Gg, Wwt, Wwt, Kv, Wwt, Cv, Kv, Gg, Rp, Gg, Kv, Cv, Cv, Cv, Kv, Cv, Wwt, Wwt, Gg, Gg, Gg, Gg, Gg, Rb^Gvs, Rb^Gvs, Rb^Gvs, Wwf, Wwf, Gg^Vwm, Wwf, Wwf, Rb^Gvs, Gg, Gg, Gg, Gg^Es, Gg, Rp, Rp, Gg, Gg
Gg, Gll, Gs^Fms, Gs, Gs, Gll, Gs, Gs, Gs^Fms, Gs, Gg, Gg, Gg, Gg^Efm, Gg, Gg, Gg, Gg, Gg, Gg^Es, Gg^Es, Gs, Hh, Hh, Hh, Gs, Gs, Gg, Gg, Gg, Rb, Gg, Gg^Es, Gg, Gg, Wwt, Gg, Wwt, Wwt, Rp, Wwt^Bsb|, Rp, Wwt, Wwt, Wwt, Wwt, Wwt, Wwt, Gg, Gg, Gg^Es, Gg^Es, Gs, Gg^Es, Gs, Gg^Es, Gg, Wwf, Rb^Gvs, Rb^Gvs, Rb^Gvs, Rb^Gvs, Rb^Gvs, Wwf, Wwf, Gg, Gg, Gg^Es, Gg, Rp, Rp, Gg, Gg
Gs^Fms, Gs^Fms, Gs^Fms, Gs^Fms, Gs, Gs, Gs, Gs^Fms, Hh, Gs, Gs, Gs, Gs, Gg^Efm, Gs, Gg, Gg, Gs, Gg, Gg, Gg^Es, Gs, Hh, Hh^Fms, Hh^Fms, Hh^Fms, Hh^Fms, Gs, Gs, Gs, Gs, Rb, Rb, Gg^Es, Gs, Gg, Gg, Gg, Gg, Wwt^Bsb|, Rp, Wwt^Bsb|, Gg, Gg, Gs, Gg, Gs, Gg, Gs, Gs, Gs, Gs, Hh, Gs, Hh, Gs, Gs, Gg, Gg, Rb^Gvs, Rb^Gvs, Rb^Gvs, Wwf, Wwf, Gg^Vwm, Wwf, Wwf, Gg, Gg, Rp, Rp, Rp, Rp
Gg, Gll, Hh^Fms, Hh, Hh^Fms, Hh, Hh, Hh, Hh^Fms, Hh, Hh, Hh, Hh, Gs, Gs^Fms, Gs, Gs, Gg, Gg, Gg, Gg, Gs, Gs, Hh^Fms, Hh^Fms, Hh^Fms, Hh, Hh^Fms, Hh^Fms, Hh^Vc, Hh, Gs, Gs, Rb, Rb, Gs^Es, Rb, Gg, Gs, Rp, Rp, Rp, Gg, Gs, Gg, Gg, Gg, Gg, Gs, Gs, Hh, Hh, Hh, Hh, Hh, Hh, Hh, Gs, Gg, Gg, Gg, Wwf, Rb^Gvs, Rb^Gvs, Rb^Gvs, Rb^Gvs, Rb^Gvs, Wwf, Gg, Gg, Gg, Rp, Rp
Gg, Hh^Fms, Hh, Hh, Hh^Fms, Hh, Hh^Fms, Hh^Fms, Hh, Hh^Fms, Hh^Fms, Hh^Fms, Hh^Fms, Hh, Hh^Fms, Gs^Fms, Gs, Gs, Gs, Gg, Gg, Gg, Gs, Hh, Hh, Hh^Fms, Hh^Fms, Hh^Fms, Hh, Hh^Fms, Hh^Fms, Hh, Hh, Gs, Gs, Rb, Gg^Es, Rb, Rb, Rp, Rp, Rp, Gg, Gs, Gg, Gg^Es, Gs, Gs, Hh, Hh, Hh^Fms, Hh, Hh^Fms, Hh^Fms, Hh^Fms, Hh, Hh, Gs, Gs, Gg, Gg, Gg, Gg, Rb^Gvs, Rb^Gvs, Rb^Gvs, Gg, Gg, Gs, Gs, Gs, Gg, Gg
Hh, Hh^Fms, Hh^Fms, Hh^Fms, Hh^Fms, Hh^Fms, Hh, Hh, Mm, Hh, Mm, Hh, Hh^Fms, Hh, Hh^Fms, Hh, Hh, Hh, Hh, Gs, Gg, Gg, Gg^Es, Gs, Gs, Hh, Hh, Hh^Fms, Hh^Fms, Hh, Hh^Fms, Hh^Fms, Hh^Fms, Hh, Gs, Gg, Gg, Gg, Gs, Rp, Rp, Rp, Gg, Gs, Gs, Gg^Es, Gs, Hh, Hh, Hh, Hh, Hh^Fms, Hh^Fms, Hh^Fms, Hh^Fms, Hh^Fms, Hh^Fms, Hh, Hh, Gs, Gs, Gg^Es, Gg, Gg, Gg, Gg, Gg^Efm, Gg, Gg^Efm, Gs^Efm, Gg, Gg, Gg
Hh^Fms, Hh^Fms, Hh^Fms, Hh, Hh, Hh, Mm, Mm, Mm, Mm, Mm, Mm, Hh, Hh^Fms, Hh^Fms, Hh^Fms, Hh^Fms, Hh, Hh, Gs, Gs, Gg, Gg, Gg, Gg, Gs, Hh, Hh^Fms, Hh, Hh, Hh^Fms, Hh^Fms, Hh^Fms, Hh, Gs, Gg^Es, Gg, Gg, Gs, Rp, Rp, Rp, Gg, Gg, Gs^Es, Gg, Gs, Hh, Hh, Hh^Fms, Hh, Hh^Fms, Hh^Fms, Mm, Mm, Hh, Hh^Fms, Hh, Hh, Hh, Gs, Gg, Gg^Es, Gg, Gg, Gg, Gs, Gs, Gg, Gs^Efm, Gs, Gg, Gg
Hh, Hh^Fms, Hh^Fms, Hh^Fms, Hh, Mm, Mm, Mm, Mm, Mm, Mm, Mm, Hh, Hh^Fms, Hh, Hh, Hh^Fms, Hh, Hh, Hh, Gs, Gg, Gg, Gg^Es, Gg, Gs, Hh, Hh^Fms, Hh, Hh^Fms, Hh, Hh^Fms, Hh^Fms, Hh, Gs, Gg, Gg, Gs, Gg, Rp, Rp, Rp, Gg, Gg, Gs^Es, Gg, Gs, Hh, Hh, Hh^Fms, Hh^Fms, Hh^Fms, Hh^Fms, Mm, Mm, Mm, Hh^Fms, Hh^Fms, Hh, Hh, Hh, Gs, Gg, Gg, Gs^Efm, Gs, Gg, Gg^Efm, Gg^Efm, Gg, Gg, Gg, Gg
Mm, Mm, Mm, Mm, Mm, Mm, Mm, Mm, Mm, Mm, Mm, Mm, Hh, Hh^Fms, Hh, Hh, Hh^Fms, Hh, Hh, Hh, Gs, Gg, Gg, Gg^Es, Gg, Gs, Gs, Gs, Gs, Hh, Gs, Hh^Fms, Hh, Hh, Gs, Gg, Gs, Gg^Es, Gg^Es, Rp, Rp, Rp, Gg, Gg, Gg, Gs, Hh, Hh, Hh, Hh, Hh^Fms, Hh, Hh^Fms, Mm, Mm, Mm, Hh, Hh^Fms, Hh, Hh, Hh, Gs, Gg, Gg, Gs, Gg, Gg^Efm, Gg^Efm, Gg^Efm, Gg, Gg, Gs, Gg
Mm, Mm, Mm, Mm, Mm, Mm, Mm, Mm, Mm, Mm, Mm, Mm, Mm, Hh^Fms, Hh^Fms, Hh^Fms, Hh^Fms, Hh, Hh, Hh, Gs, Gg, Gg, Gg, Gg, Gg^Es, Gg^Es, Gg^Es, Gg, Gs, Gg, Gs, Gs, Gs, Gg, Gg, Gs, Gg^Es, Gg, Rp, Rp, Rp, Gg, Gg, Gg, Gs, Gs, Hh, Hh, Hh, Hh, Hh, Hh^Fms, Hh^Fms, Hh, Hh^Fms, Hh^Fms, Hh^Fms, Hh, Hh, Hh, Gs, Gg, Gg, Gg, Gg^Efm, Gs, Gg, Gg, Gg, Gg, Gs, Gg
Mm, Mm, Mm, Mm, Mm, Mm, Mm, Mm, Mm, Mm, Mm, Mm, Mm, Mm, Hh, Hh^Fms, Hh, Hh, Hh, Hh, Gs, Gg, Gg, Gg, Gg, Gg, Gg, Gg, Gg, Gg, Gg, Gg, Gg, Gg, Gg, Gg, Gg, Gg, Gg, Rp, Rp, Rp, Gg, Gg, Gg, Gg, Gg, Hh, Hh, Hh, Hh^Fms, Hh^Fms, Hh, Hh^Fms, Hh^Fms, Hh^Fms, Hh, Hh, Hh, Hh, Hh, Gs, Gg, Gg, Gg, Gg, Gg, Gg, Gg, Gg, Gs, Gg, Gg
