Gs^Fms, Gs^Fms, Gs^Fms, Gs^Fms, Gg^Fms, Gg, Hh^Fms, Hh, Hh^Fms, Hh, Hh^Fms, Gg, Gs^Fms, Hh, Hh^Fms, Gg, Gll, Gs^Fms, Gs, Gg, Gg, Gg, Gs, Gg, Gg, Gg, Gs, Gg, Gg, Gg, Gg, Gg, Gs, Gg, Gs, Gg, Gg, Gg, Gg, Gg, Gg, Gg, Gs, Gg, Gll, Gg, Gs^Fms, Gg, Gs, Gg, Gg, Gg, Wwt, Wwt, Wwt, Gg, Gg, Gs, Gs^Fms, Gg, Hh^Fms, Hh^Fms, Hh, Hh, Hh, Hh, Hh, Hh, Hh, Hh
Gs^Fms, Gs^Fms, Hh, Hh, Hh^Fms, Hh^Fms, Hh, Hh, Mm, Mm, Mm, Hh^Fms, Hh^Fms, Hh^Fms, Hh, Hh^Fms, Hh^Fms, Gs^Fms, Gs^Fms, Gs, Gs, Gg, Gg, Gs, Gg, Gs, Gs, Gg, Gs, Gs, Gs, Gs, Gs, Gs, Gs, Gs, Gs, Gs, Gs, Gs, Gs, Gs, Gs^Fms, Gs^Fms, Gs^Fms, Gs^Fms, Gll, Gs^Fms, Gs, Gg, Gg, Gg, Wwt, Wwt, Wwt, Gg, Gg, Gs, Gs^Fms, Gs^Fms, Hh^Fms, Hh^Fms, Hh^Fms, Hh, Hh, Hh, Hh, Hh, Hh, Hh
Gs^Fms, Gs^Fms, Hh^Fms, Hh^Fms, Mm, Mm, Mm, Mm, Mm, Mm, Mm, Mm, Mm, Mm, Mm, Hh, Hh, Gs^Fms, Gs^Fms, Gs^Fms, Gs^Fms, Gs, Gs, Gg, Gs, Gs, Gs, Gs, Gs, Gg, Gs, Gg, Gs, Gg, Gs, Gs, Gg, Gg, Gs, Gs, Gs, Gs^Fms, Gll, Gll^Vc, Gs^Fms, Gs^Fms, Gs^Fms, Gll, Gs, Gg, Gg, Wwt, Wwt, Wwt, Wwt, Gg, Gg, Gs, Gs^Fms, Gll, Gll, Hh^Fms, Hh^Fms, Hh, Hh^Fms, Hh, Hh, Hh, Hh, Hh
Gs^Fms, Hh, Hh^Fms, Hh, Mm, Mm, Mm, Mm, Cv, Cv, Cv, Mm, Mm, Mm, Mm, Mm, Hh^Fms, Hh, Gll, Gs^Fms, Gs^Fms, Gs, Gs, Gs, Gs, Gg, Gs, Gs, Gs, Gg, Gs, Gs, Gs^Fms, Gll, Gs^Fms, Gg, Gg, Gg, Gs, Gg, Gg, Gs, Gs, Gs^Fms, Gs^Fms, Gs^Fms, Gs^Fms, Gs^Fms, Gs, Gg, Gg, Wwt, Wwt, Wwt, Wwt, Wwt, Gg, Gs, Gs, Gs^Fms, Gs, Gs^Fms, Gs^Fms, Hh, Hh^Fms, Hh^Fms, Hh, Hh, Hh, Hh
Hh^Fms, Hh^Fms, Hh, Mm, Mm, Mm, Cv, Cv, Rp, Rr^Vhc, Rp, Cv, Kv, Mm, Mm, Mm, Hh^Fms, Hh, Gll, Gll, Gll, Gs, Gs, Gg, Gs, Gs^Vc, Gs, Gs, Gg, Gs, Gs^Fms, Gs^Fms, Gll, Gs^Fms, Gs^Fms, Gs, Gs, Gg, Gs, Gg, Gs, Gs, Gs, Gs, Gs, Gll, Gg, Gs, Rb^Gvs, Gg, Gg, Gg, Wwt, Wwt, Wwt, Wwt, Wwt, Gg, Gg, Gs, Gs, Gs, Gs^Fms, Gll, Gs^Fms, Hh^Fms, Hh^Fms, Hh, Hh^Fms, Hh^Fms
Hh^Fms, Hh^Fms, Mm, Mm, Mm, Cv, Rr^Vhc, Rp, Rp, Rp, Rp, Rr^Vhc, Kv, Mm, Hh, Hh^Fms, Hh^Fms, Hh^Fms, Gs^Fms, Gs^Fms, Gs^Fms, Gs^Fms, Gs, Gg, Gs, Gs, Gg, Gs, Gg, Gs, Hh^Fms, Gs^Fms, Hh, Gg^Fms, Hh^Fms, Gs^Fms, Hh, Gs, Gs, Gs, Gg, Gs, Gg, Gg, Gg, Gg, Rb^Gvs, Rb^Gvs, Rb^Gvs, Rb^Gvs, Rb^Gvs, Gg, Gg, Wwt, Wwt, Wwt, Wwt, Wwt, Wwt, Gg, Gs, Gs, Gs^Fms, Gll, Gs^Fms, Hh, Hh^Fms, Hh, Hh^Fms, Hh
Hh^Fms, Hh^Fms, Mm, Mm, Mm, Cv, Rp, Rp, Cv, Cv, Cv, Cv, Hh, Hh, Hh, Hh^Fms, Hh^Fms, Gg^Fms, Gll, Gs^Fms, Gll, Gs^Fms, Gs, Gs, Gg, Gg, Gs, Gs, Gg, Gs, Hh^Fms, Hh, Hh^Fms, Hh^Fms, Hh^Fms, Hh^Fms, Hh^Fms, Gg^Fms, Gs, Gg, Gg, Gg, Rb^Gvs, Gg, Wwf, Rb^Gvs, Rb^Gvs, Rb^Gvs, Rb^Gvs, Rb^Gvs, Rb^Gvs, Rb^Gvs, Wwf, Wwf, Gg, Wwt, Wwt, Wwt, Wwt, Gg, Gg, Gs, Gs^Fms, Gs^Fms, Gll^Vc, Hh, Hh, Hh^Fms, Hh^Fms, Gg
Hh^Fms, Hh^Fms, Mm, Mm, Mm, Cv, Rr^Vhc, Rp, Cv, 3 Kv, Cv, Hh, Hh, Hh, Hh, Hh, Hh^Fms, Gll, Gs, Gs^Fms, Gs, Gs, Gg, Gs, Gg, Gs, Gg, Gg, Gg, Gs, Gll, Hh^Fms, Gll, Hh^Fms, Hh^Fms, Hh^Fms, Hh, Hh^Fms, Gg^Fms, Gs, Rb^Gvs, Rb^Gvs, Rb^Gvs, Rb^Gvs, Gg^Vwm, Wwf, Wwf, Rb^Gvs, Gg^Vwm, Rb^Gvs, Wwf, Wwf, Gs^Fms, Gs^Fms, Gs, Wwt, Wwt, Wwt, Wwt, Gg, Gg, Gs, Gs, Gs, Gs^Fms, Gs^Fms, Gll, Gs^Fms, Gs^Fms, Gg
Hh, Hh, Mm, Mm, Mm, Kv, Kv, Cv, Hh, Cv, Rp, Cv, Cv, Hh, Hh, Hh, Gs, Gg, Gg, Gs, Gg, Gg, Gg, Gs, Gs, Gs, Gs, Gg, Gg, Gs, Gs^Fms, Gll, Gs^Fms, Gg^Fms, Hh, Hh, Hh, Hh, Hh^Fms, Gg, Gs, Rb^Gvs, Rb^Gvs, Rb^Gvs, Gg, Gg, Gg, Wwf, Wwf, Wwf, Gs, Gs^Fms, Gs^Fms, Gs^Fms, Gs, Wwt, Wwt, Wwt, Gg, Gg, Gs, Gs, Gg, Gs, Gs, Gs^Fms, Gs^Fms, Gs^Fms, Gs^Fms, Gs^Fms
Hh, Hh, Mm, Mm, Mm, Mm, Hh, Hh, Hh, Cv, Rp, Rp, Gg, Cv, Cv, Hh, Kv, Gs, Gs, Gg, Gg, Gg, Kv, Gg, Gs, Gg, Gs, Gg, Gg, Gs, Gs^Fms, Gs^Fms, Gll, Gs^Fms, Hh, Hh, Gs^Fms, Hh, Hh^Fms, Gll, Gs^Fms, Gg, Gg, Gg, Gg, Gg, Rb^Gvs, Wwf, Wwf, Ss, Gg, Gll^Vc, Gs^Fms, Gs^Fms, Gs, Wwt, Wwt, Wwt, Gs, Gs, Gg, Gs, Gs, Gg, Gg, Gs, Gs, Gs, Gs, Gg
Hh, Hh, Hh, Hh, Hh, Mm, Hh, Hh, Hh, Cv, Gg, Rp, Rp, Gg, Cv, Cv, Gs, Cv, Cv, Gs, Gs, Gg, Gg, Cv, Cv, Gg, Gg, Gs, Gg, Gs, Gs, Gs^Fms, Gll, Hh^Fms, Hh, Gs^Fms, Gs^Fms, Hh, Hh, Hh^Fms, Gll, Gs^Fms, Gs, Gg, Rb^Gvs, Rb^Gvs, Rb^Gvs, Rb^Gvs, Rb^Gvs, Wwf, Wwf, Gs^Fms, Gg, Gg, Wwt, Wwt, Wwt, Wwt, Gs, Gg, Gs, Gs, Gg, Gs, Gs, Gs, Gs, Gs, Gg, Gg
Gll, Hh^Fms, Hh^Fms, Hh^Fms, Hh^Fms, Hh^Fms, Hh, Hh, Hh, Cv, Gg, Rp, Rp, Kv, Gg, Gg, Gg^Vhc, Gs, Gs^Fms, Cv, Cv, Gs, Gs, Gg, Cv, Gg, Gg, Gs, Gs, Gg, Gs, Gs^Fms, Gg^Fms, Hh^Fms, Hh, Hh, Hh, Hh, Hh^Fms, Hh^Fms, Gll, Gs^Fms, Gg, Rb^Gvs, Rb^Gvs, Rb^Gvs, Rb^Gvs, Rb^Gvs, Rb^Gvs, Rb^Gvs, Gg^Vwm, Wwf, Wwf, Wwt, Wwt, Wwt, Wwt, Wwt, Gs, Gs, Gg, Gg, Gg, Gg, Gs, Gg, Gs, Gg, Gg, Gg
Gs^Fms, Gll, Gs^Fms, Hh, Gll, Hh^Fms, Gs, Hh, Hh, Cv, Cv, Kv, Rp, Rp, Rp, Gg, Gg, Gs, Gs^Vhc, Gs^Fms, Gs^Fms, Cv, Gs, Gg, Kv, Gg, Gg, Gg, Gg, Gs, Gg, Gs, Hh^Fms, Hh, Hh, Hh, Hh^Fms, Hh^Fms, Gg^Fms, Gll, Gs^Fms, Gs^Fms, Gs, Gg, Re, Rb^Gvs, Rb^Gvs, Rb^Gvs, Rb^Gvs, Rb^Gvs, Gg, Gg, Wwt, Wwt, Wwt, Wwt, Gg, Gg, Gs, Gs, Gs, Gs, Gs, Gg, Gg, Gg, Gg, Gs, Gs, Gs
Gs^Fms, Gs^Fms, Gs^Fms, Gll, Gs^Fms, Gs^Fms, Gg, Gs, Kv, Cv, Gs^Fms, Gs, Rp, Gs, Gg^Efm, Rp, Rp, Gg, Gs, Gs^Fms, Gs^Fms, Cv, Gs, Gg, Gg, Gg, Gs, Gg, Gg, Gs, Gg, Gs, Gg^Fms, Hh^Fms, Gg^Fms, Hh^Fms, Gs^Fms, Gll, Gg, Gs^Fms, Gs, Gs, Re, Re, Gg, Gg, Gg, Rb^Gvs, Gg, Gg, Gg, Wwt, Wwt, Wwt, Wwt, Wwt, Gs, Gg, Gs, Gg, Gs, Gs, Gs^Fms, Gs, Gs, Gs, Gs, Gg, Gg, Gs
Gs, Gs^Fms, Gs^Fms, Gs^Fms, Gs, Gs, Gg, Gs, Cv, Gs^Fms, Gs^Vhc, Gs, Rp, Gg^Efm, Wwt, Gg^Efm, Gg^Efm, Rp, Gs, Gs^Fms, Gs, Cv, Gg, Gs, Gs, Gs, Gs, Gs, Gg, Gs, Gs, Gs, Gs, Gs, Gs, Gs^Fms, Gll, Gs^Fms, Gs, Gg, Re, Re, Gs^Fms, Gs, Gs^Fms, Gs^Fms, Gs^Fms, Gs^Fms, Gll, Gg, Gg, Wwt, Wwt, Wwt, Wwt, Gg, Gs, Gs, Gg, Gs, Gs^Fms, Gs^Fms, Gs^Fms, Gs^Fms, Gs^Fms, Gs^Fms, Gs^Fms, Gs, Gg, Gg
Gll, Gs, Gs, Gs, Gg, Gg, Gg, Gs, Cv, Gs^Fms, Gs, Gg, Rp, Gg^Efm, Wwt, Wwt, Gg^Efm, Rp, Gg, Gs, Gg, Cv, Gg, Gs, Gg, Gg, Gg, Gg, Gs, Gg, Gg, Gs, Gs, Gg, Gg, Gs, Gg, Gg, Rp, Re, Gg, Gg, Gs^Fms, Gs^Fms, Gll, Gll, Gll, Gs^Fms, Gs^Fms, Gs, Gg, Gg, Wwt, Wwt, Wwt, Wwt, Gg, Gs, Gs, Gs, Gs, Gs^Fms, Gs^Fms, Gs^Fms, Gll, Gll, Gll, Gs, Gs, Gg
Gs, Gs, Gs, Gll, Gs, Gg, Gg, Gs, Cv, Gs, Gs, Gg^Vhc, Rp, Gg^Efm, Gg^Efm, Gg^Efm, Rp, Rp, Gg, Gg^Vhc, Gs^Fms, Cv, Gs, Gs, Gg, Kv, Gg, Gg, Gs, Gs, Gg, Gs^Vc, Gg, Gg, Gs, Gg, Gg, Rp, Gg, Gg, Gg, Gs^Fms, Gs^Fms, Gs^Fms, Gs^Fms, Gll, Gs^Fms, Gs^Fms, Gll, Gs, Gs, Gg, Gg, Wwt, Wwt, Wwt, Gg, Gs, Gs, Gs, Gs^Fms, Gll, Gll^Vc, Gs^Fms, Gll, Gll, Gll, Gs^Fms, Gg, Gg
Gs^Fms, Gs^Fms, Gs^Fms, Gs^Fms, Gs^Fms, Gg, Gg, Gs, Cv, Gs^Fms, Gs^Fms, Gs, Gg, Rp, Rp, Rp, Rp, Gg, Gg, Gs, Cv, Cv, Gg, Gg, Gg, Cv, Gg, Gg, Gs, Gg, Gg, Gg, Gs, Gs, Gg, Gs, Gg, Rp, Gg, Gg, Gg, Gs, Gs^Fms, Gs^Fms, Gll, Gs^Fms, Gs^Fms, Gll, Gs^Fms, Gs, Gg, Gs, Gs, Wwt, Wwt, Wwt, Gg, Gs, Gs, Gs, Gs^Fms, Gll, Gs^Fms, Gs^Fms, Gs^Fms, Gs^Fms, Gs^Fms, Gs, Gs, Gg
Gg, Gs^Fms, Gs^Fms, Gll, Gs^Fms, Kv, Gg, Gs, Cv, Gs^Fms, Gs^Fms, Gs, Gs, Gg, Gg, Gg, Rp, Rp, Rp, Kv, Gs^Fms, Gg, Gg, Gg, Cv, Cv, Gg, Gg, Gg, Gs, Gg, Gs, Gg, Gs, Gg, Gs, Rp, Rp, Gg, Gg, Gs, Gs, Gll, Gs^Fms, Gll, Gll, Gs^Fms, Gll, Gs^Fms, Gs, Gs, Gs, Gs, Wwt, Wwt, Wwt, Gg, Gg, Gs, Gs, Gg, Gg, Gll, Gs^Fms, Gll, Gll, Gs^Fms, Gs^Fms, Gs, Gg
Gll, Gll, Gll, Gs^Fms, Gll, Cv, Gg, Gs, Gs, Cv, Cv, Gs^Fms, Gs, Gg^Vhc, Gg, Gs, Kv, Rp, Gs^Fms, Rp, Rp, Rp, Rp, Kv, Gs, Gg, Gs, Gs, Gg, Gs, Gs, Gs, Gg, Gg, Rp, Rp, Gg, Gg, Gg, Gs, Gs^Fms, Gs^Fms, Gs^Fms, Gs^Fms, Gs^Fms, Gs^Fms, Gll, Gll, Gs^Fms, Gg, Gs, Gs, Gg, Wwt, Wwt, Wwt, Gs, Gs, Gs, Gs, Gs^Fms, Gs^Fms, Gs, Gs^Fms, Gll, Gs^Fms, Gll, Gll, Gs^Fms, Gs
Gs^Fms, Gll, Gs^Fms, Gs^Fms, Gll, Cv, Cv, Gg, Gg, Gs, Gs, Cv, Cv, Gg, Cv, Cv, Gs^Fms, Rp, Gs, Gll, Kv, Gg, Rp, Gs, Gs, Gs, Gs, Gg, Gs, Gs, Gg, Gg, Rp, Rp, Gg, Gg, Gg, Gg, Gg, Gs, Gs^Fms, Gs^Fms, Gs^Fms, Gll, Gs^Fms, Gs^Fms, Gs, Gs^Fms, Gs, Gg, Gg, Gs, Gg, Wwt, Wwt, Wwt, Wwt, Gs, Gs, Gs, Gs, Gs, Gs, Gs^Fms, Gs^Fms, Gs^Fms, Gs^Fms, Gs^Fms, Gs, Gs
Gs^Fms, Gs^Fms, Gll, Gs^Fms, Gg, Gs, Gg, Kv, Gg, Gg, Gg, Gs, Gs, Cv, Gs, Gs, Gg, Rp, Kv, Gg, Kv, Gg, Rp, Gg^Vhc, Gg, Gs, Gg, Gs, Gg, Gg, Rp, Rp, Gg, Gg, Gs, Gs, Gs, Gg, Gg, Gs, Gs, Gs, Gs, Gg, Gg, Gs, Gg, Gg, Gg, Gg, Gs, Gs, Gs, Wwt, Wwt, Wwt, Wwt, Gg, Gg, Gs, Gs, Gg, Gg, Gs, Gs, Gs^Fms, Gs, Gs, Gs, Gs
Gg, Gll, Gs, Gll, Gll, Gg, Gs^Fms, Gg, Gg, Gg, Gg, Gg, Gg, Gs, Gg, Gg, Gg, Rp, Gs, Kv, Gs, Gs, Rp, Rp, Rp, Rp, Rp, Rp, Rp, Rp, Gs, Gs, Gs, Gg, Gg, Gg, Gs, Gg, Gg, Gg, Gg, Gg, Gs, Gg, Gs, Gg, Gs, Gg, Gs^Fms, Gll, Gs^Fms, Gs^Fms, Gll, Wwt, Wwt, Wwt, Wwt, Wwt, Gg, Gg, Gs, Gs, Gs, Gg, Gs, Gs, Gg, Gs, Gg, Gg
Gll, Gs, Gll, Gs^Fms, Gs^Fms, Gs^Fms, Gll, Gs, Gs, Gg, Gg, Kv, Cv, Gg, Cv, Kv, Gg, Rp, Rp, Gs, Rp, Rp, Gg, Gg, Gg, Gg, Gg, Gg, Gg, Gg, Gg, Gs, Gs, Gs, Gs, Gg, Gg, Gs, Gs, Gg, Gs, Gs, Gg, Gg, Gg, Gs, Gs, Gs^Fms, Gll, Gs^Fms, Hh, Gs^Fms, Gll, Gs^Fms, Wwt, Wwt, Wwt, Wwt, Wwt, Gs, Gg, Gg, Gs, Gs, Gg, Gs, Gg, Gs, Gs, Gg
Gg, Gll, Hh^Fms, Hh, Gll, Gs^Fms, Gs^Fms, Gs^Fms, Gs^Fms, Gs, Gg, Gs, Gs, Cv, Gs, Gs, Gg, Gg, Rp, Rp, Gg, Gg, Gs, Gs, Gs, Gg, Gs, Gs, Gs, Gg, Gs, Gs, Gs, Gg, Gg, Gs, Gs, Gs, Gg, Gs, Gs, Gg, Gg, Gs, Gs, Gg, Gs, Gs^Fms, Hh, Hh, Hh^Fms, Hh^Fms, Hh^Fms, Hh, Gs^Fms, Wwt, Wwt, Wwt, Wwt, Gg, Gs, Gs, Gs, Gg, Gg, Gs^Vc, Gg, Gs, Gs, Gg
Gg, Hh, Hh^Fms, Hh, Gs, Gll, Gll, Gs^Fms, Gs^Fms, Gs, Gs, Gg, Gg, Gs, Gs, Gg, Gs, Gg, Rp, Rp, Gg, Gs, Gg, Gg, Gs^Vc, Gg, Gg, Gs, Gg, Gg, Gs, Gs^Fms, Gs^Fms, Gs, Gs, Gg, Gg, Gs, Gs, Gg, Gg, Gs, Gs, Gg, Gs, Gg, Gs, Gs^Fms, Hh, Hh^Fms, Hh, Hh^Fms, Hh, Hh^Fms, Hh, Gs^Fms, Wwt, Wwt, Wwt, Gs, Gs, Gg, Gg, Gs, Gg, Gs, Gg, Gg, Gs, Gg
Hh, Hh^Fms, Hh, Hh, Hh, Hh, Hh, Hh, Gll, Gs^Fms, Gs, Gg, Gg, Gs, Gg, Gs, Gs, Gs, Rp, Rp, Gg, Gs, Gg, Gs, Gg, Gs, Gs, Gg, Gg, Gs, Gs^Fms, Gs^Fms, Gll, Gs^Fms, Gs^Fms, Gs, Gs, Gg, Gg, Gs, Gs, Gg, Gs, Gg, Gg, Gs, Gs, Gs^Fms, Gs^Fms, Gll, Gs^Fms, Hh^Fms, Hh^Fms, Hh^Fms, Wwt, Wwt, Wwt, Wwt, Wwt, Gs, Gs, Gs, Gg, Gs, Gs, Gs, Gg, Gg, Gs, Gg
Gg, Hh^Fms, Hh, Hh^Fms, Hh^Fms, Hh^Fms, Hh^Fms, Hh, Hh^Fms, Hh, Hh^Fms, Gs, Gs, Gs^Vc, Gg, Gg, Gg, Gs, Rp, Rp, Gg, Gs, Gs, Gs, Gs, Gs, Gs^Fms, Gs, Gg^Fms, Hh^Fms, Hh^Fms, Hh^Fms, Hh^Fms, Hh^Fms, Hh, Hh, Hh^Fms, Gs, Gg, Gs, Gg, Gs, Gs, Gg, Gg, Gs, Gg, Gg, Gs, Gs^Fms, Wwt, Wwt, Wwt, Wwt, Wwt, Wwt, Wwt, Wwt, Wwt, Gg, Gs, Gs, Gs, Gs, Gg, Gg, Gg, Gg, Gs, Gg
Gs^Fms, Hh^Fms, Hh^Fms, Hh, Hh, Hh, Hh, Hh^Fms, Hh^Fms, Hh^Fms, Hh, Hh^Fms, Hh, Gs, Gg, Gg, Gs, Gg, Rp, Rp, Gs, Gs, Gg, Gg, Gs, Gs^Fms, Hh^Fms, Gg^Fms, Hh, Hh^Fms, Hh, Hh, Hh, Hh, Hh^Fms, Hh^Fms, Gs^Fms, Gs, Gg, Gs, Gs, Gs, Gs, Gg, Gg, Gs, Gg, Gg, Wwt, Wwt, Wwt, Wwt, Wwt, Wwt, Wwt, Wwt, Gll, Wwt, Gg, Gg, Gs, Gg, Gs, Gs, Gg, Gs, Gg, Gs, Gg, Gg
Gll, Gs^Fms, Gs^Fms, Hh^Fms, Hh, Hh^Fms, Hh^Fms, Hh^Fms, Hh, Hh^Fms, Hh^Fms, Hh^Fms, Hh, Gs, Gg, Gs, Gg, Gs, Rp, Rp, Gg, Gg, Gg, Gs, Hh, Hh, Hh, Hh, Hh, Hh, Hh^Fms, Hh^Fms, Gg^Fms, Hh^Fms, Gs^Fms, Hh, Gs, Gs, Gg, Gs, Gg, Gg, Gg, Gs, Gs, Gg, Gg, Wwt, Wwt, Wwt, Wwt, Wwt, Wwt, Wwt, Wwt, Wwt, Gll, Hh, Hh^Fms, Gs, Gs, Gs, Gg, Gs, Gg, Gs, Gg, Gs, Gs, Gg
Gs^Fms, Gs^Fms, Gll, Gll, Gll, Hh, Hh, Hh, Hh, Hh, Hh, Hh, Gs^Fms, Gs, Gg, Gg, Gg, Gs, Rp, Rp, Gs, Gg, Gg, Gs, Hh^Fms, Hh^Fms, Hh, Hh, Hh^Fms, Hh^Fms, Ce, Gs^Fms, Gs, Gs^Vct, Gs, Gs, Gg, Gg, Gs, Gs, Gs, Gs, Gs, Gg, Gg, Gg, Gg, Wwt, Wwt, Wwt, Gll, Gll, Gs^Fms, Gs^Fms, Gs^Fms, Gll, Hh, Hh^Fms, Hh^Fms, Hh, Gs^Fms, Gs, Gs, Gg, Gg, Gs, Gg, Gs, Gg, Gg
Gs^Fms, Gll, Gs^Fms, Gs^Fms, Gs^Fms, Gll^Vc, Gll, Gll, Gs^Fms, Gll, Gs, Gs, Gs, Gs, Gg, Gg, Gg, Gs, Rp, Rp, Gs, Gg, Gs, Gg^Fms, Hh^Fms, Hh, Hh^Fms, Hh^Fms, Hh, Ce, 1 Ke, Ce, Gg, Gg, Gg, Gg, Gs, Gs, Gs^Fms, Hh^Fms, Hh, Hh, Gs^Fms, Gs, Gs, Gg, Wwt, Wwt, Wwt, Wwt, Gs^Fms, Gs^Fms, Hh, Hh, Hh^Fms, Hh^Vc, Hh^Fms, Hh^Fms, Hh^Fms, Hh^Fms, Hh, Gs^Fms, Gs^Fms, Gs, Gg, Gs, Gs, Gs, Gg, Gg
Gs^Fms, Gs^Fms, Gs, Gs^Fms, Gs^Fms, Gs^Fms, Gs^Fms, Gs^Fms, Gs, Gs, Gg, Gg, Gg, Gg, Gs, Gs, Gs, Gg, Rp, Rp, Gs, Gg, Gs, Hh^Fms, Hh, Hh^Fms, Gs^Fms, Gs^Fms, Gs, Ce, Ce, Ce, Gg, Gg, Gg, Gg, Gs, Gs^Fms, Hh, Hh^Fms, Hh^Fms, Hh^Fms, Hh^Fms, Gs^Fms, Wwt, Gs^Vc, Wwt, Wwt, Wwt, Wwt, Gg, Gs^Fms, Hh, Hh^Fms, Hh, Hh^Fms, Hh^Fms, Hh, Hh, Hh^Fms, Hh^Fms, Gs^Fms, Gll, Gs^Fms, Gg, Gg, Gg, Gg, Gs, Gg
Gs, Gs, Gg, Gs, Gs, Gs, Gs, Gs, Gg, Gg, Gg, Gg, Gs, Gg, Gg, Gg, Gs, Gg, Rp, Rp, Gg, Gs, Gg^Fms, Hh^Fms, Hh, Hh^Fms, Gs^Fms, Gs^Fms, Gs, Gg, Gg, Gg, Gg, Gg, Gs, Gg, Gg, Gs^Fms, Wwt, Wwt, Wwt, Wwt, Wwt, Wwt, Wwt, Wwt, Wwt, Wwt, Wwt, Gs, Gs^Fms, Gs^Fms, Hh, Hh^Fms, Hh^Fms, Hh, Hh^Fms, Hh, Hh, Hh, Hh^Fms, Hh, Hh, Gs^Fms, Gs, Gg, Gg, Gs, Gs, Gg
Gg, Gg, Gs, Gg, Gs, Gg, Gs, Gg, Gg, Gs, Gg, Gg, Gs, Gs, Gg, Gg, Gs, Gg, Rp, Rp, Gg, Gs, Gg^Fms, Hh^Fms, Hh^Fms, Hh^Fms, Gs^Fms, Gs^Vct, Gg, Gg, Gg, Gg, Gs, Gg, Gs, Gs, Wwt, Wwt, Wwt, Wwt, Wwt, Wwt, Wwt, Wwt, Wwt, Wwt, Wwt, Wwt, Gg, Gg, Gll, Gs^Fms, Gll, Hh, Hh, Hh^Fms, Hh, Hh^Fms, Hh^Fms, Hh^Fms, Hh^Fms, Hh, Hh, Gs^Fms, Gs, Gs, Gs, Gs, Gs, Gg
Gg, Gs, Gs, Gg, Gs, Gs, Gg, Gs, Gg, Gs, Gg, Gs, Gg, Gg, Gg, Gs, Gg, Gg, Rp, Rp, Gg, Gs, Gs, Hh^Fms, Hh^Fms, Hh, Gs, Gs, Gg, Gg, Gs, Gs, Hh, Gs^Fms, Hh, Gs^Fms, Wwt, Wwt, Wwt, Wwt, Wwt, Wwt, Wwt, Wwt, Gs^Fms, Wwt, Gg, Gg, Gs, Gs, Gs^Fms, Gll, Gs^Fms, Gll, Gll, Gs^Fms, Gll, Hh^Fms, Hh, Hh^Fms, Hh^Fms, Hh, Gll, Gs^Fms, Gs, Gs, Gs, Gg, Gg, Gg
Gg, Gg, Gs, Gs, Gs, Gg, Gg, Gg, Gs, Gg, Gg, Gs, Gg, Gg, Gs, Gs, Gg, Gg, Rp, Rp, Gg, Gg, Gg, Gs, Gs, Gs, Gg, Gg, Gs, Gs, Gs^Fms, Hh, Hh^Fms, Hh, Hh^Fms, Wwt, Wwt, Wwt, Wwt, Gs^Vc, Gs^Fms, Gll, Gs^Fms, Gs^Fms, Gs^Fms, Gg, Gs, Gs, Gs^Fms, Gs^Fms, Gll^Vct, Gs^Fms, Gs^Fms, Gs^Fms, Gs^Fms, Gs^Fms, Gs^Fms, Gll, Hh, Hh, Gll, Gll, Gs^Fms, Gs^Fms, Gs, Gg, Gs, Gs, Gs, Gg
Gs, Gg, Gg, Gg, Gs, Gs, Gg, Gg, Gg, Gg, Gs, Gg, Gs^Vc, Gg, Gs, Gs, Gg, Gg, Rp, Rp, Gg, Gg, Gs, Gg, Gs, Gg, Gg, Gg, Gs, Gs^Fms, Gs^Fms, Hh, Hh^Fms, Hh^Fms, Wwt, Wwt, Wwt, Wwt, Gs^Fms, Gs^Fms, Gs, Gg, Gs, Gs^Fms, Gg, Gs, Gs^Fms, Gs^Fms, Gs^Fms, Gll, Gs^Fms, Gll, Gs^Fms, Gll, Gll, Gll, Gll, Gs^Fms, Gs^Fms, Gll, Gg^Fms, Gs^Fms, Gs^Fms, Gs, Gg, Gs, Gs, Gs, Gg, Gg
Gs, Gg, Gg, Gg, Gg, Gg, Gs, Gg, Gs, Gs, Gg, Gg, Gs, Gg, Gg, Gs, Gs, Gg, Rp, Rp, Gs, Gs, Gg, Gs, Gg, Gg, Gs, Gg, Gg, Gs, Gs^Fms, Hh, Wwt, Wwt, Wwt, Wwt, Wwt, Wwt, Gll, Gs^Fms, Gg, Gg, Gg, Gs, Gg, Gs^Fms, Gll^Vct, Gll, Gs^Fms, Gll, Ce, Gs^Fms, Ce, Gs^Fms, Gs^Fms, Gs, Gs^Fms, Gg, Gs, Gs, Gs, Gg^Fms, Gs, Gs, Gs, Gs, Gs, Gs, Gg, Gg
Gg, Gs, Gg, Gg, Gs, Gs, Gg, Gg, Gg, Gg, Gg, Gs, Gg, Gg, Gg, Gs, Gg, Gg, Rp, Rp, Gg, Gs, Gg, Gg, Gg, Gg, Gs, Gs, Gg, Gs, Gs, Wwt, Wwt, Wwt, Wwt, Wwt, Wwt, Wwt, Hh, Gll, Gs^Fms, Gs, Gg, Gs, Gs^Fms, Gs^Fms, Gs^Fms, Gs^Fms, Gll, Ce, 2 Ke, Ce, Gll, Gs^Fms, Gll, Gs^Fms, Gs^Fms, Gs, Gg, Gg, Gg, Gs, Gs, Gs, Gs, Gs, Gs, Gs, Gs, Gg
Gg, Gg, Gg, Gg, Gg, Gs, Gs, Gg, Gg, Gg, Gg, Gg, Gg, Gs, Gs, Gg, Gg, Gg, Rp, Rp, Gg, Gs, Gg, Gg, Gs, Gs, Gs, Gs, Gs, Gg, Wwt, Wwt, Wwt, Wwt, Gll^Vc, Hh^Fms, Hh^Fms, Hh, Hh, Gs^Fms, Gs^Fms, Gg, Gg, Gs, Gs^Fms, Gs^Fms, Gll^Vct, Gs^Fms, Ce, Ce, Ce, Ce, Gg, Gs^Fms, Gs^Fms, Gll^Vct, Gs^Fms, Gs, Gg, Gs, Gs, Gs, Gs, Gs, Gs^Fms, Gs^Fms, Gs^Fms, Gs^Fms, Gs^Fms, Gs
Gs, Gs, Gs, Gs, Gs, Gg, Gg, Gg, Gs, Gg, Gg, Gs, Gg, Gg, Gs, Gg, Gg, Gg, Rp, Rp, Gg, Gs, Gs, Gg, Gg, Gg, Gg, Gs, Gg, Gg, Wwt, Wwt, Wwt, Wwt, Hh^Fms, Hh, Hh^Fms, Hh^Fms, Hh^Fms, Hh, Gs^Fms, Gs^Fms, Gg, Gs, Gs, Gs^Fms, Gs^Fms, Gs^Fms, Gs, Gs^Fms, Gs, Gs^Fms, Gs, Gs^Fms, Gs, Gs^Fms, Gs, Gs, Gs, Gs, Gs, Gs, Gs^Fms, Gs^Fms, Gs^Fms, Gll, Gll, Gll, Gs^Fms, Gs
Gll, Gs^Fms, Gs^Fms, Gs^Fms, Gs^Fms, Gs, Gs, Gs, Gs, Gg, Gg, Gg, Gg, Gg, Gg, Gg, Gg, Gg, Rp, Rp, Gg, Gg, Gg, Gg, Wwt, Wwt, Wwt, Gg, Wwt, Gs^Vc, Wwt, Wwt, Wwt, Hh, Hh^Fms, Hh^Fms, Hh^Fms, Hh, Hh^Fms, Gll, Gs, Gs, Gs, Gs, Gs, Gs, Gs, Gs^Fms, Gs, Gs, Gg, Gs, Gg, Gs, Gg, Gs, Gg, Gg, Gs, Gs, Gs^Fms, Gs^Fms, Gll, Gll, Gll, Gs^Fms, Gs^Fms, Gll, Gll, Gs^Fms
Gg, Gll, Gs^Fms, Gll, Gll^Vc, Gs^Fms, Gs^Fms, Gs^Fms, Gll, Gs, Gs, Gs, Gs, Gg, Gs, Gs, Gg, Gg, Rp, Rp, Rp, Gg, Wwt, Wwt, Wwt, Wwt, Wwt, Wwt, Wwt, Wwt, Wwt, Wwt, Wwt, Hh^Fms, Hh, Hh, Gll, Hh, Hh^Fms, Gll, Gg, Gg, Gs, Gg, Gs, Gg, Rp, Gs, Gg, Gg, Rp, Rp, Rp, Gg, Gg, Gs, Gg, Gg, Gs, Gs^Fms, Gs^Fms, Gs^Fms, Gs^Fms, Gs^Fms, Gs^Fms, Gs^Fms, Gll, Gs^Fms, Gs^Fms, Gg
Gs^Fms, Gs^Fms, Gll, Gs^Fms, Gs^Fms, Gs^Fms, Gs^Fms, Gll, Gs^Fms, Gs^Fms, Gs, Gg, Gg, Gg, Gg, Gg, Gg, Gg, Wwt, Rp, Wwt^Bsb\, Wwt^Bsb\, Wwt^Bsb\, Wwt, Wwt, Wwt, Wwt, Wwt, Wwt, Wwt, Wwt, Wwt, Gs^Fms, Gll, Gll, Gs^Fms, Gs^Fms, Hh, Gll, Hh^Fms, Gs, Gs, Gg, Gg, Rp, Rp, Rp, Rp, Rp, Rp, Rp, Rp, Rp, Rp, Rp, Gs, Gs, Gs, Gg, Gs, Gs^Fms, Gll^Vc, Gs^Fms, Gs^Fms, Gll, Gs^Fms, Gll, Gll, Gll, Gs^Fms
Gs^Fms, Gll, Gll, Gll, Gll, Gs^Fms, Gs^Fms, Gs^Fms, Gs, Gs, Gg, Gg, Gg, Gg, Gg, Gg, Wwt, Wwt, Wwt, Wwt, Wwt, Wwt^Bsb\, Wwt^Bsb\, Wwt^Bsb\, Rp, Gg, Gg, Gs^Vc, Gg, Gs, Gs^Fms, Gll, Gs^Fms, Gs^Fms, Gll, Gs^Fms, Gs^Fms, Gll, Gs^Fms, Gs^Fms, Gs, Gg, Rp, Rp, Rp, Rp, Gg, Rp, Rp, Rp, Gg, Gg, Gs, Rp, Rp, Rp, Rp, Gg, Gg, Gs, Gs, Gs, Gs^Fms, Gll, Gg, Gs^Fms, Gs^Fms, Gg, Gs^Fms, Gs^Fms
Gs^Fms, Gll, Gs^Fms, Gs^Fms, Gg, Gs^Fms, Gs, Gs, Gg, Gg, Gg, Gg, Gg, Gg, Gg, Gs^Vc, Wwt, Wwt, Wwt, Wwt, Wwt, Wwt, Gg, Rp, Rp, Rp, Rp, Gs, Gs, Gs, Gs^Fms, Gll, Gs^Fms, Gs^Fms, Gs, Gs^Fms, Gs, Gs^Fms, Gg, Gs^Fms, Rp, Rp, Rp, Rp, Gg, Gg, Gg, Gs, Gs, Gg, Gg, Gs, Gs, Gg, Gg, Rp, Rp, Rp, Rp, Gg, Gg, Gs, Gs, Gs^Fms, Gg, Gll, Gll, Gs^Fms, Gs^Fms, Gs^Fms
Gs, Gs^Fms, Gs^Fms, Gll, Gs, Gs, Wwt, Gg, Gg, Gg, Wwt, Wwt, Wwt, Wwt, Wwt, Wwt, Wwt, Wwt, Wwt, Wwt, Gg, Gg, Gs, Gg, Gs, Rp, Rp, Rp, Rp, Gg, Gg, Gs^Fms, Gs, Gs, Gs, Gg, Gg, Gg, Rp, Rp, Rp, Rp, Gs, Gs, Gs^Fms, Gs^Fms, Gll^Vc, Gs^Fms, Gs^Fms, Gs, Gs, Gg, Gs, Gg, Gs, Gg, Gs, Rp, Rp, Rp, Rp, Gg, Gg, Gs, Gg, Gs, Gs, Gs^Fms, Gs, Gs^Fms
Gg, Gs, Gs, Gs, Gg, Wwt, Wwt, Wwt, Wwt, Wwt, Wwt, Wwt, Wwt, Wwt, Wwt, Wwt, Wwt, Wwt, Wwt, Gg, Gs, Gs, Gg, Gs, Gs^Fms, Gg, Gg, Rp, Rp, Rp, Rp, Gg, Gg, Gg, Gg, Gg, Rp, Rp, Rp, Rp, Gg, Gs, Gll, Gs^Fms, Gll, Gs^Fms, Gs^Fms, Gs^Fms, Gs^Fms, Gg, Gg, Gs^Fms, Gs^Fms, Gs, Gg, Gs, Gg, Gg, Gs, Rp, Rp, Rp, Rp, Gg, Gg, Gg, Gg, Gs, Gs, Gs
Gs, Gg, Gg, Gg, Wwt, Wwt, Wwt, Wwt, Wwt, Wwt, Wwt, Wwt, Wwt, Wwt, Wwt, Wwt, Wwt, Wwt, Gg, Gs, Gs^Fms, Gs^Fms, Gll, Gs^Fms, Gs^Fms, Gs, Gg, Gs, Gg, Rp, Rp, Rp, Rp, Gg, Rp, Rp, Rp, Rp, Gs, Gg, Gs^Fms, Gll, Gs^Fms, Gs^Fms, Gs^Fms, Gs^Fms, Gs^Fms, Gll, Gll, Gs^Fms, Gll, Gll, Gs^Fms, Gs, Gs, Gg, Gg, Gg, Gs, Gg, Gg, Rp, Rp, Rp, Rp, Gg, Gg, Gg, Gg, Gg
Gs, Gg, Gg, Wwt, Wwt, Wwt, Wwt, Wwt, Wwt, Wwt, Gs, Gs, Gs^Fms, Gg, Gg, Wwt, Gs, Gs, Gs^Fms, Gs^Fms, Gs^Fms, Gll, Gs^Fms, Gll, Gs, Gs, Gg, Gs, Gg, Gs, Gs, Rp, Rp, Rp, Rp, Rp, Gg, Gs, Gs^Fms, Gs^Fms, Gs^Fms, Gll, Gll, Gs^Fms, Gll, Gs^Fms, Gs^Fms, Gs^Fms, Gll, Gg, Gs, Gg, Gll, Gs^Fms, Gg, Gs, Gs, Gg, Gs, Gs, Gs, Gg, Gg, Rp, Rp, Rp, Rp, Gg, Gg, Gg
Wwt, Gg, Wwt, Wwt, Wwt, Wwt, Wwt, Wwt, Gg, Gg, Gs, Gs^Fms, Gs^Fms, Gll, Gg, Gg, Gll, Gs^Fms, Gll, Gll, Gs^Fms, Gs^Fms, Gs^Fms, Gll, Gs, Gg, Gs^Fms, Gs, Gg, Gg, Gs, Gg, Rp, Rp, Gg, Gs, Gg, Gs, Gs^Fms, Gs^Fms, Gll, Gll, Gs^Fms, Gs^Fms, Gll, Gll, Gs^Fms, Gs^Fms, Gs, Gs^Fms, Gs^Fms, Gll, Gs^Fms, Gll, Gll, Gs^Fms, Gs, Gg, Gs, Gg, Gg, Gs, Gs, Gg, Gg, Rp, Rp, Rp, Rp, Gg
Wwt, Wwt, Wwt, Wwt, Wwt, Wwt, Gg, Gg, Gg, Gg, Gg, Gs^Fms, Gg, Gs^Fms, Gs^Fms, Gs^Fms, Gg, Gll, Gs^Fms, Gs^Fms, Gg, Gll, Gg, Gs^Fms, Gg, Gs, Gs^Fms, Gs, Gg, Gs, Gg, Gg, Rp, Rp, Gg, Gg, Gg, Gs, Gs^Fms, Gs^Fms, Gll, Gg, Gg, Gs^Fms, Gg, Gg, Gs^Fms, Gll, Gg, Gg, Gg, Gs^Fms, Gg, Gs^Fms, Gg, Gs^Fms, Gs, Gg, Gg, Gg, Gg, Gs, Gg, Gg, Gg, Gg, Gg, Rp, Rp, Rp
