Xu, Xu, Xu, Xu, Xu, Xu, Xu, Xu, Xu, Xu, Xu, Xu, Xu, Xu, Xu, Xu, Xu, Xu, Xu, Xu, Xu, Xu, Xu, Xu, Xu, Xu, Xu, Xu, Xu, Xu, Xu, Xu, Xu, Xu, Xu, Xu, Xu, Xu, Xu, Xu, Xu, Xu, Xu, Xu, Xu, Xu, Xu, Xu, Xu, Xu, Xu, Xu, Xu, Xu, Xu, Xu, Xu, Xu, Xu, Xu, Xu, Xu, Xu, Xu, Xu, Xu, Xu, Xu
Xu, Xu, Xu, Xu, Xu, Xu, Xu, Xu, Xu, Xu, Xu, Xu, Xu, Xu, Xu, Xu, Xu, Xu, Xu, Xu, Xu, Xu, Xu, Xu, Xu, Xu, Xu, Xu, Xu, Xu, Xu, Xu, Xu, Xu, Xu, Xu, Xu, Xu, Xu, Xu, Xu, Xu, Xu, Xu, Xu, Xu, Xu, Xu, Xu, Xu, Xu, Xu, Xu, Xu, Xu, Xu, Xu, Xu, Xu, Xu, Xu, Xu, Xu, Xu, Xu, Xu, Xu, Xu
Xu, Xu, Xu, Xu, Xu, Xu, Xu, Xu, Xu, Xu, Xu, Xu, Xu, Xu, Xu, Xu, Xu, Xu, Xu, Xu, Xu, Xu, Xu, Xu, Xu, Xu, Xu, Xu, Xu, Xu, Xu, Xu, Xu, Xu, Xu, Xu, Xu, Xu, Xu, Xu, Xu, Xu, Xu, Xu, Xu, Xu, Xu, Xu, Xu, Xu, Xu, Xu, Xu, Xu, Xu, Xu, Xu, Xu, Xu, Xu, Xu, Xu, Xu, Xu, Xu, Xu, Xu, Xu
Xu, Xu, Xu, Xu, Xu, Xu, Xu, Xu, Xu, Xu, Xu, Xu, Xu, Xu, Xu, Xu, Xu, Xu, Xu, Xu, Xu, Xu, Xu, Xu, Xu, Xu, Xu, Xu, Xu, Xu, Xu, Xu, Xu, Xu, Xu, Xu, Xu, Xu, Xu, Xu, Xu, Xu, Xu, Xu, Xu, Xu, Xu, Xu, Xu, Xu, Xu, Xu, Xu, Xu, Xu, Xu, Xu, Xu, Xu, Xu, Xu, Xu, Xu, Xu, Xu, Xu, Xu, Xu
Xu, Xu, Xu, Xu, Xu, Xu, Xu, Xu, Xu, Xu, Xu, Xu, Xu, Xu, Xu, Xu, Xu, Xu, Xu, Xu, Xu, Xu, Xu, Xu, Xu, Xu, Xu, Xu, Xu, Xu, Xu, Xu, Xu, Xu, Xu, Xu, Xu, Xu, Xu, Xu, Xu, Xu, Xu, Xu, Xu, Xu, Xu, Xu, Xu, Xu, Xu, Xu, Xu, Xu, Xu, Xu, Xu, Xu, Xu, Xu, Xu, Xu, Xu, Xu, Xu, Xu, Xu, Xu
Xu, Xu, Xu, Xu, Xu, Xu, Xu, Xu, Xu, Xu, Xu, Xu, Xu, Xu, Xu, Xu, Xu, Xu, Xu, Xu, Xu, Xu, Xu, Xu, Xu, Xu, Xu, Xu, Xu, Xu, Xu, Xu, Xu, Xu, Xu, Xu, Xu, Xu, Xu, Xu, Xu, Xu, Xu, Xu, Xu, Xu, Xu, Xu, Xu, Xu, Xu, Xu, Xu, Xu, Xu, Xu, Xu, Xu, Xu, Xu, Xu, Xu, Xu, Xu, Xu, Xu, Xu, Xu
Xu, Xu, Xu, Xu, Xu, Xu, Xu, Xu, Xu, Xu, Xu, Xu, Xu, Xu, Xu, Xu, Xu, Xu, Xu, Xu, Xu, Xu, Xu, Xu, Xu, Xu, Xu, Xu, Xu, Xu, Xu, Xu, Xu, Xu, Xu, Xu, Xu, Xu, Xu, Xu, Xu, Xu, Xu, Xu, Xu, Xu, Xu, Xu, Xu, Xu, Xu, Xu, Xu, Xu, Xu, Xu, Xu, Xu, Xu, Xu, Xu, Xu, Xu, Xu, Xu, Xu, Xu, Xu
Xu, Xu, Xu, Xu, Xu, Xu, Xu, Xu, Xu, Xu, Xu, Xu, Xu, Xu, Xu, Xu, Xu, Xu, Xu, Xu, Xu, Xu, Xu, Xu, Xu, Xu, Xu, Xu, Xu, Xu, Xu, Xu, Xu, Xu, Xu, Xu, Xu, Xu, Xu, Xu, Xu, Xu, Xu, Xu, Xu, Xu, Xu, Xu, Xu, Xu, Xu, Xu, Xu, Xu, Xu, Xu, Xu, Xu, Xu, Xu, Xu, Xu, Xu, Xu, Xu, Xu, Xu, Xu
Xu, Xu, Xu, Xu, Xu, Xu, Xu, Xu, Xu, Xu, Xu, Xu, Xu, Xu, Xu, Xu, Xu, Xu, Xu, Xu, Xu, Xu, Xu, Xu, Xu, Xu, Xu, Xu, Xu, Xu, Xu, Xu, Xu, Xu, Xu, Xu, Xu, Xu, Xu, Xu, Xu, Xu, Xu, Xu, Xu, Xu, Xu, Xu, Xu, Xu, Xu, Xu, Xu, Xu, Xu, Xu, Xu, Xu, Xu, Xu, Xu, Xu, Xu, Xu, Xu, Xu, Xu, Xu
Xu, Xu, Xu, Xu, Xu, Xu, Xu, Xu, Xu, Xu, Xu, Xu, Xu, Xu, Xu, Xu, Xu, Xu, Xu, Xu, Xu, Xu, Xu, Xu, Xu, Xu, Xu, Xu, Xu, Xu, Xu, Xu, Xu, Xu, Xu, Xu, Xu, Xu, Xu, Xu, Xu, Xu, Xu, Xu, Xu, Xu, Xu, Xu, Xu, Xu, Xu, Xu, Xu, Xu, Xu, Xu, Xu, Xu, Xu, Xu, Xu, Xu, Xu, Xu, Xu, Xu, Xu, Xu
Xu, Xu, Xu, Xu, Xu, Xu, Xu, Xu, Xu, Xu, Xu, Xu, Xu, Xu, Xu, Xu, Xu, Xu, Xu, Xu, Xu, Xu, Xu, Xu, Xu, Xu, Xu, Xu, Xu, Xu, Xu, Xu, Xu, Xu, Xu, Xu, Xu, Xu, Xu, Xu, Xu, Xu, Xu, Xu, Xu, Xu, Xu, Xu, Xu, Xu, Xu, Xu, Xu, Xu, Xu, Xu, Xu, Xu, Xu, Xu, Xu, Xu, Xu, Xu, Xu, Xu, Xu, Xu
Xu, Xu, Xu, Xu, Xu, Xu, Xu, Xu, Xu, Xu, Xu, Xu, Xu, Xu, Xu, Xu, Xu, Xu, Xu, Xu, Xu, Xu, Xu, Xu, Xu, Xu, Xu, Xu, Xu, Xu, Xu, Xu, Xu, Xu, Xu, Xu, Xu, Xu, Xu, Xu, Xu, Xu, Xu, Xu, Xu, Xu, Xu, Xu, Xu, Xu, Xu, Xu, Xu, Xu, Xu, Xu, Xu, Xu, Xu, Xu, Xu, Xu, Xu, Xu, Xu, Xu, Xu, Xu
Xu, Xu, Xu, Xu, Xu, Xu, Xu, Xu, Xu, Xu, Xu, Xu, Xu, Xu, Xu, Xu, Xu, Xu, Xu, Xu, Xu, Xu, Xu, Xu, Xu, Xu, Xu, Xu, Xu, Xu, Xu, Xu, Xu, Xu, Xu, Xu, Xu, Xu, Xu, Xu, Xu, Xu, Xu, Xu, Xu, Xu, Xu, Xu, Xu, Xu, Xu, Xu, Xu, Xu, Xu, Xu, Xu, Xu, Xu, Xu, Xu, Xu, Xu, Xu, Xu, Xu, Xu, Xu
Xu, Xu, Xu, Xu, Xu, Xu, Xu, Xu, Xu, Xu, Xu, Xu, Xu, Xu, Xu, Xu, Xu, Xu, Xu, Xu, Xu, Xu, Xu, Xu, Xu, Xu, Xu, Xu, Xu, Xu, Xu, Xu, Xu, Xu, Xu, Xu, Xu, Xu, Xu, Xu, Xu, Xu, Xu, Xu, Xu, Xu, Xu, Xu, Xu, Xu, Xu, Xu, Xu, Xu, Xu, Xu, Xu, Xu, Xu, Xu, Xu, Xu, Xu, Xu, Xu, Xu, Xu, Xu
Xu, Xu, Xu, Xu, Xu, Xu, Xu, Xu, Xu, Xu, Xu, Xu, Xu, Xu, Xu, Xu, Xu, Xu, Xu, Xu, Xu, Xu, Xu, Xu, Xu, Xu, Xu, Xu, Xu, Xu, Xu, Xu, Xu, Xu, Xu, Xu, Xu, Xu, Xu, Xu, Xu, Xu, Xu, Xu, Xu, Xu, Xu, Xu, Xu, Xu, Xu, Xu, Xu, Xu, Xu, Xu, Xu, Xu, Xu, Xu, Xu, Xu, Xu, Xu, Xu, Xu, Xu, Xu
Xu, Xu, Xu, Xu, Xu, Xu, Xu, Xu, Xu, Xu, Xu, Xu, Xu, Xu, Xu, Xu, Xu, Xu, Xu, Xu, Xu, Xu, Xu, Xu, Xu, Xu, Xu, Xu, Xu, Xu, Xu, Xu, Xu, Xu, Xu, Xu, Xu, Xu, Xu, Xu, Xu, Xu, Xu, Xu, Xu, Xu, Xu, Xu, Xu, Xu, Xu, Xu, Xu, Xu, Xu, Xu, Xu, Xu, Xu, Xu, Xu, Xu, Xu, Xu, Xu, Xu, Xu, Xu
Xu, Xu, Xu, Xu, Xu, Xu, Xu, Xu, Xu, Xu, Xu, Xu, Xu, Xu, Xu, Xu, Xu, Xu, Xu, Xu, Xu, Xu, Xu, Xu, Xu, Xu, Xu, Xu, Xu, Xu, Xu, Xu, Xu, Xu, Xu, Xu, Xu, Xu, Xu, Xu, Xu, Xu, Xu, Xu, Xu, Xu, Xu, Xu, Xu, Xu, Xu, Xu, Xu, Xu, Xu, Xu, Xu, Xu, Xu, Xu, Xu, Xu, Xu, Xu, Xu, Xu, Xu, Xu
Xu, Xu, Xu, Xu, Xu, Xu, Xu, Xu, Xu, Xu, Xu, Xu, Xu, Xu, Xu, Xu, Xu, Xu, Xu, Xu, Xu, Xu, Xu, Xu, Xu, Xu, Xu, Xu, Xu, Xu, Xu, Xu, Xu, Xu, Xu, Xu, Xu, Xu, Xu, Xu, Xu, Xu, Xu, Xu, Xu, Xu, Xu, Xu, Xu, Xu, Xu, Xu, Xu, Xu, Xu, Xu, Xu, Xu, Xu, Xu, Xu, Xu, Xu, Xu, Xu, Xu, Xu, Xu
Xu, Xu, Xu, Xu, Xu, Xu, Xu, Xu, Xu, Xu, Xu, Xu, Xu, Xu, Xu, Xu, Xu, Xu, Xu, Xu, Xu, Xu, Xu, Xu, Xu, Xu, Xu, Xu, Xu, Xu, Xu, Xu, Xu, Xu, Xu, Xu, Xu, Xu, Xu, Xu, Xu, Xu, Xu, Xu, Xu, Xu, Xu, Xu, Xu, Xu, Xu, Xu, Xu, Xu, Xu, Xu, Xu, Xu, Xu, Xu, Xu, Xu, Xu, Xu, Xu, Xu, Xu, Xu
Xu, Xu, Xu, Xu, Xu, Xu, Xu, Xu, Xu, Xu, Xu, Xu, Xu, Xu, Xu, Xu, Xu, Xu, Xu, Xu, Xu, Xu, Xu, Xu, Xu, Xu, Xu, Xu, Xu, Xu, Xu, Xu, Xu, Xu, Xu, Xu, Xu, Xu, Xu, Xu, Xu, Xu, Xu, Xu, Xu, Xu, Xu, Xu, Xu, Xu, Xu, Xu, Xu, Xu, Xu, Xu, Xu, Xu, Xu, Xu, Xu, Xu, Xu, Xu, Xu, Xu, Xu, Xu
Xu, Xu, Xu, Xu, Xu, Xu, Xu, Xu, Xu, Xu, Xu, Xu, Xu, Xu, Xu, Xu, Xu, Xu, Xu, Xu, Xu, Xu, Xu, Xu, Xu, Xu, Xu, Xu, Xu, Xu, Xu, Xu, Xu, Xu, Xu, Xu, Xu, Xu, Xu, Xu, Xu, Xu, Xu, Xu, Xu, Xu, Xu, Xu, Xu, Xu, Xu, Xu, Xu, Xu, Xu, Xu, Xu, Xu, Xu, Xu, Xu, Xu, Xu, Xu, Xu, Xu, Xu, Xu
Xu, Xu, Xu, Xu, Xu, Xu, Xu, Xu, Xu, Xu, Xu, Xu, Xu, Xu, Xu, Xu, Xu, Xu, Xu, Xu, Xu, Xu, Xu, Xu, Xu, Xu, Xu, Xu, Xu, Xu, Xu, Xu, Xu, Xu, Xu, Xu, Xu, Xu, Xu, Xu, Xu, Xu, Xu, Xu, Xu, Xu, Xu, Xu, Xu, Xu, Xu, Xu, Xu, Xu, Xu, Xu, Xu, Xu, Xu, Xu, Xu, Xu, Xu, Xu, Xu, Xu, Xu, Xu
Xu, Xu, Xu, Xu, Xu, Xu, Xu, Xu, Xu, Xu, Xu, Xu, Xu, Xu, Xu, Xu, Xu, Xu, Xu, Xu, Xu, Xu, Xu, Xu, Xu, Xu, Xu, Xu, Xu, Xu, Xu, Xu, Xu, Xu, Xu, Xu, Xu, Xu, Xu, Xu, Xu, Xu, Xu, Xu, Xu, Xu, Xu, Xu, Xu, Xu, Xu, Xu, Xu, Xu, Xu, Xu, Xu, Xu, Xu, Xu, Xu, Xu, Xu, Xu, Xu, Xu, Xu, Xu
Xu, Xu, Xu, Xu, Xu, Xu, Xu, Xu, Xu, Xu, Xu, Xu, Xu, Xu, Xu, Xu, Xu, Xu, Xu, Xu, Xu, Xu, Xu, Xu, Xu, Xu, Uh, Xu, Uh, Xu, Uh, Xu, Uh, Xu, Tb^Tf, Xu, Uh, Xu, Xu, Xu, Xu, Xu, Xu, Xu, Xu, Xu, Xu, Xu, Xu, Xu, Xu, Xu, Xu, Xu, Xu, Xu, Xu, Xu, Xu, Xu, Xu, Xu, Xu, Xu, Xu, Xu, Xu, Xu
Xu, Xu, Xu, Xu, Xu, Xu, Xu, Xu, Xu, Xu, Xu, Xu, Xu, Xu, Xu, Xu, Xu, Xu, Xu, Xu, Xu, Xu, Xu, Xu, Qxu, Qxu, Tb^Tf, Uh, Tb^Tf, Tb^Tf, Uu, Uh, Uh, Tb^Tf, Tb^Tf, Uh, Uu, Qxu, Uu, Xu, Xu, Xu, Xu, Xu, Xu, Xu, Xu, Xu, Xu, Xu, Xu, Xu, Xu, Xu, Xu, Xu, Xu, Xu, Xu, Xu, Xu, Xu, Xu, Xu, Xu, Xu, Xu, Xu
Xu, Xu, Xu, Xu, Xu, Xu, Xu, Xu, Xu, Xu, Xu, Xu, Xu, Xu, Xu, Xu, Xu, Xu, Xu, Xu, Xu, Xu, Uh, Qxu, Qxu, Qxu, Qxu, Uh, Tb^Tf, Uu, Qxu, Tb^Tf, Qxu, Tb^Tf, Tb^Tf, Xu, Tb^Tf, Qxu, Uu, Uu, Qxu, Xu, Xu, Xu, Xu, Xu, Xu, Xu, Xu, Xu, Xu, Xu, Xu, Xu, Xu, Xu, Xu, Xu, Xu, Xu, Xu, Xu, Xu, Xu, Xu, Xu, Xu, Xu
Xu, Xu, Xu, Xu, Xu, Xu, Xu, Xu, Xu, Xu, Xu, Xu, Xu, Xu, Xu, Xu, Xu, Xu, Xu, Xu, Qxu, Uh, Qxu, Qxu, Qxu, Uh^Vud, Uu^Edb, Qxu, Tb^Tf, Qxu, Uu^Ii, Uu^Ii, Uu^Ii, Qxu, Xu, Uu, Qxu, Qxu, Uu, Qxu, Uu, Qxu, Qxu, Xu, Xu, Xu, Xu, Xu, Xu, Xu, Xu, Xu, Xu, Xu, Xu, Xu, Xu, Xu, Xu, Xu, Xu, Xu, Xu, Xu, Xu, Xu, Xu, Xu
Xu, Xu, Xu, Xu, Xu, Xu, Xu, Xu, Xu, Xu, Xu, Xu, Xu, Xu, Xu, Xu, Xu, Xu, Uh, Uh, Qxu, Qxu, Qxu, Qxu, Uh, Xu, Uu^Edb, Uu^Edb, Uu^Cov, Uu^Cov, Cud, Xos, Cud, Qxu, Qxu, Qxu, Uu^Edb, Qxu, Qxu, Uu, Xu, Uu, Uu, Uu, Uu, Xu, Xu, Xu, Xu, Xu, Xu, Xu, Xu, Xu, Xu, Xu, Xu, Xu, Xu, Xu, Xu, Xu, Xu, Xu, Xu, Xu, Xu, Xu
Xu, Xu, Xu, Xu, Xu, Xu, Xu, Xu, Xu, Xu, Xu, Xu, Xu, Xu, Xu, Xu, Qxu, Qxu, Xu, Xu, Qxu, Qxu, Uu^Edb, Uh, Tb^Tf, Xu, Uu^Edb, Uu, Cud, Xos, Uu^Ii, Uu^Ii, Uu^Cov, Xos, Cud, Uu, Uu^Edb, Xu, Qxu, Uu, Uu, Uu, Qxu, Qxu, Qxu, Uu, Uu, Xu, Xu, Xu, Xu, Xu, Xu, Xu, Xu, Xu, Xu, Xu, Xu, Xu, Xu, Xu, Xu, Xu, Xu, Xu, Xu, Xu
Xu, Xu, Xu, Xu, Xu, Xu, Xu, Xu, Xu, Xu, Xu, Xu, Xu, Xu, Qxu, Uh, Qxu, Qxu, Qxu, Qxu, Uu, Uu, Uu^Edb, Uh, Xu, Xu, Uu, Kud, Uu^Cov, Urc, Urc^Ii, Urc^Kov, Urc^Ii, Urc^Cov, Uu^Cov, Kud, Uu, Uu^Edb, Qxu, Uu, Qxu, Qxu, Xu, Xu, Qxu, Qxu, Qxu, Qxu, Wog, Xu, Xu, Xu, Xu, Xu, Xu, Xu, Xu, Xu, Xu, Xu, Xu, Xu, Xu, Xu, Xu, Xu, Xu, Xu
Xu, Xu, Xu, Xu, Xu, Xu, Xu, Xu, Xu, Xu, Xu, Xu, Wog, Wog, Qxu, Uh, Uh, Qxu, Uu, Tb^Tf, Uu, Qxu, Uu, Uu^Edb, Ur, Uu, Ur, Xos, Uu^Cov, Xos, Urc, Urc^Cov, Urc, Xos, Uu^Cov, Xos, Qxu, Uu, Qxu, Uu, Uu, Qxu, Qxu, Qxu, Uu^Edb, Uu^Vu, Qxu, Qxu, Qxu, Wog, Wog, Xu, Xu, Xu, Xu, Xu, Xu, Xu, Xu, Xu, Xu, Xu, Xu, Xu, Xu, Xu, Xu, Xu
Xu, Xu, Xu, Xu, Xu, Xu, Xu, Xu, Xu, Xu, Xu, Xu, Wog, Qxu, Xu, Uh, Qxu, Xu, Xu, Uu, Qxu, Qxu, Ur, Ur, Qxu, Ur, Uu, Cud, Cud, Urc^Ii, Ur, Urc^Cov, Ur, Urc^Ii, Cud, Qxu, Uu^Edb, Qxu, Uu, Uu, Qxu, Uu, Uu, Uu, Uu^Edb, Qxu, Qxu, Qxu, Qxu, Qxu, Wog, Xu, Xu, Xu, Xu, Xu, Xu, Xu, Xu, Xu, Xu, Xu, Xu, Xu, Xu, Xu, Xu, Xu
Xu, Xu, Xu, Xu, Xu, Xu, Xu, Xu, Xu, Xu, Xu, Xu, Qxu, Qxu, Qxu, Xu, Tb^Tf, Qxu, Uu, Qxu, Xu, Ur, Uu^Edb, Uu, Uu, Qxu, Qxu, Uu, Uu^Cov, Xos, Ur, Uu^Cov, Ur, Xos, Uu^Ii, Uu, Ur, Ur, Qxu, Ur, Uu^Edb, Uu^Edb, Uu^Edb, Uu, Uu^Edb, Uu, Xu, Qxu, Qxu, Qxu, Wog, Xu, Xu, Xu, Xu, Xu, Xu, Xu, Xu, Xu, Xu, Xu, Xu, Xu, Xu, Xu, Xu, Xu
Xu, Xu, Xu, Xu, Xu, Xu, Xu, Xu, Xu, Xu, Xu, Xu, Qxu, Tb^Tf, Uh, Qxu, Uu, Qxu, Uu, Qxu, Uu, Ur, Ur, Uh^Edb, Uh, Uu, Ur, Xos, Cud, Cud, Ur^Cov, Uu^Cov, Ur, Qxu, Qxu, Qxu, Xu, Qxu, Ur, Ur, Uu, Uu, Qxu, Xu, Xu, Uu, Uu, Qxu, Uu, Qxu, Qxu, Xu, Xu, Xu, Xu, Xu, Xu, Xu, Xu, Xu, Xu, Xu, Xu, Xu, Xu, Xu, Xu, Xu
Xu, Xu, Xu, Xu, Xu, Xu, Xu, Xu, Xu, Xu, Xu, Xu, Uh, Qxu, Uh, Qxu, Uu^Edb, Uu, Qxu, Qxu, Ur, Xu, Uu, Uh, Ur, Ur, Uu, Qxu, Qxu, Uu, Ur, Kud, Ur, Uu, Xu, Uu, Uu^Edb, Uu^Edb, Uu, Uu^Edb, Qxu, Uu, Qxu, Qxu, Qxu, Qxu, Qxu, Uu, Ur^Edb, Uu, Uu, Xu, Xu, Xu, Xu, Xu, Xu, Xu, Xu, Xu, Xu, Xu, Xu, Xu, Xu, Xu, Xu, Xu
Xu, Xu, Xu, Xu, Xu, Xu, Xu, Xu, Xu, Xu, Xu, Xu, Qxu, Xu, Uu, Uu^Edb, Uu, Tb^Tf, Qxu, Tb^Tf, Ur, Xu, Ur, Ur, Qxu, Qxu, Ur, Uu^Vu, Qxu, Uu, Ur, Qxu, Qxu, Ur, Ur, Uu^Edb, Ur, Ur, Qxu, Qxu, Uu^Edb, Uu, Uu, Qxu, Ur, Uu, Uu, Uu, Ur, Uu^Edb, Uu^Edb, Xu, Xu, Xu, Xu, Xu, Xu, Xu, Xu, Xu, Xu, Xu, Xu, Xu, Xu, Xu, Xu, Xu
Xu, Xu, Xu, Xu, Xu, Xu, Xu, Xu, Xu, Xu, Xu, Xu, Qxu, Tb^Tf, Qxu, Uu, Xu, Qxu, Xu, Uu, Ur, Uu, Qxu, Qxu, Uh, Uu, Tb^Tf, Uu, Ur, Ur, Ur, Uh, Uh, Qxu, Ur, Xu, Ur, Qxu, Qxu, Xu, Xu, Uu^Edb, Qxu, Ur, Uu, Ur, Ur, Ur, Uu, Uu, Uu, Xu, Xu, Xu, Xu, Xu, Xu, Xu, Xu, Xu, Xu, Xu, Xu, Xu, Xu, Xu, Xu, Xu
Xu, Xu, Xu, Xu, Xu, Xu, Xu, Xu, Xu, Xu, Xu, Xu, Uh, Qxu, Uu^Vud, Uu, Uu, Uu, Uh, Ur, Ur, Uu^Edb, Qxu, Tb^Tf, Ur, Ur, Ur^Edb, Ur^Edb, Uu^Edb, Uu^Edb, Ur, Tb^Tf, Uh, Qxu, Ur, Uu^Edb, Uh^Edb, Ur, Qxu, Qxu, Qxu, Xu, Uu^Edb, Qxu, Uu^Edb, Uu, Ur^Edb, Uu, Uu, Uu, Uh, Xu, Xu, Xu, Xu, Xu, Xu, Xu, Xu, Xu, Xu, Xu, Xu, Xu, Xu, Xu, Xu, Xu
Uu, Xu, Tb^Tf, Xu, Tb^Tf, Xu, Uu, Xu, Uu, Xu, Uh, Xu, Tb^Tf, Tb^Tf, Uu, Uu, Ur, Uh, Tb^Tf, Uh, Uu, Ur^Edb, Ur^Edb, Ur, Uu^Edb, Uu^Edb, Qxu, Uu^Edb, Qxu, Uu, Ur, Uh, Qxu, Qxu, Ur, Tb^Tf, Uh^Edb, Uu^Edb, Ur, Qxu, Uu, Uu^Edb, Ur, Uu, Ur^Edb, Uu^Edb, Ur^Edb, Uu^Edb, Uu^Edb, Uh^Vu, Uh^Edb, Xu, Uh, Xu, Uu^Edb, Xu, Uh, Xu, Uu^Uf, Xu, Uh, Xu, Uu^Uf, Xu, Uh, Xu, Uh, Xu
Uu, Ur, Ur, Tb^Tf, Ur, Uu, Ur, Ur, Ur, Uu, Ur, Ur, Cud, Ur, Ur, Ur^Edb, Uu^Edb, Uu^Edb, Ur, Uu, Tb^Tf, Uu, Ur, Uu, Uu, Qxu, Ur, Uu, Ur, Qxu, Ur^Edb, Qxu, Ur^Edb, Uu, Ur, Uu, Ur, Ur^Edb, Uu, Ur, Ur, Ur, Uu, Xu, Uu^Edb, Ur^Edb, Uu^Edb, Ur^Edb, Ur^Edb, Ur, Cte, Ur^Edb, Ur^Edb, Ur, Ur^Edb, Ur^Edb, Ur, Ur, Ur, Ur, Ur, Ur, Ur, Ur, Ur, Uh, Uu, Ur
Uh, Ur, Uu, Uu, Uu, Ur, Uh, Tb^Tf, Uh, Ur, Uu, Cud, Kud, Cud, Uu, Uu^Edb, Xu, Uh^Edb, Xu, Ur, Tb^Tf, Tb^Tf, Ur, Qxu, Qxu, Uu, Ur, Uu, Uh, Uu, Tb^Tf, Uu^Edb, Ur, Ur, Qxu, Qxu, Ur^Edb, Xu, Qxu, Ur, Xu, Uu, Uu, Uu, Uu^Edb, Uu^Edb, Qxu, Uu, Uu^Edb, Cte, Kte, Cte, Uu, Uu^Edb, Uh, Uu, Uu, Uu, Uh, Uu, Uu^Uf, Uu, Uu^Uf, Uu, Uu^Uf, Uu, Uu, Uu
Xu, Xu, Xu, Xu, Xu, Xu, Xu, Xu, Xu, Xu, Xu, Xu, Cud, Cud, Xu, Xu, Ur, Xu, Uu, Ur, Uu, Ur, Uu^Edb, Qxu, Uu, Uu, Ur, Qxu, Qxu, Qxu, Qxu, Qxu, Qxu, Ur, Qxu, Uu, Ur, Qxu, Qxu, Ur, Xu, Uu, Qxu, Qxu, Uu^Vu, Qxu, Uh^Edb, Qxu, Uu^Edb, Cte, Cte, Xu, Xu, Xu, Xu, Xu, Xu, Xu, Xu, Xu, Xu, Xu, Xu, Xu, Xu, Xu, Xu, Xu
Xu, Xu, Xu, Xu, Xu, Xu, Xu, Xu, Xu, Xu, Xu, Xu, Uh, Uu, Uu, Ur, Qxu, Ur, Qxu, Qxu, Qxu, Ur, Ur, Ur^Edb, Ur, Ur, Uu, Ur, Ur, Uu, Ur, Uh, Qxu, Ur, Uu^Vud, Ur, Ur, Qxu, Ur, Uu^Edb, Tb^Tf, Uh, Uu, Qxu, Qxu, Uu^Edb, Uu, Uu^Edb, Uu, Tb^Tf, Uh, Xu, Xu, Xu, Xu, Xu, Xu, Xu, Xu, Xu, Xu, Xu, Xu, Xu, Xu, Xu, Xu, Xu
Xu, Xu, Xu, Xu, Xu, Xu, Xu, Xu, Xu, Xu, Xu, Xu, Qxu, Qxu, Qxu, Qxu, Uu, Uu^Edb, Uu^Edb, Tb^Tf, Uu, Qxu, Uu, Uu, Qxu, Qxu, Uh, Uu, Ur, Uu^Edb, Ur^Edb, Qxu, Ur, Ur, Qxu, Uu^Edb, Ur, Ur, Uu, Ur, Uu, Uh, Uu, Uu, Ur, Qxu, Uh, Uu^Edb, Uu, Qxu, Tb^Tf, Xu, Xu, Xu, Xu, Xu, Xu, Xu, Xu, Xu, Xu, Xu, Xu, Xu, Xu, Xu, Xu, Xu
Xu, Xu, Xu, Xu, Xu, Xu, Xu, Xu, Xu, Xu, Xu, Xu, Xu, Qxu, Tb^Tf, Uh, Tb^Tf, Uu, Qxu, Uu, Xu, Qxu, Ur, Qxu, Xu, Qxu, Uh, Tb^Tf, Ur, Qxu, Ur, Uu, Ur, Uu, Qxu, Uu, Ur^Edb, Xu, Qxu, Ur, Qxu, Ur, Qxu, Ur, Uu, Qxu, Qxu, Qxu, Uu, Qxu, Xu, Xu, Xu, Xu, Xu, Xu, Xu, Xu, Xu, Xu, Xu, Xu, Xu, Xu, Xu, Xu, Xu, Xu
Xu, Xu, Xu, Xu, Xu, Xu, Xu, Xu, Xu, Xu, Xu, Xu, Xu, Xu, Xu, Uu, Qxu, Qxu, Tb^Tf, Qxu, Qxu, Qxu, Tb^Tf, Ur, Uu^Edb, Qxu, Qxu, Ur, Uu^Edb, Qxu, Ur, Uh, Tb^Tf, Ur, Qxu, Uu, Ur, Uu^Edb, Qxu, Qxu, Qxu, Uu, Qxu, Qxu, Qxu, Qxu, Uh, Uu, Xu, Xu, Xu, Xu, Xu, Xu, Xu, Xu, Xu, Xu, Xu, Xu, Xu, Xu, Xu, Xu, Xu, Xu, Xu, Xu
Xu, Xu, Xu, Xu, Xu, Xu, Xu, Xu, Xu, Xu, Xu, Xu, Xu, Xu, Xu, Xu, Xu, Uu, Tb^Tf, Tb^Tf, Tb^Tf, Uh, Uu, Qxu, Uu, Ur, Ur, Ur, Ur, Qxu, Ur, Uu, Ur, Ur, Qxu, Xu, Uu, Ur^Edb, Ur, Qxu, Qxu, Uu, Uu, Uu, Uu, Uu, Xu, Xu, Xu, Xu, Xu, Xu, Xu, Xu, Xu, Xu, Xu, Xu, Xu, Xu, Xu, Xu, Xu, Xu, Xu, Xu, Xu, Xu
Xu, Xu, Xu, Xu, Xu, Xu, Xu, Xu, Xu, Xu, Xu, Xu, Xu, Xu, Xu, Xu, Xu, Xu, Xu, Tb^Tf, Uh, Uh, Tb^Tf, Qxu, Tb^Tf, Uu, Qxu, Uu, Ur, Uu, Ur^Cov, Kud, Ur^Cov, Uu, Qxu, Uu, Ur, Ur, Uu^Edb, Uu, Qxu, Qxu, Qxu, Qxu, Xu, Xu, Xu, Xu, Xu, Xu, Xu, Xu, Xu, Xu, Xu, Xu, Xu, Xu, Xu, Xu, Xu, Xu, Xu, Xu, Xu, Xu, Xu, Xu
Xu, Xu, Xu, Xu, Xu, Xu, Xu, Xu, Xu, Xu, Xu, Xu, Xu, Xu, Xu, Xu, Xu, Xu, Xu, Xu, Xu, Uh, Tb^Tf, Qxu, Uh, Tb^Tf, Qxu, Uu, Cud, Cud, Ur, Uu, Ur, Cud, Cud, Ur, Xu, Uu, Uu^Edb, Qxu, Uh, Uh, Xu, Xu, Xu, Xu, Xu, Xu, Xu, Xu, Xu, Xu, Xu, Xu, Xu, Xu, Xu, Xu, Xu, Xu, Xu, Xu, Xu, Xu, Xu, Xu, Xu, Xu
Xu, Xu, Xu, Xu, Xu, Xu, Xu, Xu, Xu, Xu, Xu, Xu, Xu, Xu, Xu, Xu, Xu, Xu, Xu, Xu, Xu, Xu, Xu, Qxu, Qxu, Qxu, Uh, Uh, Kud, Uu, Rr^Pr|o, Uu, Rr^Pr|o, Uu, Kud, Uu, Qxu, Qxu, Qxu, Uu, Xu, Xu, Xu, Xu, Xu, Xu, Xu, Xu, Xu, Xu, Xu, Xu, Xu, Xu, Xu, Xu, Xu, Xu, Xu, Xu, Xu, Xu, Xu, Xu, Xu, Xu, Xu, Xu
Xu, Xu, Xu, Xu, Xu, Xu, Xu, Xu, Xu, Xu, Xu, Xu, Xu, Xu, Xu, Xu, Xu, Xu, Xu, Xu, Xu, Xu, Xu, Xu, Xu, Uh, Xu, Uh, Xu, Qxu, Qxu^Bcx|, Rr^Pr|o, Qxu^Bcx|, Qxu, Xu, Uh, Xu, Uh, Xu, Xu, Xu, Xu, Xu, Xu, Xu, Xu, Xu, Xu, Xu, Xu, Xu, Xu, Xu, Xu, Xu, Xu, Xu, Xu, Xu, Xu, Xu, Xu, Xu, Xu, Xu, Xu, Xu, Xu
Xu, Xu, Xu, Xu, Xu, Xu, Xu, Xu, Xu, Xu, Xu, Xu, Xu, Xu, Xu, Xu, Xu, Xu, Xu, Xu, Xu, Xu, Xu, Xu, Xu, Xu, Xu, Xu, Kud, Qxu, Qxu^Bcx|, Qxu^Bcx|, Qxu^Bcx|, Qxu, Kud, Xu, Xu, Xu, Xu, Xu, Xu, Xu, Xu, Xu, Xu, Xu, Xu, Xu, Xu, Xu, Xu, Xu, Xu, Xu, Xu, Xu, Xu, Xu, Xu, Xu, Xu, Xu, Xu, Xu, Xu, Xu, Xu, Xu
Xu, Xu, Xu, Xu, Xu, Xu, Xu, Xu, Xu, Xu, Xu, Xu, Xu, Xu, Xu, Xu, Xu, Xu, Xu, Xu, Xu, Xu, Xu, Xu, Xu, Xu, Xu, Xu, Xu, Qxu, Qxu^Bcx|, Qxu^Bcx|, Qxu, Qxu, Xu, Xu, Xu, Xu, Xu, Xu, Xu, Xu, Xu, Xu, Xu, Xu, Xu, Xu, Xu, Xu, Xu, Xu, Xu, Xu, Xu, Xu, Xu, Xu, Xu, Xu, Xu, Xu, Xu, Xu, Xu, Xu, Xu, Xu
Xu, Xu, Xu, Xu, Xu, Xu, Xu, Xu, Xu, Xu, Xu, Xu, Xu, Xu, Xu, Xu, Xu, Xu, Xu, Xu, Xu, Xu, Xu, Xu, Xu, Xu, Xu, Xu, Kud, Qxu, Qxu^Xo, Qxu^Bcx|, Qxu^Bcx|, Qxu, Kud, Xu, Xu, Xu, Xu, Xu, Xu, Xu, Xu, Xu, Xu, Xu, Xu, Xu, Xu, Xu, Xu, Xu, Xu, Xu, Xu, Xu, Xu, Xu, Xu, Xu, Xu, Xu, Xu, Xu, Xu, Xu, Xu, Xu
Xu, Xu, Xu, Xu, Xu, Xu, Xu, Xu, Xu, Xu, Xu, Xu, Xu, Xu, Xu, Xu, Xu, Xu, Xu, Xu, Xu, Xu, Xu, Xu, Xu, Xu, Xu, Xu, Xu, Qxu^Xo, Qxu, Qxu^Xo, Qxu^Xo, Qxu^Xo, Xu, Xu, Xu, Xu, Xu, Xu, Xu, Xu, Xu, Xu, Xu, Xu, Xu, Xu, Xu, Xu, Xu, Xu, Xu, Xu, Xu, Xu, Xu, Xu, Xu, Xu, Xu, Xu, Xu, Xu, Xu, Xu, Xu, Xu
Xu, Xu, Xu, Xu, Xu, Xu, Xu, Xu, Xu, Xu, Xu, Xu, Xu, Xu, Xu, Xu, Xu, Xu, Xu, Xu, Xu, Xu, Xu, Xu, Xu, Xu, Xu, Xu, Kud, Qxu, Qxu^Bcx|, Qxu^Bcx|, Qxu^Bcx|, Qxu, Kud, Xu, Xu, Xu, Xu, Xu, Xu, Xu, Xu, Xu, Xu, Xu, Xu, Xu, Xu, Xu, Xu, Xu, Xu, Xu, Xu, Xu, Xu, Xu, Xu, Xu, Xu, Xu, Xu, Xu, Xu, Xu, Xu, Xu
Xu, Xu, Xu, Xu, Xu, Xu, Xu, Xu, Xu, Xu, Xu, Xu, Xu, Xu, Xu, Xu, Xu, Xu, Xu, Xu, Xu, Xu, Xu, Xu, Xu, Xu, Xu, Xu, Xu, Qxu, Qxu^Bcx|, Qxu^Bcx|, Qxu^Bcx|, Qxu, Xu, Xu, Xu, Xu, Xu, Xu, Xu, Xu, Xu, Xu, Xu, Xu, Xu, Xu, Xu, Xu, Xu, Xu, Xu, Xu, Xu, Xu, Xu, Xu, Xu, Xu, Xu, Xu, Xu, Xu, Xu, Xu, Xu, Xu
Xu, Xu, Xu, Xu, Xu, Xu, Xu, Xu, Xu, Xu, Wog, Xu, Xu, Xu, Xu, Xu, Xu, Xu, Xu, Xu, Xu, Xu, Xu, Xu, Xu, Xu, Xu, Xu, 2 Kud, Qxu, Qxu^Bcx|, Qxu, Qxu^Bcx|, Qxu, Kud, Xu, Xu, Xu, Xu, Xu, Xu, Xu, Xu, Xu, Xu, Xu, Xu, Xu, Xu, Xu, Xu, Xu, Xu, Xu, Xu, Xu, Xu, Xu, Xu, Xu, Xu, Xu, Xu, Xu, Xu, Xu, Xu, Xu
Xu, Xu, Xu, Xu, Xu, Xu, Wog^Ii, Wog^Ii, Wog^Ii, Wog^Ii, Qxu^Ii, Wog, Wog^Ii, Xu, Xu, Xu, Xu, Xu, Xu, Xu, Xu, Xu, Xu, Xu, Tb^Tf, Uu, Uu, Cud, Cud, Cud, Qxu^Bcx|, Qxu^Bcx|, Qxu^Bcx|, Cud, Cud, Cud, Tb^Tf, Xu, Xu, Xu, Xu, Xu, Xu, Xu, Xu, Xu, Xu, Xu, Xu, Xu, Xu, Xu, Xu, Xu, Xu, Xu, Xu, Xu, Xu, Xu, Xu, Xu, Xu, Xu, Xu, Xu, Xu, Xu
Xu, Xu, Xu, Xu, Xu, Xu, Wog^Ii, Qxu^Ii, Qxu, Qxu^Ii, Qxu, Qxu^Ii, Qxu, Wog^Ii, Uh^Edb, Xu, Xu, Xu, Xu, Xu, Xu, Xu, Xu, Uh, Tb^Tf, Xu, Xu, Ur, Qxu^Ii, Uh^Cov, Uu^Cov, Uh^Cov, Uu^Cov, Qxu^Cov, Qxu, Tb^Tf, Uh^Edb, Tb^Tf, Uh^Ii, Xu, Uh, Xu, Xu, Xu, Wog^Ii, Wog^Ii, Wog, Xu, Xu, Xu, Xu, Xu, Xu, Xu, Xu, Xu, Xu, Xu, Xu, Xu, Xu, Xu, Xu, Xu, Xu, Xu, Xu, Xu
Xu, Xu, Xu, Xu, Wog^Ii, Wog, Qxu, Qxu^Ii, Qxu^Ii, Qxu, Qxu, Qxu, Qxu, Qxu, Uh, Uh, Uh, Xu, Xu, Xu, Xu, Uh^Ii, Uu^Edb, Xu, Uu^Edb, Uu^Edb, Ur^Edb, Ur, Qxu, Uu^Edb, Ur^Edb, Ur, Ur^Edb, Xu, Qxu^Ii, Uu^Edb, Tb^Tf, Uh^Ii, Ur, Xu, Ur, Tb^Tf, Xu, Wog, Qxu^Ii, Qxu, Qxu, Wog, Wog, Xu, Xu, Xu, Xu, Xu, Xu, Xu, Xu, Xu, Xu, Xu, Xu, Xu, Xu, Xu, Xu, Xu, Xu, Xu
Xu, Xu, Xu, Xu, Wog^Ii, Qxu, Qxu^Ii, Qxu, Qxu, Qxu, Qxu, Qxu, Qxu, Uh, Uh, Uh^Edb, Tb^Tf, Uu, Xu, Xu, Xu, Uu^Edb, Ur^Edb, Ur, Xu, Ur, Qxu^Bs\, Uh^Ii, Qxu, Uh, Uh^Ii, Xu, Uu^Ii, Ur, Qxu^Bs\, Qxu, Qxu^Bs/, Ur, Qxu, Uu^Edb, Ur^Edb, Tb^Tf, Qxu, Qxu^Ii, Qxu^Ii, Qxu, Qxu, Qxu, Wog, Xu, Xu, Xu, Xu, Xu, Xu, Xu, Xu, Xu, Xu, Xu, Xu, Xu, Xu, Xu, Xu, Xu, Xu, Xu
Xu, Xu, Xu, Xu, Wog^Ii, Qxu^Ii, Qxu, Qxu, Qxu, Qxu, Qxu, Qxu, Qxu, Uu, Uu^Edb, Uu, Uu^Edb, Uu, Uu^Edb, Uh^Vu, Ur, Uu^Edb, Ur, Uu^Ii, Uu^Ii, Qxu^Ii, Xu, Qxu^Bs\, Ur, Ur, Uh^Vu, Ur, Uu, Uu, Qxu^Ii, Ur, Ur, Qxu^Ii, Tb^Tf, Qxu^Bs/, Qxu, Xu, Qxu^Ii, Qxu^Ii, Qxu, Qxu, Qxu, Qxu, Qxu, Wog, Wog, Xu, Xu, Xu, Xu, Xu, Xu, Xu, Xu, Xu, Xu, Xu, Xu, Xu, Xu, Xu, Xu, Xu
Xu, Xu, Xu, Xu, Xu, Wog, Qxu, Qxu, Qxu, Qxu, Tb^Tf, Qxu, Qxu, Tb^Tf, Qxu, Uu^Edb, Qxu^Ii, Uu^Edb, Uu, Ur^Edb, Xu, Xu, Uu, Ur, Uu^Edb, Qxu, Ur^Edb, Ur, Xu, Ur, Ur, Ur, Ur, Xu, Uu, Uh^Edb, Uh, Uu, Ur, Xu, Uu, Qxu, Qxu, Qxu, Qxu, Qxu, Qxu, Qxu, Qxu, Qxu, Wog, Xu, Xu, Xu, Xu, Xu, Xu, Xu, Xu, Xu, Xu, Xu, Xu, Xu, Xu, Xu, Xu, Xu
Xu, Xu, Xu, Xu, Tb^Tf, Tb^Tf, Uh^Edb, Tb^Tf, Qxu, Tb^Tf, Xu, Uu, Uu, Qxu, Uu^Vud, Qxu^Ii, Qxu^Bs/, Qxu^Bs/, Qxu^Ii, Uh, Uu, Uu, Qxu^Ii, Qxu^Ii, Ur, Uu^Edb, Uh, Uu, Tb^Tf, Uu^Edb, Ur, Xu, Qxu^Ii, Qxu^Bs\, Ur, Uh^Edb, Uu^Ii, Ur, Xu, Uu^Edb, Ur, Uh^Vud, Uh, Qxu, Qxu, Qxu, Qxu, Qxu, Qxu, Qxu, Qxu, Tb^Tf, Xu, Xu, Xu, Xu, Xu, Xu, Xu, Xu, Xu, Xu, Xu, Xu, Xu, Xu, Xu, Xu
Xu, Xu, Xu, Tb^Tf, Uh, Uh^Edb, Uh, Uh, Qxu, Tb^Tf, Ur^Edb, Uh, Ur^Edb, Ur^Edb, Uu, Ur, Ur, Qxu, Qxu^Bs/, Qxu^Bs/, Qxu, Uh^Vu, Qxu^Ii, Tb^Tf, Ur, Uh, Uh, Uu^Edb, Ur, Ur, Qxu, Qxu^Bs\, Ur, Qxu^Ii, Qxu, Ur, Uu^Ii, Ur, Xu, Tb^Tf, Uu^Edb, Uu, Uh, Qxu, Qxu, Qxu, Qxu, Qxu, Qxu, Qxu, Uu, Uu, Xu, Xu, Xu, Xu, Xu, Xu, Xu, Xu, Xu, Xu, Xu, Xu, Xu, Xu, Xu, Xu
Xu, Xu, Xu, Uh, Uh^Edb, Tb^Tf, Tb^Tf, Xu, Xu, Qxu, Qxu, Ur, Uu, Uu^Edb, Uh, Xu, Uh, Ur, Ur^Edb, Qxu^Ii, Uh, Qxu, Qxu, Uu, Xu, Ur, Ur^Edb, Ur^Edb, Tb^Tf, Uu^Vu, Qxu, Tb^Tf, Qxu, Ur^Edb, Ur^Edb, Qxu^Ii, Qxu, Uu^Edb, Ur^Edb, Ur^Edb, Ur, Uu, Qxu, Qxu, Uu, Uu^Edb, Ur, Uu, Uu^Edb, Xu, Uh, Uh, Xu, Xu, Xu, Xu, Xu, Xu, Xu, Xu, Xu, Xu, Xu, Xu, Xu, Xu, Xu, Xu
Xu, Xu, Xu, Tb^Tf, Tb^Tf, Ur, Ur^Edb, Uu, Uu, Uh^Vud, Qxu, Uu, Qxu, Xu, Ur^Edb, Uh, Uu, Uu, Uh, Ur^Edb, Uu, Xu, Qxu, Xu, Uu^Edb, Ur, Qxu, Tb^Tf, Qxu, Qxu, Qxu, Qxu, Qxu, Xu, Uu, Ur^Edb, Ur, Qxu, Ur, Qxu, Qxu, Ur, Ur^Edb, Xu, Uu, Uu^Edb, Ur, Xu, Ur, Ur, Uh, Xu, Xu, Xu, Xu, Xu, Xu, Xu, Xu, Xu, Xu, Xu, Xu, Xu, Xu, Xu, Xu, Xu
Xu, Xu, Xu, Xu, Xu, Uh, Uu, Uu^Edb, Ur, Qxu, Ur, Uu, Ur^Edb, Ur^Edb, Qxu, Ur, Uh, Xu, Uh, Ur, Xu, Uh, Uu, Qxu, Ur, Qxu, Qxu, Qxu, Wog^Ii, Wog^Ii, Wog^Ii, Qxu^Ii, Qxu, Qxu, Tb^Tf, Uh^Vu, Uh, Ur^Edb, Uu, Uh^Vud, Qxu, Uh, Uu, Ur, Xu, Uh^Vu, Uu, Uu, Ur, Uu^Edb, Xu, Xu, Xu, Xu, Xu, Xu, Xu, Xu, Xu, Xu, Xu, Xu, Xu, Xu, Xu, Xu, Xu, Xu
Xu, Xu, Xu, Xu, Xu, Xu, Qxu, Uu, Qxu, Ur, Xu, Ur, Ur^Edb, Uu, Tb^Tf, Qxu, Qxu, Ur, Ur, Ur^Edb, Uu, Xu, Ur, Ur, Tb^Tf, Qxu, Qxu, Qxu^Ii, Xu, Xu, Xu, Xu, Wog^Ii, Qxu, Qxu, Uu^Edb, Ur, Ur^Edb, Qxu, Qxu, Uh, Qxu, Qxu^Bs/, Ur, Ur, Uu, Xu, Uu, Uu, Uu^Edb, Xu, Xu, Xu, Xu, Xu, Xu, Xu, Xu, Xu, Xu, Cud, Xu, Cud, Xu, Xu, Xu, Xu, Xu
Xu, Xu, Xu, Xu, Xu, Xu, Cud, Qxu, Uu, Uu, Uu, Uu, Ur^Edb, Uu, Tb^Tf, Qxu, Qxu, Tb^Tf, Qxu, Ur^Edb, Qxu, Uh, Uu^Edb, Uh, Xu, Xu, Qxu, Qxu, Qxu^Ii, Wog^Ii, Wog^Ii, Xu, Wog^Ii, Qxu^Ii, Qxu, Tb^Tf, Qxu, Qxu^Bs\, Ur, Xu, Ur, Ur, Qxu, Uu, Ur^Edb, Ur, Uu, Xu, Ur, Ur, Ur, Xu, Ur, Tb^Tf, Ur, Xu, Tb^Tf, Xu, Uu, Tb^Tf, Ur, 1 Kud, Ur, Uu, Ur, Uu^Vud, Uu, Xu
Xu, Xu, Xu, Xu, Xu, 3 Kud, Cud, Cud, Uu, Uu, Ur, Xu, Uu^Edb, Xu, Uu, Tb^Tf, Qxu, Qxu, Uu, Ur, Uu^Edb, Qxu, Qxu, Uh^Edb, Qxu, Qxu, Uu, Tb^Tf, Tb^Tf, Qxu, Qxu, Wog^Ii, Qxu, Qxu, Qxu, Qxu, Tb^Tf, Xu, Ur, Ur, Tb^Tf, Ur, Qxu^Bs\, Uu^Edb, Ur^Edb, Xu, Ur, Ur, Uu^Vud, Ur, Ur^Edb, Ur^Edb, Ur, Ur, Ur^Edb, Ur, Ur, Ur, Ur, Ur, Uu, Ur^Cov, Uu, Ur, Ur, Ur, Ur, Ur
Uh, Uh, Uh, Uh, Uu, Cud, Cud, Cud, Ur^Edb, Ur, Uu, Uu, Uu, Uu^Edb, Uu, Xu, Qxu, Tb^Tf, Uu, Ur, Ur, Uu, Uh, Qxu, Tb^Tf, Uu^Vu, Ur, Xu, Uu^Edb, Qxu, Qxu, Qxu^Ii, Tb^Tf, Qxu, Qxu, Qxu, Ur^Edb, Ur, Tb^Tf, Ur, Tb^Tf, Qxu, Tb^Tf, Ur, Xu, Ur, Uu, Uu, Ur, Ur, Tb^Tf, Tb^Tf, Tb^Tf, Ur, Tb^Tf, Ur, Uu^Vud, Ur, Tb^Tf, Uu, Cud, Kud, Cud, Uu, Xu, Ur, Uu, Uu
Uu, Uh, Uu^Edb, Uu, Uu, Uu, Ur, Ur, Uu^Edb, Xu, Uu^Vud, Tb^Tf, Uu, Xu, Uu, Uu^Vud, Qxu, Uu, Uu^Edb, Xu, Uh, Ur^Edb, Uh, Qxu, Qxu, Ur^Edb, Uu, Uu^Edb, Ur^Edb, Uu, Uu, Tb^Tf, Ur, Ur^Edb, Uu^Edb, Ur^Edb, Uu, Qxu, Qxu, Tb^Tf, Qxu, Xu, Qxu, Tb^Tf, Qxu, Uh, Tb^Tf, Uh, Tb^Tf, Uu, Xu, Xu, Xu, Xu, Xu, Xu, Xu, Xu, Xu, Xu, Xu, Xu, Xu, Xu, Xu, Xu, Xu, Xu
Uu, Uu^Edb, Ur, Ur, Ur^Edb, Ur, Uu, Uu^Edb, Uu, Xu, Xu, Uu, Qxu, Qxu, Qxu, Qxu, Tb^Tf, Uh, Uu^Edb, Uh, Xu, Ur^Edb, Ur, Uh, Uu, Ur, Tb^Tf, Xu, Uh, Ur, Cte, Cte, Cte, Xu, Xu, Ur^Edb, Uu^Edb, Uh, Uh, Qxu, Qxu, Qxu, Qxu, Qxu, Qxu, Qxu, Qxu, Qxu, Qxu, Xu, Xu, Xu, Xu, Xu, Xu, Xu, Xu, Xu, Xu, Xu, Xu, Xu, Xu, Xu, Xu, Xu, Xu, Xu
Ur, Ur^Edb, Uu, Uu, Uu, Uu, Uu, Uu^Edb, Uh^Edb, Tb^Tf, Tb^Tf, Tb^Tf, Qxu, Qxu, Qxu, Qxu, Qxu, Tb^Tf, Tb^Tf, Uu^Edb, Xu, Uu, Uu^Edb, Ur^Edb, Ur, Uu, Xu, Xu, Tb^Tf, Ur, Cte, Cte, Cte, Uh, Ur, Ur^Edb, Uh, Tb^Tf, Tb^Tf, Qxu, Qxu, Qxu, Qxu, Qxu, Qxu, Qxu, Qxu, Qxu, Qxu, Wog, Xu, Xu, Xu, Xu, Xu, Xu, Xu, Xu, Xu, Xu, Xu, Xu, Xu, Xu, Xu, Xu, Xu, Xu
Uh, Uu, Uh, Uu, Xu, Uh, Xu, Xu, Xu, Tb^Tf, Wog, Qxu, Qxu, Qxu, Qxu, Qxu, Qxu, Qxu, Tb^Tf, Uu, Uu, Uu^Edb, Xu, Uu, Uu, Ur, Ur^Edb, Uh, Ur^Edb, Ur, Ur, 4 Kte, Ur^Edb, Ur^Edb, Uu, Uu^Vu, Tb^Tf, Uh, Tb^Tf, Qxu, Qxu, Qxu, Qxu, Qxu, Qxu, Qxu, Qxu, Qxu, Wog, Wog, Xu, Xu, Xu, Xu, Xu, Xu, Xu, Xu, Xu, Xu, Xu, Xu, Xu, Xu, Xu, Xu, Xu, Xu
Uh, Uh, Xu, Xu, Xu, Xu, Xu, Xu, Xu, Xu, Wog, Qxu, Qxu, Qxu, Qxu, Qxu, Qxu, Qxu, Tb^Tf, Tb^Tf, Tb^Tf, Xu, Uh, Uu, Uu, Uu^Edb, Xu, Ur, Tb^Tf, Uu^Vu, Uh, Ur^Edb, Uu, Uu, Tb^Tf, Uu, Xu, Uh, Tb^Tf, Qxu, Qxu, Qxu, Qxu, Qxu, Qxu, Qxu, Qxu, Qxu, Wog, Xu, Xu, Xu, Xu, Xu, Xu, Xu, Xu, Xu, Xu, Xu, Xu, Xu, Xu, Xu, Xu, Xu, Xu, Xu
Xu, Xu, Xu, Xu, Xu, Xu, Xu, Xu, Xu, Xu, Xu, Wog, Wog, Qxu, Wog, Qxu, Qxu, Qxu, Xu, Uh, Xu, Uh, Xu, Uh, Xu, Xu, Xu, Xu, Xu, Tb^Tf, Uh, Ur, Uu, Tb^Tf, Uh, Xu, Xu, Xu, Xu, Wog, Wog, Wog, Wog, Qxu, Qxu, Qxu, Wog, Wog, Xu, Xu, Xu, Xu, Xu, Xu, Xu, Xu, Xu, Xu, Xu, Xu, Xu, Xu, Xu, Xu, Xu, Xu, Xu, Xu
Xu, Xu, Xu, Xu, Xu, Xu, Xu, Xu, Xu, Xu, Xu, Xu, Xu, Wog, Xu, Wog, Wog, Wog, Xu, Xu, Xu, Xu, Xu, Xu, Xu, Xu, Xu, Xu, Xu, Uh, Uu, Ur^Edb, Uu, Tb^Tf, Xu, Xu, Xu, Xu, Xu, Xu, Xu, Xu, Xu, Wog, Wog, Wog, Xu, Xu, Xu, Xu, Xu, Xu, Xu, Xu, Xu, Xu, Xu, Xu, Xu, Xu, Xu, Xu, Xu, Xu, Xu, Xu, Xu, Xu
Xu, Xu, Xu, Xu, Xu, Xu, Xu, Xu, Xu, Xu, Xu, Xu, Xu, Xu, Xu, Xu, Xu, Xu, Xu, Xu, Xu, Xu, Xu, Xu, Xu, Xu, Xu, Xu, Xu, Tb^Tf, Uu, Ur, Uu, Tb^Tf, Xu, Xu, Xu, Xu, Xu, Xu, Xu, Xu, Xu, Xu, Xu, Xu, Xu, Xu, Xu, Xu, Xu, Xu, Xu, Xu, Xu, Xu, Xu, Xu, Xu, Xu, Xu, Xu, Xu, Xu, Xu, Xu, Xu, Xu
