Mm, Mm, Mm, Mm, Mm, Mm, Mm, Mm, Mm, Hh^Fmf, Hh^Fmf, Gg, Gll^Fmf, Gg, Gll^Fmf, Gll^Fmf, Gll^Fmf, Gll^Fmf, Gll^Fmf, Gg, Gll, Gg, Hh^Fmf, Hh, Hh, Hh^Fmf, Hh^Fmf, Hh, Hh, Hh, Hh^Fmf, Hh, Gll^Fmf, Gll, Gg, Gg, Gll, Gll, Gll, Gg, Gg^Efm, Gg, Gll, Gg, Gll, Gll^Fmf, Gll^Fmf, Hh^Fmf, Hh^Fmf, Gg
Mm, Mm, Mm, Mm, Mm, Mm, Mm, Mm, Mm, Hh^Fmf, Hh^Fmf, Gll^Fmf, Gll, Gll^Fmf, Gll^Fmf, Gll, Gll, Gll, Gll^Fmf, Gll, Gll^Fmf, Gll^Fmf, Hh, Hh^Fmf, Hh^Fmf, Hh, Hh^Fmf, Hh^Fmf, Hh^Fmf, Hh^Fmf, Hh^Fmf, Hh, Gll^Fmf, Gll, Gll, Gll, Gll^Fmf, Gll^Fmf, Gll^Fmf, Gll, Gll, Gll^Efm, Gll^Fmf, Gll^Fmf, Gll, Gll^Fmf, Hh^Fmf, Hh^Fmf, Hh^Fmf, Hh^Fmf
Mm, Mm, Mm, Mm, Mm, Mm, Mm, Mm, Hh^Fmf, Hh^Fmf, Gll, Gll^Fmf, Gll^Fmf, Gll, Gll^Fmf, Gll^Fmf, Gll^Fmf, Gll^Fmf, Gll^Fmf, Gll, Gd^Fetd, Gll, Gd^Fetd, Hh, Gd, Hh^Fmf, Hh^Ve, Hh^Fmf, Hh, Hh^Fmf, Gll^Fmf, Gll, Gll^Fmf, Gll, Gll^Fmf, Gll^Fmf, Gll^Fmf, Gll, Gll^Fmf, Gll^Fmf, Gll^Fmf, Gll^Fmf, Gll^Fmf, Gll^Fmf, Gll, Hh^Fmf, Hh^Fmf, Hh^Fmf, Mm, Mm
Mm, Mm, Mm, Mm, Mm, Mm, Hh^Fmf, Hh^Fmf, Hh^Fmf, Hh^Ve, Gll^Fmf, Gg^Fet, Gll, Gll^Fmf, Gg, Gll^Fmf, Gll, Gll, Gd^Fetd, Gll, Gd, Gd^Fetd, Rb, Rb, Rb, Gd, Gd^Fetd, Gll^Fmf, Gll^Fmf, Gll^Fmf, Gll, Gll^Fmf, Gll, Gll, Hh^Fmf, Gll^Fmf, Hh^Fmf, Gll, Gll^Fmf, Gll^Fmf, Gll^Fmf, Gg^Fet, Gll, Gll^Fmf, Gll^Fmf, Hh^Fmf, Hh^Fmf, Hh^Fmf, Mm, Mm
Mm, Mm, Mm, Mm, Hh^Fmf, Hh^Fmf, Gll, Hh^Fmf, Gll, Gll, Gll^Fmf, Gll, Gll^Fmf, Gll^Fmf, Gll^Fmf, Gll^Fmf, Gll^Fmf, Gll^Fmf, Gll, Gll, Gd, Rb, Rd^Cov, Rd^Cov, Rd^Cov, Rb, Gd^Fetd, Gd^Fetd, Gll, Gll, Gg, Gll, Gs, Gg, Hh^Fmf, Hh, Hh^Fmf, Hh^Fmf, Hh^Fmf, Gll, Gll, Gll^Fmf, Gll^Fmf, Gll^Fmf, Gll, Hh^Fmf, Hh^Fmf, Mm, Mm, Mm
Mm, Mm, Mm, Mm, Hh^Fmf, Hh^Fmf, Gll^Fmf, Gll, Gll^Fmf, Gll^Fmf, Gll^Fmf, Gll^Fmf, Gll^Fmf, Gll^Fmf, Gll^Fmf, Gll^Fmf, Gll, Gll, Gd^Fetd, Gs, Gd, Rb, Rd^Cov, 3 Rd^Kov, Rd^Cov, Rb, Gd, Gll, Gd^Fetd, Gs, Gs, Gs, Gll, Hh^Fmf, Wwt, Hh, Wwt, Hh^Fmf, Hh^Fmf, Hh, Hh, Gll^Fmf, Gll^Fmf, Gll^Efm, Gll^Efm, Hh^Fmf, Hh^Fmf, Mm, Mm, Mm
Mm, Mm, Hh^Fmf, Hh^Fmf, Hh^Fmf, Gll^Fmf, Gll^Fmf, Gll^Fmf, Gll, Gll^Fmf, Gll, Gll, Gll^Fmf, Gll, Gll, Gll, Gg, Gs, Gd^Fetd, Gd^Fetd, Gd, Rb, Rb, Rd^Cov, Rb, Rb, Gd, Gg, Gd^Fetd, Gs, Gs, Gll^Fmf, Gll^Fmf, Gll, Wwt, Ww^Ewf, Ww^Ewf, Wwt, Wwt, Hh^Fmf, Hh, Gll, Gll^Fmf, Gll, Gll^Efm, Gll, Hh^Fmf, Hh^Fmf, Hh^Fmf, Mm
Mm, Hh^Fmf, Hh^Fmf, Hh^Fmf, Gll, Gll^Fmf, Gll, Gll, Gll^Fmf, Gll^Fmf, Gll, Gll, Gll^Fmf, Gll, Gg, Gs, Gg^Ve, Gs, Gg, Gd^Fetd, Gs, Gd, Gd, Rb, Gd, Gd, Gs, Gd^Fetd, Gg, Gg^Ve, Gs, Gs, Wwt, Wwt, Ww^Ewf, Ww^Ewf, Wwt, Ww^Ewf, Wwt, Wwt, Hh^Fmf, Hh^Fmf, Gll, Gll^Fmf, Gll^Fmf, Gll^Fmf, Gll^Fmf, Hh^Fmf, Hh^Fmf, Hh^Fmf
Hh^Fmf, Hh^Fmf, Gll^Fmf, Gll, Gll^Fmf, Gll, Gg^Ve, Gll, Gll^Fmf, Gll^Fmf, Gll, Gll, Gll^Fmf, Gll, Gll^Fmf, Gs, Gg, Gg, Gll, Gll, Gll, Gll, Gd^Fetd, Gd^Fetd, Gd^Fetd, Gll, Gll, Gs, Gll^Fmf, Gll^Fmf, Wwt, Wwt, Ww^Ewf, Ww^Ewf, Wwt, Wwt, Wwt, Ww^Ewf, Wwt, Wwt, Wwt, Gll, Gll^Fmf, Gll, Gg^Fet, Gll^Fmf, Gll^Fmf, Gll, Gll, Gll
Hh^Fmf, Gll^Fmf, Gll^Fmf, Gll^Fmf, Gll, Gll^Fmf, Gll^Fmf, Gll^Fmf, Gll^Fmf, Gll^Fmf, Gll^Fmf, Gll^Fmf, Gll, Gll, Gll^Fmf, Gll^Fmf, Gll^Fmf, Gs, Gll, Gll^Fmf, Gll^Fmf, Gd^Fetd, Gll, Gd^Fetd, Gll^Fmf, Gd^Fetd, Gll, Gll^Fmf, Gll^Fmf, Wwt, Wwt, Ww^Ewf, Ww^Ewf, Wwt, Gg^Fet, Ww^Ewf, Ww^Ewf, Ww^Ewf, Wwt, Wwt, Gll^Fmf, Gll^Fmf, Gll, Gll^Fmf, Gg^Ve, Gll^Fmf, Gll^Fmf, Gll^Fmf, Gll^Fmf, Gll
Gg^Fet, Gg^Fet, Gll, Gll, Gs^Efm, Gll, Gll, Gll, Gll, Gll^Fmf, Gll, Gll, Gll^Fmf, Gll^Fmf, Gll, Gll, Gll, Gll, Gll^Fmf, Gll^Fmf, Gll, Hh^Fmf, Hh, Gll^Fmf, Gll^Fmf, Gll^Fmf, Gll, Gs, Gll^Fmf, Wwt, Ww^Ewf, Ww^Ewf, Wwt, Gg^Fet, Wwt, Wwt, Ww^Ewf, Wwt, Wwt, Gll, Gll^Fmf, Gll, Gll, Gll, Gll, Gll, Gll^Fmf, Gll^Fmf, Hh^Fmf, Gll
Gll^Fmf, Gll^Fmf, Gll^Fmf, Gll, Gll^Efm, Gs^Efm, Gll^Fmf, Gll^Fmf, Gg, Gll^Efm, Gs, Gs, Gll, Gll, Gll^Fmf, Gll^Fmf, Gll^Fmf, Gll^Fmf, Gll^Fmf, Gll, Hh^Ve, Hh^Fmf, Hh^Fmf, Hh, Gll^Fmf, Gll, Gll, Gs, Gll^Fmf, Wwt, Wwt, Ww^Ewf, Wwt, Gg^Fet, Gg^Fet, Wwt, Ww^Ewf, Ww^Ewf, Wwt, Gll, Gll^Fmf, Gll^Fmf, Gll^Fmf, Gg^Fet, Gll^Fmf, Gll^Fmf, Gll, Hh^Fmf, Hh^Fmf, Hh^Fmf
Gll, Gll, Gll, Gll^Fmf, Gll, Gs, Gs, Gll^Fmf, Gs, Gs^Efm, Gll^Fmf, Gll^Fmf, Gll^Fmf, Gll, Gll^Fmf, Gll, Hh^Fmf, Gll^Fmf, Hh^Fmf, Hh, Hh, Hh^Fmf, Hh, Hh^Fmf, Gll^Fmf, Gll^Fmf, Gll, Gs, Gs, Gg^Ve, Ww^Ewf, Wwt, Wwt, Wwt, Gg^Fet, Gg^Fet, Wwt, Ww^Ewf, Wwt, Wwt, Gll^Fmf, Gll^Fmf, Gll^Fmf, Gg^Fet, Gll, Gll^Fmf, Hh^Fmf, Hh^Fmf, Hh^Fmf, Hh^Fmf
Gg, Gll^Fmf, Gll, Gll^Fmf, Gll^Fmf, Gll, Gll^Fmf, Gs^Efm, Gll^Fmf, Gll, Gg^Fet, Gll^Fmf, Gll, Gll^Fmf, Hh, Hh, Hh^Fmf, Hh^Fmf, Hh^Fmf, Hh, Hh^Fmf, Hh^Fmf, Hh, Gll, Gll^Fmf, Gll, Gs, Gs, Wwt, Ww^Ewf, Ww^Ewf, Ww^Ewf, Wwt, Gg^Fet, Gg^Fet, Gg^Fet, Wwt, Ww^Ewf, Ww^Ewf, Wwt, Wwt, Gll, Gll^Fmf, Gll^Fmf, Gll, Gll, Hh^Fmf, Hh^Fmf, Mm, Mm
Gg, Gll^Fmf, Gll^Fmf, Gll^Fmf, Gll, Gll, Gll^Fmf, Gg^Ve, Gg^Efm, Gll, Gll^Fmf, Gll, Hh^Fmf, Hh, Hh^Fmf, Hh^Fmf, Hh, Hh^Fmf, Hh, Hh^Fmf, Hh^Fmf, Hh^Fmf, Gll, Gll, Gll^Fmf, Gll, Wwt, Gg, Wwt, Ww^Ewf, Wwt, Ww^Ewf, Ww^Ewf, Wwt, Wwt, Wwt, Ww^Ewf, Ww^Ewf, Wwt, Ww^Ewf, Wwt, Gll^Fmf, Gll, Gll^Fmf, Hh^Fmf, Hh^Fmf, Hh^Fmf, Hh^Fmf, Mm, Mm
Gg, Gll^Fmf, Gll^Fmf, Gll^Fmf, Gg, Gs, Gs^Efm, Gs, Gll^Fmf, Gll^Efm, Gll, Gll^Fmf, Gll, Hh^Fmf, Hh^Fmf, Hh, Hh, Hh, Hh^Fmf, Hh^Fmf, Gll^Fmf, Gll, Gll^Fmf, Gll^Fmf, Wwt, Wwt, Wwt, Wwt, Wwt, Wwt, Gll, Gll^Fmf, Gll, Ww^Ewf, Ww^Ewf, Wwt, Ww^Ewf, Wwt, Ww^Ewf, Ww^Ewf, Wwt, Gll^Fmf, Gll^Fmf, Hh^Fmf, Hh^Fmf, Hh^Fmf, Mm, Mm, Mm, Mm
Gll^Fmf, Gll^Fmf, Gll, Gll, Gs, Gs^Efm, Gg^Efm, Gll^Fmf, Gs^Efm, Gll, Gll^Fmf, Gll^Fmf, Gll, Hh, Gll, Hh^Fmf, Gll, Gll, Gll^Fmf, Gll^Fmf, Gll, Gll^Fmf, Gll, Gll, Ww^Ewl, Ww^Ewl, Gll^Fmf, Wwt, Gll^Fmf, Gll^Fmf, Gll^Fmf, Gll, Gll^Fmf, Wwt, Ww^Ewf, Wwt, Ww^Ewf, Ww^Ewf, Ww^Ewf, Wwt, Wwt, Gll^Fmf, Hh^Fmf, Hh^Fmf, Mm, Mm, Mm, Mm, Mm, Mm
Hh^Fmf, Gll^Fmf, Gll^Fmf, Gll, Gll^Fmf, Gll, Gg, Gg^Efm, Gs, Gll, Gll, Gll^Fmf, Gll^Fmf, Gll, Gll, Gll^Fmf, Gll^Fmf, Gll^Fmf, Gll, Gll^Fmf, Gll, Gll, Wwt, Wwt, Wwt, Wwt, Gll, Gll^Fmf, Gll^Fmf, Gg^Ve, Gll, Gll, Gll^Fmf, Wwt, Wwt, Ww^Ewf, Wwt, Wwt, Ww^Ewf, Ww^Ewf, Wwt, Gll^Fmf, Hh^Fmf, Hh^Fmf, Mm, Mm, Mm, Mm, Mm, Mm
Hh^Fmf, Gll^Fmf, Hh^Fmf, Gll^Fmf, Gll, Gll, Gll^Fmf, Gll^Fmf, Gll^Fmf, Gs, Gll, Gll^Fmf, Gll, Gll^Fmf, Gll^Fmf, Gll^Fmf, Gg^Fet, Gll, Gll^Efm, Gs^Efm, Gg, Wwt^Bh\, Wwt^Bh\, Wwt, Gs^Efm, Gs, Gll, Gll^Fmf, Gll, Gll^Fmf, Gll, Gll, Gll^Fmf, Gll^Fmf, Gll, Wwt, Ww^Ewf, Ww^Ewf, Ww^Ewf, Wwt, Gll, Gll^Fmf, Hh^Fmf, Hh^Fmf, Mm, Mm, Mm, Mm, Mm, Mm
Mm, Hh^Fmf, Mm, Hh^Fmf, Hh^Fmf, Gll, Gll, Gll^Fmf, Gll^Fmf, Gg, Gs, Gll, Gll, Gll, Gll, Gll^Fmf, Gll, Gll, Gs^Efm, Gs, Wwt, Wwt, Ww^Ewl, Gll, Gll, Gg^Efm, Gll, Gll, Gll^Fmf, Gll, Gll^Fmf, Gll, Gll^Fmf, Gll^Fmf, Gll^Fmf, Wwt, Gg^Ve, Wwt, Gs, Gs, Gll^Fmf, Gll^Fmf, Hh^Fmf, Hh^Fmf, Hh^Fmf, Mm, Mm, Mm, Mm, Mm
Mm, Mm, Mm, Mm, Mm, Hh^Fmf, Gll, Gll^Fmf, Gll, Gll, Gll^Efm, Gll^Fmf, Gll^Fmf, Gg, Gs^Efm, Gll, Wwt, Gg, Ww^Ewl, Wwt, Wwt, Ww^Ewl, Gll, Gll^Fmf, Gll^Fmf, Gll^Efm, Gg^Efm, Gll^Fmf, Gll^Fmf, Gll, Gll, Gll^Fmf, Gll, Gg^Fet, Gll, Gll, Gg^Efm, Gg^Efm, Gll^Efm, Gll, Gll^Fmf, Gll^Fmf, Gll^Fmf, Hh^Fmf, Hh^Fmf, Hh^Fmf, Mm, Mm, Mm, Mm
Mm, Mm, Mm, Mm, Mm, Hh^Fmf, Hh^Ve, Gll^Fmf, Gll^Fmf, Gll^Efm, Gll, Gll^Fmf, Gs^Efm, Gg, Gll^Fmf, Wwt, Ww^Ewl, Ww^Ewl, Wwt, Wwt, Gll^Fmf, Gll, Hh, Gll^Fmf, Gll^Fmf, Gll, Gll^Efm, Gg, Gll, Gg, Cv, Gll, Gg, Gll^Efm, Gs, Gg^Efm, Gll, Gll, Gll^Fmf, Gll^Fmf, Gll, Gll^Fmf, Gll^Fmf, Hh^Fmf, Hh^Fmf, Hh^Fmf, Mm, Mm, Mm, Mm
Mm, Mm, Mm, Mm, Mm, Hh^Fmf, Gll, Gll, Gll^Fmf, Gll^Fmf, Gll^Fmf, Gg, Gs, Gg, Wwf, Wwt, Wwt, Wwt, Gll^Fmf, Gll^Fmf, Hh^Fmf, Hh, Hh^Fmf, Hh^Fmf, Gll^Fmf, Gll^Fmf, Gll^Efm, Gg^Efm, Gs, Cv, Gs^Efm, 2 Kv, Cv, Cv, Cv, Gs, Gll, Gll^Fmf, Gg^Fet, Gll, Gll, Gll^Fmf, Hh^Fmf, Hh^Fmf, Mm, Mm, Mm, Mm, Mm, Mm
Mm, Mm, Hh^Fmf, Hh^Fmf, Hh^Fmf, Hh^Fmf, Gll^Fmf, Gll^Fmf, Gg^Fet, Gll, Gll^Fmf, Gll, Gll^Fmf, Gll, Wwt, Wwf, Gs, Gll, Gll^Fmf, Hh^Fmf, Hh^Fmf, Hh^Fmf, Hh^Fmf, Hh, Gll^Fmf, Gll^Fmf, Gll, Gg, Gs^Efm, Cv, Gg^Efm, Gg, Gs, Gg, Cv, Gg, Gll, Gll^Fmf, Gll^Fmf, Gll^Fmf, Hh^Fmf, Hh^Fmf, Hh^Fmf, Mm, Mm, Mm, Mm, Mm, Mm, Mm
Hh^Fmf, Hh^Fmf, Hh^Fmf, Hh^Fmf, Hh^Fmf, Hh^Fmf, Gll^Fmf, Gll, Gll^Fmf, Gll^Fmf, Hh^Fmf, Gll^Fmf, Gll^Fmf, Gll^Fmf, Wwt, Wwt, Gll, Gll, Gll^Fmf, Gll^Fmf, Hh, Hh^Fmf, Hh, Hh^Fmf, Hh, Gll^Fmf, Gll^Fmf, Gll, Gg^Efm, Gs, Gs, Gs^Efm, Kv, Cv, Gg^Efm, Gll, Gll^Fmf, Gll, Gll^Fmf, Hh^Fmf, Hh^Fmf, Hh^Fmf, Mm, Mm, Mm, Mm, Mm, Mm, Mm, Mm
Hh^Fmf, Hh^Fmf, Gll^Fmf, Gll, Gll^Fmf, Gll^Fmf, Gll^Fmf, Gll^Fmf, Gll^Fmf, Hh, Hh^Fmf, Hh^Fmf, Hh^Ve, Gll^Fmf, Wwt, Wwt, Gll, Gll^Fmf, Gll^Fmf, Gll^Fmf, Hh^Fmf, Hh^Fmf, Hh, Hh^Fmf, Hh, Gg^Fet, Gll, Gll, Gg^Ve, Gs^Efm, Gg, Gg^Efm, Gs, Gs^Efm, Gll, Gll, Gll^Fmf, Gll^Fmf, Gll^Fmf, Hh^Fmf, Hh^Fmf, Hh^Fmf, Hh^Fmf, Mm, Mm, Mm, Mm, Mm, Mm, Mm
Hh^Fmf, Gll^Fmf, Gll, Gll^Fmf, Gll, Gll^Fmf, Gg, Gll^Fmf, Gll, Hh^Fmf, Hh^Fmf, Hh^Fmf, Hh^Fmf, Gll, Wwt, Wwt, Gll, Gll^Fmf, Gg^Fet, Gll, Hh^Fmf, Hh, Hh^Fmf, Hh^Fmf, Gll, Gll^Fmf, Gll^Fmf, Gll, Gs, Gs^Efm, Gs^Efm, Gs^Efm, Gg^Ve, Gg^Efm, Gll, Gll^Fmf, Gg^Fet, Gll, Gll^Fmf, Hh^Fmf, Hh^Fmf, Hh^Fmf, Mm, Mm, Mm, Mm, Mm, Mm, Mm, Mm
Gg, Gll^Fmf, Gll^Fmf, Gg^Fet, Gll^Fmf, Gll^Fmf, Gll^Fmf, Gll^Fmf, Hh, Hh, Hh^Fmf, Hh^Fmf, Hh^Fmf, Wwt, Ww^Ewl, Wwt, Gll, Gll^Fmf, Gll^Fmf, Hh, Hh^Ve, Hh^Fmf, Hh, Hh, Gll, Gll^Fmf, Gll, Gll, Gs^Efm, Gs^Efm, Gg^Efm, Gs, Gll^Efm, Gll^Efm, Gll^Fmf, Gll^Fmf, Gll^Fmf, Gll^Fmf, Hh^Fmf, Hh^Fmf, Hh^Fmf, Hh^Fmf, Mm, Mm, Mm, Mm, Mm, Mm, Mm, Mm
Gll^Fmf, Gll^Fmf, Gll^Fmf, Gll^Fmf, Wwt, Gll, Wwt, Gll^Fmf, Wwt, Hh^Fmf, Hh^Fmf, Hh, Wwt, Wwf, Wwf, Wwt, Gg, Gll, Gll^Fmf, Gll, Gll, Gll^Fmf, Gll^Fmf, Gll, Gll^Fmf, Gll^Fmf, Gll, Gs^Efm, Gs, Gg, Gll, Gll, Gll^Fmf, Gll^Fmf, Gll^Fmf, Gll^Fmf, Hh^Fmf, Hh^Fmf, Hh^Fmf, Hh^Fmf, Hh^Fmf, Hh^Fmf, Mm, Mm, Mm, Mm, Mm, Mm, Mm, Mm
Gg, Gll^Fmf, Wwt, Wwt, Ww^Ewl, Wwt, Ww^Ewl, Ww^Ewl, Ww^Ewl, Wwt, Wwf, Wwt, Wwt, Ww^Ewl, 1 Ket, Ce, Ce, Gll, Gll^Efm, Gll^Fmf, Gll^Fmf, Gll^Fmf, Gll^Fmf, Gll^Fmf, Gll, Gll, Gs, Gs, Gg, Gll, Gll^Fmf, Gll^Fmf, Gll^Fmf, Gll^Fmf, Gg, Gg, Hh^Fmf, Hh^Fmf, Hh^Fmf, Hh^Fmf, Mm, Mm, Mm, Mm, Mm, Mm, Mm, Mm, Mm, Mm
Gll^Fmf, Gll^Fmf, Ww^Ewl, Wwt, Wwt, Wwt, Gs, Wwt, Gll, Wwt, Gs, Wwt, Gll, Ce, Ce, Ce, Gg, Gs^Efm, Gs, Gg^Efm, Gg^Efm, Gll, Gs, Gll, Gg, Gs, Gs^Efm, Gs^Efm, Gll, Gll, Gll^Fmf, Gg^Fet, Gll, Gll^Fmf, Hh^Fmf, Hh^Fmf, Hh^Fmf, Mm, Mm, Mm, Mm, Mm, Mm, Mm, Mm, Mm, Mm, Mm, Mm, Mm
Wwt, Wwt, Wwt, Ww^Ewl, Gs, Gs, Gg, Gg, Gll^Fmf, Gll, Gll^Fmf, Gll, Gll^Fmf, Gll, Gll^Efm, Ce, Gll, Gll, Gll, Gll, Gll, Gs^Efm, Gll^Efm, Gg, Gll^Efm, Gg^Efm, Gll, Gll, Gll^Fmf, Gll^Fmf, Hh^Fmf, Hh^Fmf, Hh^Fmf, Hh^Fmf, Hh^Fmf, Hh^Fmf, Hh^Fmf, Mm, Mm, Mm, Mm, Mm, Mm, Mm, Mm, Mm, Mm, Mm, Mm, Mm
Wwt, Wwt, Ww^Ewl, Ww^Ewl, Gll, Gll, Gll, Gg^Fet, Gll, Gll, Gg^Ve, Gll^Fmf, Gll, Gll^Fmf, Gll^Fmf, Gll, Gll, Gll^Fmf, Gll^Fmf, Gll^Fmf, Gll^Fmf, Gll, Gll^Fmf, Gll, Gll^Fmf, Gll, Gll, Gll^Fmf, Hh^Fmf, Hh^Fmf, Hh^Fmf, Hh^Fmf, Mm, Hh^Fmf, Hh^Fmf, Hh^Fmf, Mm, Mm, Mm, Mm, Mm, Mm, Mm, Mm, Mm, Mm, Mm, Mm, Mm, Mm
Wwt, Wwt, Gs, Gg, Gll^Fmf, Gll, Gll, Gll^Fmf, Gll^Fmf, Gll, Gll^Fmf, Gll^Fmf, Gll^Fmf, Gll^Fmf, Gll^Fmf, Gll^Fmf, Gll^Fmf, Gll, Gll^Fmf, Gll, Gll, Gll^Fmf, Gll^Fmf, Gll^Fmf, Gll^Fmf, Gll^Fmf, Hh^Fmf, Gg^Ve, Hh^Fmf, Hh^Fmf, Mm, Mm, Mm, Mm, Mm, Mm, Mm, Mm, Mm, Mm, Mm, Mm, Mm, Mm, Mm, Mm, Mm, Mm, Mm, Mm
Gg, Gs, Gll, Gg^Fet, Gll^Fmf, Gll, Gll^Fmf, Gll^Fmf, Gll^Fmf, Gll^Fmf, Gll^Fmf, Gll^Fmf, Gll, Gll^Fmf, Hh^Fmf, Gll, Gg^Ve, Gll^Fmf, Hh^Fmf, Gg^Fet, Hh^Fmf, Gll, Hh^Fmf, Gll^Fmf, Hh^Fmf, Hh^Fmf, Hh^Fmf, Hh^Fmf, Hh^Fmf, Mm, Mm, Mm, Mm, Mm, Mm, Mm, Mm, Mm, Mm, Mm, Mm, Mm, Mm, Mm, Mm, Mm, Mm, Mm, Mm, Mm
Gg, Gll, Gll, Gll, Gll^Fmf, Gll^Fmf, Gll^Fmf, Gll, Gll^Fmf, Gll^Fmf, Gll, Gll^Fmf, Hh^Fmf, Hh^Fmf, Hh^Fmf, Hh^Fmf, Hh^Fmf, Hh^Fmf, Hh^Fmf, Hh^Fmf, Hh^Fmf, Hh^Fmf, Hh^Fmf, Hh^Fmf, Hh^Fmf, Hh^Fmf, Hh^Fmf, Hh^Fmf, Mm, Mm, Mm, Mm, Mm, Mm, Mm, Mm, Mm, Mm, Mm, Mm, Mm, Mm, Mm, Mm, Mm, Mm, Mm, Mm, Mm, Mm
Gll^Fmf, Gll^Fmf, Gll, Gll^Fmf, Gll, Gll^Fmf, Gll^Fmf, Gg^Fet, Hh^Fmf, Gll, Hh^Fmf, Hh^Fmf, Mm, Hh^Fmf, Mm, Hh^Fmf, Mm, Hh^Fmf, Mm, Mm, Mm, Mm, Mm, Mm, Mm, Mm, Mm, Mm, Mm, Mm, Mm, Mm, Mm, Mm, Mm, Mm, Mm, Mm, Mm, Mm, Mm, Mm, Mm, Mm, Mm, Mm, Mm, Mm, Mm, Mm
Gg, Gll^Fmf, Gll^Fmf, Gll, Gll, Gll^Fmf, Gll^Fmf, Hh^Fmf, Hh^Fmf, Hh^Fmf, Mm, Mm, Mm, Mm, Mm, Mm, Mm, Mm, Mm, Mm, Mm, Mm, Mm, Mm, Mm, Mm, Mm, Mm, Mm, Mm, Mm, Mm, Mm, Mm, Mm, Mm, Mm, Mm, Mm, Mm, Mm, Mm, Mm, Mm, Mm, Mm, Mm, Mm, Mm, Mm
Gll^Fmf, Gll^Fmf, Gll^Fmf, Gll^Fmf, Gll^Fmf, Gll^Fmf, Hh^Fmf, Hh^Fmf, Hh^Fmf, Hh^Fmf, Mm, Mm, Mm, Mm, Mm, Mm, Mm, Mm, Mm, Mm, Mm, Mm, Mm, Mm, Mm, Mm, Mm, Mm, Mm, Mm, Mm, Mm, Mm, Mm, Mm, Mm, Mm, Mm, Mm, Mm, Mm, Mm, Mm, Mm, Mm, Mm, Mm, Mm, Mm, Mm
Gll^Fmf, Gll^Fmf, Hh^Fmf, Hh^Fmf, Hh^Fmf, Hh^Fmf, Hh^Fmf, Hh^Fmf, Mm, Mm, Mm, Mm, Mm, Mm, Mm, Mm, Mm, Mm, Mm, Mm, Mm, Mm, Mm, Mm, Mm, Mm, Mm, Mm, Mm, Mm, Mm, Mm, Mm, Mm, Mm, Mm, Mm, Mm, Mm, Mm, Mm, Mm, Mm, Mm, Mm, Mm, Mm, Mm, Mm, Mm
Gg, Gg, Hh^Fmf, Hh^Fmf, Gg, Hh^Fmf, Mm, Mm, Mm, Mm, Mm, Mm, Mm, Mm, Mm, Mm, Mm, Mm, Mm, Mm, Mm, Mm, Mm, Mm, Mm, Mm, Mm, Mm, Mm, Mm, Mm, Mm, Mm, Mm, Mm, Mm, Mm, Mm, Mm, Mm, Mm, Mm, Mm, Mm, Mm, Mm, Mm, Mm, Mm, Mm
