Mm, Mm, Mm, Mm^Xm, Mm^Xm, Mm^Xm, Mm^Xm, Mm^Xm, Mm^Xm, Mm, Mm, Mm, Mm, Mm, Mm, Mm^Xm, Mm^Xm, Mm^Xm, Mm^Xm, Mm, Mm, Mm, Mm^Xm, Mm, Mm^Xm, Mm, Mm^Xm, Mm, Mm^Xm, Mm, Mm^Xm, Mm, Mm^Xm, Mm, Mm, Mm, Mm, Mm, Mm, Mm, Mm, Mm
Mm, Mm, Mm^Xm, Mm, Mm, Mm, Mm, Mm, Mm, Mm, Mm, Mm, Mm, Mm, Mm, Mm, Mm, Mm^Xm, Mm^Xm, Mm^Xm, Mm, Mm^Xm, Mm, Mm^Xm, Mm, Mm^Xm, Mm, Mm^Xm, Mm, Mm^Xm, Mm, Mm^Xm, Mm^Xm, Mm^Xm, Mm^Xm, Mm^Xm, Mm^Xm, Mm, Mm, Mm, Mm, Mm
Mm, Mm, Mm^Xm, Mm, Mm, Mm, Mm, Mm, Mm, Mm, Mm, Mm, Mm, Mm, Mm, Mm, Mm, Mm, Mm, Mm, Mm, Mm, Mm, Mm, Mm, Mm, Mm, Mm, Mm^Xm, Mm^Xm, Mm^Xm, Mm, Mm, Mm, Mm, Mm, Mm^Xm, Mm, Mm, Mm, Mm, Mm
Mm^Xm, Mm^Xm, Mm, Mm, Mm, Mm, Mm, Mm, Mm, Mm, Mm, Mm, Mm, Mm, Mm, Mm, Mm, Mm, Mm, Mm, Mm, Mm, Mm, Mm, Mm, Mm, Mm, Mm^Xm, Mm, Mm, Mm, Mm^Xm, Mm^Xm, Mm^Xm, Mm, Mm, Mm, Mm^Xm, Mm, Mm, Mm, Mm
Mm^Xm, Mm^Xm, Mm, Mm, Mm, Mm, Mm, Mm, Mm, Mm, Mm, Mm, Mm, Mm, Mm, Mm, Mm, Mm, Mm, Mm, Mm, Mm, Mm, Mm, Mm, Mm, Mm, Mm, Mm, Mm, Mm, Mm, Mm, Mm^Xm, Ww, Ww, Mm^Xm, Mm^Xm, Mm^Xm, Mm, Mm, Mm
Mm, Mm, Mm, Mm, Mm, Mm, Mm, Mm, Mm, Mm, Mm, Mm, Hhd^Fetd, Hhd^Fetd, Hhd^Fetd, Hhd, Hhd^Fetd, Mm, Hhd, Mm, Hhd^Fetd, Mm, Hh^Fms, Mm, Hh^Fms, Mm, Mm, Mm, Mm, Mm, Mm, Mm, Ww, Ww, Mm, Mm, Mm, Mm^Xm, Mm^Xm, Mm, Mm, Mm
Mm^Xm, Mm, Mm, Mm, Mm, Mm, Mm, Mm, Mm, Mm, Mm, Mm, Hhd, Hhd^Fetd, Gd^Fetd, Hhd, Hhd, Hhd^Fetd, Hhd^Fetd, Hhd^Fetd, Hhd, Hhd^Fetd, Hhd^Fetd, Hh^Fms, Hh^Ve, Hh^Fms, Hh^Fms, Mm, Hh^Fms, Hh^Fms, Hh^Fms, Mm, Ww, Mm, Mm, Mm, Mm, Mm, Mm^Xm, Mm, Mm, Mm
Mm^Xm, Mm, Mm, Mm, Mm, Mm, Mm, Mm, Hh^Fms, Mm, Mm, Mm, Hhd, Gll, Rd, Gd^Fetd, Gd^Xfk, Gd^Fetd, Gd^Fetd, Gll, Gd^Fetd, Gll, Gd^Fetd, Gs^Fms, Gs^Fms, Gs^Fms, Gs^Fms, Hh^Fms, Hh, Hh^Fms, Ww, Ww, Hh^Fms, Hh^Fms, Mm, Mm, Mm, Mm, Mm^Xm, Mm^Xm, Mm, Mm
Mm, Mm, Mm, Mm, Hh^Fms, Hh^Fms, Hh^Fms, Hh^Fms, Gll, Hh, Hhd, Hhd, Gd^Xfk, Gd^Fetd, Rd, Rd, Rd, Gd^Xfk, Rd, Gd^Xfk, Gd^Xfk, Gd^Fetd, Gs, Gs, Gg, Gs, Wwg, Gs^Fms, Wwg, Ww, Gs^Fms, Hh^Fms, Mm, Mm, Mm, Mm, Mm, Mm, Mm^Xm, Mm, Mm, Mm
Mm, Mm, Mm, Mm, Hh^Fms, Hh^Fms, Gs^Fms, Gs^Fms, Gll, Gd^Fetd, Gd^Fetd, Gd^Xfk, Rd, Rd, Skl^Cov, Skl^Cov, Skl^Cov, Skl, Rd, Rd, Gd^Xfk, Gg, Wwg, Wwg, Wwg, Wwg, Gg, Wwg, Gs^Fms, Gs^Fms, Hh^Fms, Hh, Mm, Mm, Mm, Mm, Mm, Mm^Xm, Mm^Xm, Mm, Mm, Mm
Mm, Mm, Hh^Fms, Hh^Fms, Hh^Ve, Gs^Fms, Gll, Gs^Fms, Gg, Gs, Rd, Gd^Xfk, Rd, Skl, Skl^Cov, 2 Skl^Kov, Skl^Cov, Rd, Rd, Rd, Wwf, Wwf, Gg, Gg, Gg, Gg, Gg, Gs, Gs^Fms, Gll, Hh, Mm, Mm, Mm, Mm, Mm, Mm, Mm^Xm, Mm, Mm, Mm, Mm
Hh^Fms, Hh^Fms, Hh, Hh^Fms, Ww, Gll, Wwg, Gs, Wwg, Gg, Wwf, Rd, Wwg, Rd, Rd, Skl^Cov, Gd^Xfk, Rd, Wwg, Wwg, Gg, Gg, Gs, Gg, Gg, Gs, Gg, Gg, Gll, Gs^Fms, Hh^Fms, Hh^Fms, Mm, Mm, Mm, Mm, Mm^Xm, Mm^Xm, Mm, Mm, Mm, Mm
Ww, Ww, Ww, Ww, Gs^Fms, Ww, Gll, Wwg, Gg, Wwg, Gg, Wwg, Wwg, Rd, Rd, Gd^Xfk, Rd, Rd, Wwg, Gg, Gs, Gs, Gg, Gg, Gg, Gg, Gs, Gs, Gs^Fms, Hh, Hh^Fms, Hh^Fms, Mm, Mm, Mm, Mm, Mm^Xm, Mm, Mm, Mm, Mm, Mm
Hh, Hh^Fms, Hh^Fms, Hh^Fms, Gs^Fms, Gll, Gs^Fms, Gs, Gs, Gg, Gs, Gg, Wwg, Gg, Gg, Rd, Gg, Gg, Wwg, Ss, Ss, Gg, Gg, Gg, Gg, Gs, Gs^Fms, Gs^Fms, Hh^Ve, Hh^Fms, Mm, Mm, Mm, Mm, Mm, Mm, Mm^Xm, Mm, Mm, Mm, Mm, Mm
Mm, Hh, Hh^Fms, Hh, Hh, Hh, Hh^Fms, Gs^Fms, Gs^Fms, Gg, Gg, Gs, Wwg, Gg, Gg^Ve, Gg, Ss, Ss, Wwg, Wwg, Wwf, Wwg, Ww, Gg, Gg, Gs, Gs^Fms, Gll, Hh^Fms, Hh^Fms, Mm, Mm, Mm, Mm, Mm, Mm^Xm, Mm^Xm, Mm, Mm, Mm, Mm, Mm
Mm, Mm, Mm, Mm, Mm, Hh^Fms, Hh, Hh^Fms, Gs^Fms, Gs, Gs, Gs, Gg, Wwf, Wwg, Wwg, Wwg, Wwg, Wwg, Wwg, Gs^Fms, Wwg, Chw, Ch, Gg, Gg, Gs, Gs^Fms, Hh^Fms, Mm^Fms, Mm, Mm, Mm, Mm, Mm, Mm^Xm, Mm^Xm, Mm^Xm, Mm^Xm, Mm, Mm, Mm
Mm, Mm, Mm^Xm, Mm, Mm, Mm, Mm, Hh, Hh^Fms, Gs^Fms, Gs^Fms, Gg, Gg, Gg, Gg, Wwg, Wwg, Wwg, Gll, Gs^Fms, Kvr, Wwg, Chw, Wwf, Ww, Gg, Gs, Gs^Fms, Hh, Hh^Fms, Hh, Mm, Mm, Mm, Mm, Mm, Mm, Mm, Mm^Xm, Mm, Mm, Mm
Mm, Mm, Mm, Mm^Xm, Mm, Mm, Mm, Hh^Fms, Hh, Gs^Fms, Gll, Gg, Gg, Gg, Gs, Wwf, Ch, Ww, Ww, Cvr, Ww, Wwf, Ww, Ww, Ww, Gg, Gs, Gs^Fms, Gll, Gs^Fms, Gs^Fms, Hh^Fms, Hh^Fms, Mm, Mm, Mm, Mm, Mm, Mm, Mm^Xm, Mm^Xm, Mm
Mm, Mm^Xm, Mm^Xm, Mm, Mm, Mm, Mm, Hh, Hh^Fms, Gs^Fms, Gs, Gg, Gg, Gs, Gg, Gg, Gg, Chw, Wwg, Ww, Ww^Ewl, Ww, Wwf, Ww^Ewl, Ww, Ww, Ww, Gs, Gs, Gs^Fms, Gs^Fms, Gll, Hh^Fms, Mm, Mm, Mm, Mm, Mm, Mm, Mm, Mm^Xm, Mm
Mm, Mm, Mm, Mm^Xm, Mm, Mm, Hh^Fms, Hh^Fms, Gs^Fms, Gs^Fms, Gs, Gg, Gs, Gg, Gg, Gs, Gg, Chw, Ww, Wwg, Ww, Ww, Wwg, Gs^Ve, Gs^Fms, Ww, Ww, Gg, Gg, Gs, Gll, Hh^Ve, Hh^Fms, Hh^Fms, Mm, Mm, Mm, Mm, Mm, Mm^Xm, Mm^Xm, Mm
Mm, Mm, Mm, Mm, Mm, Mm, Hh, Hh^Ve, Gll, Gs^Fms, Gs, Gg, Ww, Gg, Gg, Gs, Ww, Wwf, Kvr, Cvr, Ww, Ww, Gs^Fms, Gs^Fms, Cvr, Ww, Ch, Gg, Gg, Gs, Gs^Fms, Gs^Fms, Hh^Fms, Mm, Mm, Mm, Mm, Mm, Mm, Mm^Xm, Mm, Mm
Mm, Mm^Xm, Mm^Xm, Mm, Mm, Mm, Hh^Fms, Gs^Fms, Gs^Fms, Gs^Fms, Ww, Ww, Ww, Ww, Ww, Ss, Ww, Ww, Gs^Fms, Gs^Fms, Ww, Wwf, Ww, Kvr, Ww, Ww, Chw, Gg, Gg, Gs^Efm, Gs, Gll, Hh, Hh^Fms, Mm, Mm, Mm, Mm, Mm, Mm, Mm, Mm
Mm, Mm, Mm, Mm, Mm, Mm, Hh^Fms, Gll, Gs^Fms, Gll, Wwf, Ww, Ww^Ewl, Ww, Ww, Ww, Chw, Ww, Ww, Ww^Ewl, Ww, Ww, Ww^Ewl, Ww, Ww, Chw, Ww, Ww, Ww, Gg, Gs, Gs^Fms, Gs^Fms, Hh^Fms, Hh^Fms, Mm, Mm, Mm, Mm, Mm, Mm, Mm
Mm, Mm, Mm, Mm, Mm, Mm, Hh, Gs^Fms, Ww, Ww, Wwf, Ss, Ww^Ewl, Ww, Ww, Ww, Chw, Ww, Ww, Ww, Ww, Ww, Ww, Ww, Ww, Ww, Ww, Ww, Wwf, Wwf, Ww, Gll, Gs^Fms, Hh^Ve, Hh^Fms, Hh^Fms, Hh^Fms, Mm, Mm, Mm, Mm, Mm
Hh, Mm, Hh^Fms, Mm, Hh^Fms, Hh^Fms, Gs^Fms, Gs^Fms, Ww, Ww, Ww, Gg, Ww, Ww, Ww, Ww, Ww, Chw, Ww, Ww, Ww, Ww^Ewl, Ss, Ss, Gg, Gg, Gs, Gg, Gg, Ww, Ww, Ww, Ww, Ww, Ww, Ww, Ww, Hh^Fms, Hh^Fms, Hh^Fms, Hh^Fms, Mm
Ww, Hh^Fms, Ww, Hh^Fms, Ww, Ww, Ww, Ww, Ww, Ww, Gg, Gg, Gs, Gg, Gg, Ww, Gg, Ww, Gg, Ww, Ww, Ww^Ewl, Ss, Gg, Gg, Gs, Gg, Gs, Gg^Efm, Gg, Gg, Ww, Ww, Ww, Ww, Ww, Ww, Ww, Ww, Hh, Ww, Hh^Fms
Ww, Ww, Ww, Ww, Ww, Ww, Ww, Ww, Gs^Fms, Gs, Gs, Gg, Gg, Gs, Gg, Gs, Gs, Gg, Gg, Gg, Gg, Ww, Gg, Gg, Gg, Gg, Gg, Gg, Gg, Gs, Gs^Fms, Gs, Gll, Gll, Gs^Fms, Gs^Fms, Gs^Fms, Ww, Ww, Ww, Ww, Ww
Hh^Fms, Ww, Hh^Fms, Ww, Hh^Fms, Hh^Ve, Gs^Fms, Gs^Fms, Gs^Fms, Gs^Fms, Gg, Gg, Gg, Gg, Gg, Gg, Gs, Gg, Gs, Gg, Gs, Gg, Gs, Gg, Gs^Efm, Gs, Gg^Efm, Gg, Gg, Gs, Gs^Fms, Gs^Fms, Gs^Fms, Gs^Fms, Gll, Hh, Hh^Fms, Gs^Fms, Hh, Ww, Hh^Fms, Ww
Mm, Hh^Fms, Mm, Hh^Fms, Hh^Fms, Hh^Fms, Hh, Gll, Hh^Fms, Gll, Gs^Fms, Gs, Gs, Gg^Efm, Gg^Efm, Gg, Gg, Gs, Gs, Gs, Re^Vct, Gs, Gg^Efm, Gg^Efm, Gg, Gg, Gs, Gg, Gg, Gs, Gll, Hh^Fms, Hh^Fms, Hh, Hh^Fms, Hh^Fms, Mm, Hh^Fms, Hh^Fms, Hh^Fms, Mm, Hh^Fms
Mm, Mm, Mm, Mm, Hh, Hh^Fms, Hh^Fms, Hh^Fms, Hh^Fms, Hh, Gll, Gs^Fms, Gll, Re^Vct, Gs, Gg, Gs, Gs, Gg, Gg, Gg, Gg, Gs, Gs, Gg, Gs, Gs^Fms, Gg, Gs^Fms, Gs^Fms, Hh^Fms, Hh^Ve, Hh^Fms, Hh^Fms, Mm, Mm, Mm, Mm, Mm, Mm, Mm^Xm, Mm
Mm, Mm^Xm, Mm, Mm, Mm, Mm, Mm, Mm, Mm, Hh^Fms, Hh^Fms, Gll, Gs^Fms, Gs^Fms, Gs, Gg, Ce, Ce, Ce, Gg, Gs, Gg, Gs^Fms, Gs^Fms, Gll, Gs^Fms, Hh, Gll, Hh, Hh^Fms, Hh^Fms, Hh^Fms, Mm, Mm, Mm, Mm, Mm, Mm, Mm, Mm, Mm, Mm
Mm, Mm, Mm, Mm, Mm, Mm, Mm, Mm, Mm, Hh, Hh^Fms, Hh, Hh^Fms, Gs^Fms, Gs^Fms, Gg, Ce, 1 Ke, Ce, Gg, Gs^Efm, Gs^Fms, Hh^Fms, Hh^Fms, Hh^Fms, Hh^Fms, Hh^Fms, Hh^Fms, Hh^Fms, Hh^Fms, Mm, Mm, Mm, Mm, Mm, Mm^Xm, Mm, Mm, Mm^Xm, Mm^Xm, Mm, Mm
Mm, Mm, Mm^Xm, Mm, Mm, Mm, Mm, Mm, Mm, Mm, Mm, Hh^Fms, Hh^Fms, Hh, Hh, Gs, Gg, Ce, Gs, Gg, Gll, Gs^Fms, Hh^Fms, Mm, Mm, Mm, Mm, Mm, Hh^Fms, Mm, Mm, Mm, Mm, Mm^Xm, Mm, Mm, Mm, Mm^Xm, Mm^Xm, Mm^Xm, Mm^Xm, Mm
Mm, Mm, Mm, Mm^Xm, Mm, Mm, Mm^Xm, Mm^Xm, Mm^Xm, Mm, Mm, Mm, Mm, Hh^Fms, Hh^Fms, Gs^Fms, Gs, Gg, Re^Vct, Gg, Gs^Fms, Hh^Fms, Mm, Mm, Mm, Mm, Mm, Mm, Mm, Mm, Mm, Mm^Xm, Mm^Xm, Mm, Mm, Mm^Xm, Mm^Xm, Mm, Mm, Mm, Mm, Mm
Mm, Mm, Mm, Mm, Mm, Mm, Mm^Xm, Mm, Mm, Mm, Mm, Mm, Mm, Hh^Fms, Hh, Gll, Gs, Gs, Gg, Gs, Hh, Hh^Fms, Mm, Mm, Mm, Mm^Xm, Mm^Xm, Mm, Mm, Mm^Xm, Mm^Xm, Mm, Mm, Mm, Mm^Xm, Mm, Mm, Mm^Xm, Mm, Mm, Mm, Mm
Mm, Mm, Mm, Mm, Mm, Mm^Xm, Mm, Mm, Mm, Mm, Mm, Mm, Mm, Hh^Fms, Hh, Gs^Fms, Gs, Gs, Gs, Gs^Fms, Hh, Hh^Fms, Mm, Mm, Mm, Mm, Mm, Mm^Xm, Mm, Mm, Mm, Mm, Mm, Mm^Xm, Mm^Xm, Mm, Mm, Mm, Mm, Mm, Mm, Mm
Mm, Mm, Mm, Mm, Mm, Mm, Mm, Mm, Mm, Mm, Mm, Mm, Mm, Hh^Fms, Hh, Gs^Fms, Gg, Gs, Gg, Gs^Fms, Hh, Hh^Fms, Mm, Mm, Mm, Mm, Mm, Mm, Mm, Mm, Mm, Mm, Mm, Mm, Mm, Mm, Mm, Mm, Mm, Mm, Mm, Mm
