Mm, Mm, Mm, Mm, Mm, Mm, Mm, Mm, Mm, Mm, Mm, Mm, Hh^Fmf, Gg, Hh^Fmf, Hh, Hh^Fmf, Hh, Hh^Fmf, Mm, Mm, Mm, Mm, Mm, Mm, Mm, Mm, Mm, Mm, Mm, Mm, Mm, Mm, Mm, Mm, Mm, Mm, Mm, Mm, Gg, Gg, Gg, Mm, Mm, Mm, Mm, Mm, Mm, Mm, Mm, Mm, Mm, Mm, Mm, Mm, Mm, Mm
Mm, Mm, Mm, Mm, Mm, Mm, Mm, Mm, Mm, Mm, Mm, Mm, Mm, Hh^Fmf, Hh, Hh^Fmf, Hh, Hh^Fmf, Hh^Fmf, Mm, Mm, Mm, Mm, Mm, Mm, Mm, Mm, Mm, Mm, Mm, Mm, Mm, Mm, Mm, Mm, Mm, Mm, Mm, Mm, Mm, Mm, Gg, Ww, Mm, Mm, Mm, Mm, Mm, Mm, Mm, Mm, Mm, Mm, Mm, Mm, Mm, Mm
Mm, Mm, Mm, Mm, Mm, Mm, Mm, Mm, Mm, Mm, Mm, Mm, Mm, Mm, Mm, Mm, Hh^Fmf, Hh, Hh^Fmf, Hh, Hh^Fmf, Mm, Mm, Mm, Mm, Mm, Mm, Mm, Mm, Mm, Mm, Mm, Mm, Mm, Mm, Mm, Mm, Mm, Mm, Mm, Mm, Mm, Ww, Hh^Fmf, Mm, Mm, Mm, Mm, Mm, Mm, Mm, Mm, Mm, Mm, Mm, Mm, Mm
Mm, Mm, Mm, Mm, Mm, Mm, Mm, Mm, Mm, Mm, Mm, Mm, Mm, Mm, Mm, Mm, Hh^Fmf, Hh, Hh^Fmf, Hh, Hh^Fmf, Hh^Fmf, Hh^Fmf, Mm, Mm, Mm, Mm, Mm, Mm, Mm, Mm^Cov, Mm, Mm, Mm, Mm, Mm, Mm, Mm, Mm, Mm, Mm, Mm, Ww, Hh^Fmf, Mm, Mm, Mm, Mm, Mm, Mm, Mm, Mm, Mm, Mm, Mm, Mm, Mm
Mm, Mm, Mm, Mm, Mm, Mm, Mm, Mm, Mm, Mm, Mm, Mm, Mm, Mm, Mm, Mm, Hh^Fmf, Hh^Fmf, Hh^Fmf, Hh^Fmf, Hh^Vc, Hh^Fmf, Hh^Fmf, Mm, Mm, Mm, Mm, Mm, Mm^Cov, Mm, Mm^Cov, Mm, Mm^Cov, Mm, Mm, Mm, Mm, Mm, Mm, Mm, Mm, Ww, Ww, Mm, Mm, Mm, Mm, Mm, Mm, Mm, Mm, Mm, Mm, Mm, Mm, Mm, Mm
Mm, Mm, Mm, Mm, Mm, Mm, Mm, Mm, Mm, Mm, Mm, Mm, Mm, Mm, Mm, Mm, Mm, Hh, Hh, Hh^Fmf, Hh^Fmf, Hh^Fmf, Hh, Mm, Mm, Mm, Mm, Mm, Mm, Mm^Cov, 2 Mm^Kov, Mm^Cov, Mm, Mm, Mm, Mm, Mm, Mm, Mm, Mm, Mm, Ww, Ww, Mm, Mm, Mm, Mm, Mm, Mm, Mm, Mm, Mm, Mm, Mm, Mm, Mm, Mm
Mm, Mm, Mm, Mm, Mm, Mm, Mm, Mm, Mm, Mm, Mm, Mm, Mm, Mm, Mm, Mm, Mm, Mm, Hh, Hh^Fmf, Hh^Fmf, Hh^Fmf, Mm, Mm, Mm, Mm, Mm, Mm, Mm^Cov, Mm^Cov, Mm^Cov, Mm^Cov, Mm^Cov, Mm, Mm, Mm, Mm, Mm, Mm, Mm, Hh^Fmf, Ww, Hh^Fmf, Mm, Mm, Mm, Mm, Mm, Mm, Mm, Mm, Mm, Mm, Mm, Mm, Mm, Mm
Mm, Mm, Mm, Mm, Mm, Mm, Mm, Mm, Mm, Mm, Mm, Mm, Mm, Mm, Mm, Mm, Mm, Mm, Mm, Hh^Fmf, Hh^Fmf, Hh, Mm, Mm, Mm, Mm, Mm, Mm, Mm, Mm, Mm^Cov, Hh^Fmf, Hh^Fmf, Hh^Fmf, Hh^Fmf, Mm, Mm, Mm, Mm, Mm, Hh^Fmf, Ww, Mm, Mm, Mm, Mm, Mm, Mm, Mm, Mm, Mm, Mm, Mm, Mm, Mm, Mm, Mm
Mm, Mm, Mm, Mm, Mm, Mm, Mm, Mm, Mm, Mm, Mm, Mm, Mm, Mm, Mm, Mm, Mm, Mm, Mm, Hh^Fmf, Hh^Fmf, Mm, Mm, Mm, Mm, Mm, Mm, Mm, Mm, Mm, Hh^Fmf, Gll^Fmf, Gll^Fmf, Gll^Fmf, Gll^Fmf, Gll^Fmf, Hh^Fmf, Mm, Mm, Mm, Ww, Ww, Mm, Mm, Mm, Mm, Mm, Mm, Mm, Mm, Mm, Mm, Mm, Mm, Mm, Mm, Mm
Mm, Mm, Mm, Mm, Mm, Mm, Mm, Mm, Mm, Mm, Mm, Mm^Xm, Mm, Mm, Mm^Xm, Mm^Xm, Mm, Mm, Hh^Fmf, Hh^Fmf, Hh^Fmf, Mm, Mm, Mm, Mm, Mm, Mm, Mm, Mm, Mm, Hh^Fmf, Gll^Fmf, Gll^Fmf, Gll^Fmf, Gll^Fmf, Gll^Fmf, Hh^Fmf, Mm, Mm^Xm, Mm, Ww, Ww, Mm, Mm, Mm, Mm, Mm, Mm, Mm, Mm, Mm, Mm, Mm, Mm, Mm, Mm, Mm
Mm, Mm, Mm, Mm, Mm, Mm, Mm, Mm, Mm, Mm, Mm, Mm, Mm^Cov, Mm, Mm^Cov, Mm, Hh^Fmf, Hh^Fmf, Hh^Fmf, Gll^Fmf, Gll^Fmf, Hh^Fmf, Hh^Fmf, Mm, Mm, Mm, Hh^Fmf, Hh^Fmf, Hh^Fmf, Hh^Fmf, Gll^Fmf, Gll^Fmf, Gll, Gll, Gll^Fmf, Gll^Fmf, Hh^Fmf, Mm, Mm, Mm^Xm, Mm^Xm, Ww, Ww, Mm, Mm, Mm, Mm^Xm, Mm, Mm, Mm, Mm, Mm, Mm, Mm, Mm, Mm, Mm
Mm, Mm, Mm, Mm, Mm, Mm, Mm, Mm, Mm, Mm, Mm, Mm^Cov, Mm^Kov, Mm^Cov, Hh^Fmf, Hh^Fmf, Hh^Fmf, Hh^Fmf, Gll, Gll, Gg^Vws, Gll^Fmf, Gll^Fmf, Hh^Fmf, Hh^Fmf, Hh^Fmf, Gll^Fmf, Gll^Fmf, Gll^Fmf, Gll^Fmf, Gll^Fmf, Gll, Gg, Gll, Gll, Gll^Fmf, Hh^Fmf, Mm, Mm, Mm, Mm, Mm, Ww, Ww, Hh^Fmf, Mm, Mm, Mm, Mm, Mm, Mm, Mm, Mm, Mm, Mm, Mm, Mm
Mm, Mm, Mm, Mm, Mm, Mm, Mm, Mm, Mm, Mm, Mm^Cov, Mm^Cov, Mm^Cov, Hh^Cov, Hh^Cov, Hh^Fmf, Gll^Fmf, Gll, Gll^Fmf, Gs, Gs, Gll^Fmf, Gg, Gll, Gg, Gll^Fmf, Gg, Gg, Gg, Gll, Gll, Gll, Gg, Gg, Gll^Fmf, Gll, Gll^Fmf, Hh^Fmf, Hh^Fmf, Mm, Mm, Mm, Ww, Ww, Mm, Mm, Mm, Mm, Mm, Mm, Mm, Mm, Mm, Mm, Mm, Mm, Mm
Mm, Mm, Mm, Mm, Mm, Mm, Mm, Mm, Mm, Mm, Mm, Mm, Hh^Cov, Hh^Fmf, Hh^Fmf, Gll^Fmf, Gll, Gll^Fmf, Gs, Gg, Gs, Gg, Gg, Gg, Gg, Gs, Gs, Gg, Gg, Gs, Gs, Gs, Gg, Gll, Gll^Fmf, Gll, Gll, Gll^Fmf, Gll^Fmf, Hh^Fmf, Hh^Vws, Ww, Ww, Mm, Mm, Mm, Mm, Mm, Mm^Cov, Mm^Cov, Mm^Cov, Mm, Mm, Mm, Mm, Mm, Mm
Mm, Mm, Mm, Mm, Hh^Fmf, Mm, Mm, Mm, Mm, Mm, Hh^Fmf, Hh^Fmf, Hh^Fmf, Gll^Fmf, Gll, Gll^Fmf, Gll, Gs, Gg, Gs, Gg, Gs, Gs, Gs, Hh, Gll, Hh, Gg, Gll, Gg, Gg, Gg, Gll^Fmf, Gll^Fmf, Hh^Fmf, Hh^Fmf, Hh^Fmf, Gll^Fmf, Gll^Fmf, Gll, Ww, Ww, Hh^Fmf, Mm, Mm, Mm, Mm, Mm, Mm^Cov, Mm^Kov, Mm^Cov, Mm, Mm, Mm, Mm, Mm, Mm
Mm, Mm, Mm, Hh^Fmf, Ww, Hh^Fmf, Hh^Fmf, Mm, Hh^Fmf, Hh^Fmf, Hh^Fmf, Hh^Fmf, Hh^Vws, Gll^Fmf, Gll, Gll, Gll^Fmf, Gll, Hh^Vws, Gg, Gs, Gs, Gg^Fmf, Hh, Hh^Fmf, Hh^Fmf, Hh^Fmf, Gg^Fmf, Gg^Fmf, Gg, Gg, Gll, Gll^Fmf, Gll, Hh^Fmf, Hh, Hh^Fmf, Hh^Fmf, Gll, Gs, Ww, Ww, Hh^Fmf, Mm, Mm, Mm, Hh^Fmf, Hh^Fmf, Hh^Fmf, Mm^Cov, Mm, Mm, Mm, Mm, Mm, Mm, Mm
Mm, Mm, Ww, Ww, Ww, Ww, Ww, Hh^Fmf, Hh^Fmf, Hh^Fmf, Hh^Fmf, Gll^Fmf, Gll^Fmf, Gll, Gll^Fmf, Gll^Fmf, Hh, Hh, Hh^Fmf, Hh, Gg, Gs, Gg^Fmf, Hh, Hh^Fmf, Hh^Fmf, Hh, Gg^Fmf, Gll, Gg^Vws, Gg, Gll, Gll, Gll^Fmf, Hh^Vws, Hh^Fmf, Hh^Fmf, Hh^Fmf, Gg, Ww, Gll, Gs, Gll, Hh^Fmf, Hh^Fmf, Hh^Fmf, Gll^Fmf, Gll^Fmf, Gll, Hh^Fmf, Mm, Mm, Mm, Mm, Mm, Mm, Mm
Ww, Ww, Ww, Ww, Hh^Fmf, Ww, Ww, Ww, Ww, Hh^Fmf, Ww, Ww, Ww, Gll, Gll^Fmf, Hh, Hh, Hh^Fmf, Gs, Gg, Gs, Gs, Gg, Gg^Fmf, Gll, Gll, Hh^Fmf, Gll, Gg, Gg, Gg, Gg, Gg, Gll, Gll^Fmf, Hh^Fmf, Gll^Fmf, Gll^Fmf, Rr, Ww, Gg, Gll^Fmf, Gll^Fmf, Gll^Fmf, Gll^Fmf, Gll, Gll, Gll^Fmf, Gll, Hh^Fmf, Hh^Fmf, Mm, Mm, Mm, Mm, Mm, Mm
Ww, Ww, Mm, Hh^Fmf, Mm, Hh^Fmf, Hh^Fmf, Ww, Gll^Fmf, Ww, Gll^Fmf, Gll^Fmf, Gll^Fmf, Ww, Ww, Hh^Fmf, Hh^Fmf, Hh, Gs, Gg, Gg, Gs, Gs, Gg, Gg, Gg, Gs, Gg, Gg, Gg, Gg, Gg, Gg, Gg, Rr, Gll^Fmf, Rr, Rr, Ww, Ww^Bw\r, Rr, Gll, Gll^Fmf, Gll^Fmf, Gll^Fmf, Gll, Gg, Gg, Hh^Fmf, Hh^Fmf, Mm, Mm, Mm, Mm, Mm, Mm, Mm
Mm, Mm, Mm, Mm, Mm, Mm, Mm, Hh^Fmf, Hh^Fmf, Gll^Fmf, Gll^Fmf, Gll^Fmf, Gll, Gs, Ww, Gs, Gg, Gg, Gs, Gg, Gg, Gg, Gg, Gg, Gs, Gs, Gg, Gg, Kw, Gg, Rr^Cov, Rr, Kw, Rr, Gg, Rr, Ww, Ww, Ww, Gg, Rr, Gll^Fmf, Gll^Fmf, Gll^Fmf, Gll^Fmf, Gll^Fmf, Gg, Gs, Hh^Fmf, Mm, Mm, Mm, Mm, Mm, Mm, Mm, Mm
Mm, Mm, Mm, Mm, Mm, Mm, Mm, Mm, Mm, Hh^Fmf, Hh^Fmf, Gll^Fmf, Gll, Gg, Ww, Ww, Gg^Vws, Gg, Gg, Gs, Gs, Gg, Gs, Gs, Gg, Gg, Gll^Fmf, Cw, Gll^Fmf, Cw, Gg^Bsb|, Cw, Gll^Fmf, Cw, Ww, Ww, Wo, Wo, Ww, Gs, Rr, Gll, Gll^Fmf, Gll, Gll^Fmf, Gll, Gs, Gg, Gg, Hh^Fmf, Hh^Fmf, Mm, Mm, Mm, Mm, Mm, Mm
Mm, Mm, Mm, Mm, Mm, Mm, Mm, Mm, Mm, Mm, Mm, Hh^Fmf, Gll^Fmf, Gg, Gs, Ww, Ww, Ww, Ww, Gg, Gg, Gs, Gg, Gg, Ww, Ww, Ww, Ww, Ww, Gll^Fmf, Ww^Bsb|, Gll^Fmf, Ww, Ww, Mm, Ww, Wo, Wo, Ww, Gs, Rr, Gll, Gll^Fmf, Gll^Fmf, Gs, Gg, Rr, Gs, Gs, Gg, Gg, Hh^Fmf, Mm, Mm, Mm, Mm, Mm
Mm, Mm, Mm, Mm, Mm, Mm, Mm, Mm, Mm, Mm^Xm, Mm, Hh^Fmf, Hh^Fmf, Gll^Fmf, Gs, Gg, Gs, Gs, Ww, Gg, Ww, Cw, Kw, Cw, Ww, Ww, Mm^Xm, Kw, Ww, Ww, Rrc, Ww, Ww, Kw, Mm, Ww, Ww, Wo, Ww, Gg, Rr, Gs, Rr, Gs, Rr, Rr, Gll, Rr, Rr, Gg, Gg, Hh^Fmf, Hh^Fmf, Hh^Fmf, Hh^Fmf, Hh^Fmf, Hh^Fmf
Mm, Mm, Mm, Mm, Mm, Mm, Mm, Mm, Mm, Mm, Mm, Mm, Mm, Hh^Fmf, Gll^Fmf, Gg, Gs, Gg, Gs, Ww, Cw, Ww^Bsb|, Ww, Ww, Ww, Mm^Xm, Mm, Mm^Xm, Mm, Kw, Rrc, Kw, Mm, Mm, Mm, Mm, Kw, Ww, Ww, Gs, Gg, Rr, Gll^Fmf, Rr, Hh^Fmf, Hh^Fmf, Hh^Fmf, Gll, Hh^Fmf, Rr, Rr, Rr, Rr, Gll, Rr, Gs, Gg
Mm, Mm, Mm, Mm, Mm, Mm, Mm, Mm, Mm, Mm, Mm, Mm^Xm, Mm^Xm, Hh^Fmf, Hh^Fmf, Gs, Gs, Gg^Vws, Gg, Gg, Gg, Kw, Ww, Ww, Mm^Xm, Mm, Cw, Kw, Rrc^Vws, Rrc, Rrc, Rrc, Rrc^Vws, Kw, Cw, Mm, Mm^Xm, Ww, Ww, Gs, Gs, Gll, Gll^Fmf, Hh^Fmf, Mm, Mm^Xm, Mm, Hh^Fmf, Mm, Hh^Fmf, Hh^Fmf, Hh^Fmf, Hh^Fmf, Rr, Gs, Rr, Rr
Mm, Mm, Mm, Mm, Mm, Mm, Mm, Mm, Mm, Mm^Xm, Mm^Xm, Mm, Mm, Mm, Hh^Fmf, Gg, Gs, Gs, Gg, Gs, Gs, Cw, Ww, Ww, Ww, Kw, Cw, Rrc, Rrc^Vws, Rrc, Cw, Rrc, Rrc^Vws, Rrc, Cw, Kw, Mm, Mm^Xm, Ww, Ww, Gll^Fmf, Gll^Fmf, Gll, Hh^Fmf, Mm, Mm, Mm, Mm, Mm, Mm, Mm, Mm, Hh^Fmf, Gll, Hh, Gs, Gg
Mm, Mm, Mm, Mm, Mm, Mm, Mm, Mm, Mm, Mm, Mm, Mm^Xm, Mm, Mm, Hh^Fmf, Gll, Gs, Gs, Gg, Gs, Gll^Fmf, Gs, Ww, Wo, Ww, Cw, Rrc^Vws, Kw, Cw, Cw, Cw, Cw, Cw, Kw, Rrc^Vws, Cw, Mm, Mm^Xm, Ww, Ww, Gll, Gll^Fmf, Gll^Fmf, Hh^Fmf, Hh^Fmf, Mm, Mm, Mm, Mm, Mm, Mm, Mm, Hh^Fmf, Hh^Fmf, Hh^Fmf, Hh^Fmf, Hh^Fmf
Mm, Mm, Mm, Mm, Mm, Mm, Mm, Mm, Mm, Mm, Mm, Mm, Mm, Mm, Hh^Fmf, Gll^Fmf, Gg, Gs, Gs, Gg, Gll^Fmf, Gll^Fmf, Ww, Ww, Mm, Kw, Rrc^Vws, Rrc, Cw, Kw, 3 Kw, Kw, Cw, Rrc, Rrc^Vws, Kw, Mm, Mm, Ww, Ww, Gs, Gs, Gll, Hh^Fmf, Hh^Fmf, Mm, Mm, Mm, Mm, Mm, Mm, Mm, Mm, Hh^Fmf, Hh^Fmf, Hh^Fmf, Hh
Mm, Mm, Mm, Mm, Mm, Mm, Mm, Mm, Mm, Mm, Mm, Mm, Mm, Hh^Fmf, Hh^Fmf, Gll, Gll, Gg, Ww, Gll, Ww, Ww, Ww, Mm^Xm, Mm, Kw, Rrc^Vws, Rrc, Cw, Kw, Cw, Kw, Cw, Rrc, Rrc^Vws, Kw, Mm, Mm, Ww, Ww, Cw, Gg, Gll^Fmf, Gll^Fmf, Hh^Vws, Hh^Fmf, Mm, Mm, Mm, Mm, Mm, Mm, Mm, Mm, Hh^Fmf, Hh, Gll^Fmf
Mm, Mm, Mm, Mm, Mm, Mm, Mm, Mm, Mm, Mm, Mm^Xm, Mm^Xm, Mm, Hh^Fmf, Ww, Ww, Ww, Gll^Fmf, Ww, Ww, Mm^Xm, Ww, Mm, Mm, Mm, Cw, Cw, Kw, Rrc^Vws, Cw, Cw, Cw, Rrc^Vws, Kw, Cw, Cw, Mm, Mm, Ww, Ww, Kw, Gg, Gs, Gll, Gll, Hh^Fmf, Hh^Fmf, Mm, Mm, Mm, Mm, Mm, Mm, Mm, Hh^Fmf, Gll^Fmf, Ww
Mm, Mm, Mm, Mm, Mm, Mm, Mm, Mm, Mm, Mm^Xm, Mm, Mm, Ww, Ww, Ww, Gll^Fmf, Gll^Fmf, Ww, Ww, Kw, Mm, Mm^Xm, Mm^Xm, Mm, Cw, Kw, Cw, Rrc^Vws, Rrc^Vws, Rrc, 1 Rrc, Rrc, Rrc^Vws, Rrc^Vws, Cw, Kw, Mm^Xm, Kw, Ww, Ww, Ww, Cw, Kw, Gg, Gg, Gll^Fmf, Gll, Hh^Fmf, Hh^Fmf, Hh^Fmf, Hh^Fmf, Mm, Hh^Fmf, Hh^Fmf, Ww, Ww, Ww
Mm, Mm, Mm, Mm, Mm, Mm, Mm, Mm, Mm, Mm, Mm, Ww, Ww, Ww, Mm^Xm, Hh^Vws, Hh^Fmf, Ww, Ww, Cw, Cw, Mm, Cw, Cw, Ww, Mm, Mm, Kw, Mm, Rrc, Rrc, Rrc, Mm, Kw, Mm, Mm, Kw, Ww, Ww, Wo, Wo^Bsb/, Ww^Bsb/, Ww, Ww, Ww, Gll, Gll, Gll^Fmf, Gll^Fmf, Gll^Fmf, Gll^Fmf, Hh^Fmf, Ww, Ww, Ww, Ww, Rr
Ww, Mm, Mm, Mm, Mm, Mm, Mm, Hh^Fmf, Ww, Mm, Ww, Ww, Mm, Mm, Mm, Mm, Hh^Fmf, Gll^Fmf, Ss, Ww, Ww, Kw, Ww, Ww, Ww, Ww, Ww, Mm, Mm, Kw, Rrc, Kw, Mm, Mm, Mm, Mm, Ww, Ww, Kw, Ww^Bsb/, Ww, Wo, Ww, Ww, Ww, Ww, Ww, Gll, Gll^Fmf, Gll^Fmf, Ww, Ww, Ww, Ww, Rr, Rr, Hh
Ww, Ww, Ww, Mm, Hh^Fmf, Mm, Ww, Ww, Ww, Ww, Ww, Mm, Mm, Mm, Mm^Xm, Mm, Hh^Fmf, Gll^Fmf, Gll^Fmf, Ss, Ww, Ww, Ds, Ds, Ds, Ww, Ww, Kw, Ww, Ww, Ww^Bsb|, Ww, Ww, Kw, Ww, Ww, Gg, Cw, Gs, Cw, Gg, Ww, Gs, Gs, Gg, Ww, Ww, Ww, Ww, Ww, Ww, Ww, Rr, Rr, Hh^Fmf, Hh^Fmf, Mm
Mm, Ww, Ww, Ww, Ww, Ww, Ww, Ww, Mm, Mm, Mm, Mm, Mm, Mm, Mm, Mm, Hh^Fmf, Gll^Fmf, Gll, Gll, Ww, Ds, Gll^Fmf, Gg^Vws, Ds, Ww, Gs, Ww^Bsb|, Ww, Ww, Gg^Bsb|, Ww, Ww, Ww^Bsb|, Gg, Gs, Gg, Gs, Gs, Gg, Gs, Gg, Gg, Gs, Gg, Gs, Gg, Ww, Ww, Ww, Rr, Rr, Gg, Hh^Fmf, Mm, Mm, Mm
Mm, Mm, Mm, Ww, Hh^Fmf, Ww, Mm, Mm, Mm, Mm, Mm, Mm, Mm, Mm, Mm, Mm, Hh^Fmf, Gll^Fmf, Gll, Ww, Ds, Ds, Gll^Fmf, Ds, Ww, Ww, Gg, Kw, Cw, Gs, Rr^Cov, Gs, Cw, Kw, Gg, Gs, Gs, Gs, Gs, Gs, Gs, Gs, Gs, Gg, Gs, Gg, Rr, Gg^Vws, Rr, Rr, Gs, Gs, Hh^Fmf, Hh^Fmf, Mm, Mm, Mm
Mm, Mm, Mm, Hh^Fmf, Mm, Mm, Mm, Mm, Mm, Mm, Mm, Mm, Mm, Mm, Mm, Mm, Mm, Hh^Fmf, Hh^Fmf, Ww, Ds, Gll^Fmf, Gll^Fmf, Ds, Ww, Ww, Gs, Gs, Gg, Kw, Rr^Cov, Kw, Gg, Gs, Gs, Gg, Gg, Gg^Vws, Gg, Gg, Rr, Rr, Rr, Gs, Rr, Rr, Gs, Rr, Gg, Gg, Hh^Fmf, Hh^Fmf, Mm, Mm, Mm, Mm, Mm
Mm, Mm, Mm, Mm, Mm, Mm, Mm, Mm, Hh^Fmf, Hh^Fmf, Mm, Mm, Mm, Mm, Mm, Mm, Mm, Mm, Hh^Fmf, Ww, Ww, Ds, Ds, Ds, Ww, Gg, Gg, Gs, Rr, Rr, Hh, Hh, Hh^Fmf, Hh^Fmf, Hh, Gg, Gs, Gs, Rr, Rr, Hh^Fmf, Hh^Fmf, Mm, Rr, Hh^Fmf, Hh^Fmf, Hh^Fmf, Gg, Gll, Gll, Hh^Fmf, Mm, Mm, Mm, Mm, Mm, Mm
Mm, Mm, Mm, Mm, Mm, Mm, Hh^Fmf, Hh^Fmf, Gll^Fmf, Hh^Fmf, Hh^Fmf, Mm, Mm, Mm, Mm, Mm, Mm, Mm, Hh^Fmf, Ww, Ww, Ww, Ww, Ww, Ww, Gg, Gs, Gs, Rr, Gs, Gs, Hh^Fmf, Hh^Fmf, Hh^Fmf, Hh^Fmf, Hh^Fmf, Rr, Rr, Hh^Fmf, Hh^Fmf, Mm, Mm, Mm, Mm^Xm, Mm^Xm, Mm, Mm, Hh^Fmf, Hh^Fmf, Hh^Fmf, Mm, Mm, Mm, Mm, Mm, Mm, Mm
Mm, Mm, Mm, Mm, Mm, Mm, Hh^Fmf, Gll^Fmf, Gll^Fmf, Gll^Fmf, Ww, Ww, Ww, Mm, Ww, Mm, Mm, Mm, Ww, Ww, Gs, Gg, Gg, Gg, Gs, Gs, Gg, Gg, Rr, Gg, Gs, Hh^Fmf, Hh, Hh, Hh, Gs, Rr, Gs, Hh^Fmf, Mm, Mm, Mm, Mm, Mm, Mm, Mm^Xm, Mm, Mm, Mm, Hh^Fmf, Mm, Mm, Mm, Mm, Mm, Mm, Mm
Mm, Mm, Mm, Mm, Mm, Hh^Fmf, Ww, Gll^Fmf, Ww, Ww, Hh^Fmf, Hh^Fmf, Mm^Xm, Ww, Ww, Ww, Ww, Hh^Vws, Ww, Ww, Gg, Gs, Hh^Vws, Gs, Hh^Fmf, Gs, Gg, Rr, Gll, Rr, Gs, Hh^Fmf, Hh, Hh, Gll, Gs, Rr, Gs, Hh^Fmf, Mm, Mm, Mm, Mm, Mm, Mm, Mm, Mm, Mm, Mm, Mm, Mm, Mm, Mm, Mm, Mm, Mm, Mm
Mm, Mm, Hh^Fmf, Hh^Fmf, Hh^Fmf, Hh^Fmf, Ww, Ww, Hh^Fmf, Hh^Fmf, Mm, Mm, Mm, Mm, Mm, Ww, Gll, Ww, Gg, Gg, Gs, Gs, Hh^Fmf, Hh^Fmf, Hh^Fmf, Hh^Fmf, Gs, Rr, Gs, Rr, Rr, Gg, Gs, Gs, Rr, Gg, Rr, Gs, Hh^Fmf, Mm, Cw, Mm, Mm, Mm, Mm, Mm, Mm, Mm, Mm, Mm, Mm, Mm, Mm, Mm, Mm, Mm, Mm
Mm, Mm, Hh^Fmf, Hh^Fmf, Ww, Ww, Ww, Hh^Fmf, Mm, Mm, Mm, Mm, Mm, Mm, Hh^Fmf, Hh^Fmf, Gll^Fmf, Gll, Gs, Gg, Gs, Hh^Fmf, Hh^Fmf, Hh, Hh^Fmf, Hh^Fmf, Gs, Rr, Gg, Gs, Gs, Rr, Rr, Rr, Gg, Rr, Rr, Gg, Gll, Cw, Kw, Cw, Mm, Mm, Mm, Mm, Mm, Mm, Mm, Mm, Mm, Mm, Mm, Mm, Mm, Mm, Mm
Mm, Mm, Hh^Fmf, Ww, Ww, Ww, Hh^Fmf, Hh^Fmf, Mm, Mm, Mm, Mm, Mm, Hh^Fmf, Hh^Vws, Gll^Fmf, Gll^Fmf, Gll, Gll, Gg, Hh^Fmf, Hh^Fmf, Mm, Hh^Fmf, Hh^Fmf, Mm, Rr, Rr, Mm, Hh^Fmf, Hh^Fmf, Gs, Gg, Gg, Gs, Gg, Gg, Rr, Gll, Cw, Cw, Cw, Mm, Mm, Mm, Mm, Mm, Mm, Mm, Mm, Mm, Mm, Mm, Mm, Mm, Mm, Mm
Mm, Mm, Ww, Ww, Mm, Mm, Mm, Mm, Mm, Mm, Mm, Mm, Mm, Hh^Fmf, Hh^Fmf, Gll^Fmf, Gll^Fmf, Gll^Fmf, Gll, Gg, Gs, Hh^Fmf, Mm, Mm^Xm, Mm, Mm, Rr, Gs, Hh^Fmf, Mm^Xm, Hh^Fmf, Gll, Hh^Fmf, Hh^Fmf, Hh^Fmf, Gs, Gs, Rr, Rr, Gll, Hh^Fmf, Mm, Mm, Mm, Mm, Mm, Mm, Mm, Mm, Mm, Mm, Mm, Mm, Mm, Mm, Mm, Mm
Ww, Ww, Mm, Mm, Mm, Mm, Mm, Mm, Hh^Fmf, Hh^Fmf, Mm, Mm, Mm, Mm, Hh^Fmf, Gll^Fmf, Gll, Gll^Fmf, Gll^Fmf, Gll, Hh^Fmf, Gs, Gll, Hh^Fmf, Hh^Fmf, Hh^Fmf, Rr, Gll, Hh^Vc, Mm^Xm, Mm, Hh^Fmf, Mm, Mm, Mm, Hh^Fmf, Hh^Fmf, Gs, Gg, Rr, Rr, Hh^Fmf, Hh^Fmf, Mm, Hh^Fmf, Mm, Mm, Mm, Mm, Mm, Mm, Mm, Mm, Mm, Mm, Mm, Mm
Mm, Mm, Mm, Mm, Mm, Mm, Hh^Cov, Hh^Fmf, Hh^Fmf, Hh^Fmf, Hh^Fmf, Mm, Hh^Fmf, Hh^Fmf, Hh^Fmf, Gll^Fmf, Gll^Fmf, Gll^Fmf, Hh^Fmf, Hh^Fmf, Mm, Hh^Fmf, Mm, Gll, Gs, Gs, Rr, Gg, Gs, Hh^Fmf, Hh^Fmf, Mm, Mm, Mm^Xm, Mm^Xm, Mm, Mm, Hh^Fmf, Gs^Vws, Gs, Gll, Rr, Rr, Rr, Rr, Hh^Fmf, Hh^Fmf, Mm, Mm, Mm, Mm, Mm, Mm, Mm, Mm, Mm, Mm
Mm, Mm, Mm, Mm, Mm, Hh^Cov, Hh^Kov, Hh^Cov, Hh^Fmf, Hh^Fmf, Hh^Fmf, Hh^Fmf, Hh^Fmf, Hh, Hh^Fmf, Gll^Fmf, Hh^Vws, Hh^Fmf, Mm, Mm, Mm, Mm, Mm, Mm, Hh^Fmf, Rr, Cud, Rr, Gll, Hh^Fmf, Mm, Mm, Mm, Mm, Mm, Mm^Xm, Mm, Hh^Fmf, Hh^Fmf, Hh^Fmf, Hh^Fmf, Hh^Fmf, Hh^Fmf, Hh^Fmf, Hh^Fmf, Rr, Rr, Hh^Fmf, Hh^Fmf, Mm, Mm, Mm, Mm, Mm, Mm, Mm, Mm
Mm, Mm, Mm, Mm, Mm, Hh^Cov, Hh^Cov, Hh^Cov, Hh^Fmf, Hh^Fmf, Hh^Fmf, Hh^Fmf, Hh^Fmf, Hh^Fmf, Hh^Fmf, Hh^Fmf, Hh^Fmf, Mm, Mm, Mm^Xm, Mm^Xm, Mm, Mm, Mm, Cud, Rr, Rr, Rr, Cud, Hh^Fmf, Mm, Mm, Mm, Mm, Mm^Xm, Mm, Mm, Mm, Mm, Mm, Mm, Mm^Xm, Mm, Mm, Mm, Hh^Fmf, Gll^Fmf, Rr, Rr, Hh^Fmf, Hh^Fmf, Mm, Mm, Mm, Mm, Mm, Mm
Mm, Mm, Mm, Mm, Mm, Mm, Mm, Hh^Fmf, Mm, Hh^Fmf, Hh^Fmf, Hh^Fmf, Hh^Fmf, Hh^Fmf, Mm, Mm^Xm, Mm^Xm, Mm, Mm, Mm, Mm, Mm^Xm, Mm, Cud, Hh, Rr, Cud, Rr, Hh^Vud, Cud, Mm, Mm, Mm, Mm, Mm^Xm, Mm^Xm, Mm^Xm, Mm, Mm, Mm, Mm, Mm, Mm, Mm^Xm, Mm, Hh^Fmf, Hh^Fmf, Gll^Fmf, Gll^Fmf, Rr, Rr, Hh^Fmf, Hh^Fmf, Hh^Fmf, Mm, Mm, Mm
Mm, Mm, Mm, Mm, Mm, Mm, Mm, Mm, Mm, Mm^Xm, Mm^Xm, Mm, Mm, Mm, Mm, Mm^Xm, Mm^Xm, Mm^Xm, Mm, Mm, Mm, Mm, Mm, Mm, Hh, Cud, Kud, Cud, Hh, Hh, Mm, Mm, Mm, Mm, Mm, Mm^Xm, Mm, Mm, Mm, Mm, Mm, Mm^Xm, Mm^Xm, Mm, Mm, Mm, Hh^Fmf, Gll^Fmf, Gll^Fmf, Gll^Fmf, Gll^Fmf, Rr, Rr, Gll^Fmf, Mm, Mm, Mm
Mm, Mm, Mm, Mm, Mm, Mm, Mm, Mm, Mm, Mm, Mm, Mm^Xm, Mm, Mm, Mm, Mm, Mm, Mm, Mm, Mm, Mm, Mm, Mm, Mm, Mm, Cud, Cud, Cud, Mm, Mm, Mm, Mm, Mm, Mm, Mm, Mm, Mm, Mm, Mm, Mm^Xm, Mm^Xm, Mm, Mm, Mm^Xm, Mm, Mm, Mm^Xm, Hh^Fmf, Hh^Fmf, Hh^Fmf, Hh^Fmf, Gll^Fmf, Gll^Fmf, Rr, Rr, Mm, Mm
Mm, Mm, Mm, Mm, Mm, Mm, Mm, Mm, Mm, Mm, Mm, Mm, Mm, Mm^Xm, Mm^Xm, Mm, Mm, Mm, Mm, Mm, Mm, Mm, Mm, Mm, Mm, Mm, Mm, Mm, Mm, Mm, Mm, Mm, Mm, Mm, Mm, Mm, Mm, Mm, Mm, Mm, Mm, Mm, Mm, Mm, Mm, Mm, Mm, Mm, Mm, Mm, Mm, Hh^Fmf, Gll^Fmf, Gll^Fmf, Rr, Mm, Gll^Fmf
Mm, Mm, Mm, Mm, Mm, Mm, Mm, Mm, Mm, Mm, Mm, Mm, Mm, Mm, Mm, Mm^Xm, Mm, Mm, Mm, Mm, Mm, Mm, Mm, Mm, Mm, Mm, Mm, Mm, Mm, Mm, Mm, Mm, Mm, Mm, Mm, Mm, Mm, Mm, Mm, Mm, Mm, Mm, Mm, Mm, Mm, Mm, Mm, Mm, Mm, Mm, Mm, Mm, Mm, Hh^Fmf, Gll^Fmf, Rr, Rr
Mm, Mm, Mm, Mm, Mm, Mm, Mm, Mm, Mm, Mm, Mm, Mm, Mm, Mm, Mm, Mm, Mm, Mm, Mm, Mm, Mm, Mm, Mm, Mm, Mm, Mm, Mm, Mm, Mm, Mm, Mm, Mm, Mm, Mm, Mm, Mm, Mm, Mm, Mm, Mm, Mm, Mm, Mm, Mm, Mm, Mm, Mm, Mm, Mm, Mm, Mm, Mm, Mm, Hh^Fmf, Hh^Fmf, Gll^Fmf, Gg
