Xoi^Efs, Xoi^Efs, Xoi^Efs, Xoi^Efs, Xoi^Efs, Xoi^Efs, Xoi^Efs, Xoi^Efs, Xoi^Efs, Xoi^Efs, Xoi^Efs, Xoi^Efs, Xoi^Efs, Xoi^Efs, Xoi^Efs
Xoi^Efs, Xoi^Efs, Xoi^Efs, Xoi^Efs, Xoi^Efs, Xoi^Efs, Xoi^Efs, Xoi^Efs, Xoi^Efs, Xoi^Efs, Xoi^Efs, Xoi^Efs, Xoi^Efs, Xoi^Efs, Xoi^Efs
Xoi^Efs, Xoi^Efs, Irs, Xoi^Efs, Irs, Xoi^Efs, Irs^Ii, Xoi^Efs, Irs^Ii, Xoi^Efs, Irs, Xoi^Efs, Irs, Xoi^Efs, Xoi^Efs
Xoi^Efs, Irs, Irs, Irs, Irs, Irs, Irs^Ii, Irs^Vs, Irs^Ii, Irs, Irs, Irs, Irs, Irs, Xoi^Efs
Xoi^Efs, Xoi^Efs, Xoi^Efs, Irs, Irs, Xoi^Efs, 1 Irs, Irs^Ii, Irs, Xoi^Efs, Irs, Irs, Xoi^Efs, Xoi^Efs, Xoi^Efs
Xoi^Efs, Xoi^Efs, Irs, Irs, Irs, Irs, Irs, 2 Irs, Irs, Irs, Irs, Irs, Irs, Xoi^Efs, Xoi^Efs
Xoi^Efs, Irs, Irs, Xoi^Efs, Irs, 4 Irs, Irs, Irs, Irs, 3 Irs, Irs, Xoi^Efs, Irs, Irs, Xoi^Efs
Xoi^Efs, Irs, Irs, Irs, Irs, Irs, Irs, Irs, 5 Irs, Irs, Irs, Irs, Irs, Irs, Xoi^Efs
Xoi^Efs, Xoi^Efs, Xoi^Efs, Irs, Irs, Xoi^Efs, Irs, Irs, Irs, Xoi^Efs, Irs, Irs, Xoi^Efs, Xoi^Efs, Xoi^Efs
Xoi^Efs, Xoi^Efs, Irs, Irs, Irs, Irs, Irs, Irs, Irs, Irs, Irs, Irs, Irs, Xoi^Efs, Xoi^Efs
Xoi^Efs, Irs, Irs, Irs, Xoi^Efs, Xoi^Efs, Irs, Irs, Irs, Xoi^Efs, Xoi^Efs, Irs, Irs, Irs, Xoi^Efs
Xoi^Efs, Xoi^Efs, Xoi^Efs, Xoi^Efs, Xoi^Efs, Xoi^Efs, Irs, Irs, Irs, Xoi^Efs, Xoi^Efs, Xoi^Efs, Xoi^Efs, Xoi^Efs, Xoi^Efs
Gg, Gg, Xoi, Gg, Gg, Xoi, Irs^Xo, Irs^Xo, Irs^Xo, Xoi, Gg, Gg, Xoi, Gg, Gg
Xoi, Xoi, Gg^Efm, Xoi, Xoi, Xoi, Irs, Irs, Irs, Xoi, Xoi, Xoi, Gg^Efm, Xoi, Xoi
Xoi, Gg^Efm, Irs, Gg^Efm, Gg^Efm, Xoi, Irs, Irs, Irs, Xoi, Gg^Efm, Gg^Efm, Irs, Gg^Efm, Xoi
Xoi, Gg^Efm, Irs, Irs, Irs, Gg^Efm, Irs, Gg^Efm, Irs, Gg^Efm, Irs, Irs, Irs, Gg^Efm, Xoi
Xoi, Gg^Efm, Irs, Gg^Efm, Irs, Gg^Efm, Irs, Gg^Efm, Irs, Gg^Efm, Irs, Gg^Efm, Irs, Gg^Efm, Xoi
Xoi, Irs, Irs, Gg^Efm, Irs, Gg^Efm, Irs, Irs, Irs, Gg^Efm, Cwr, Gg^Efm, Cwr, Irs, Xoi
Xoi, Gg^Efm, Irs, Gg^Efm, Irs, Gg^Efm, Irs, Gg^Efm, Irs, Gg^Efm, Cwr, Gg^Efm, Cwr, Gg^Efm, Xoi
Xoi, Gg^Efm, Irs, Irs, Irs, Gg^Efm, Irs, Gg^Efm, Irs, Gg^Efm, Cwr, Kwr, Cwr, Gg^Efm, Xoi
Xoi, Gg^Efm, Irs, Gg^Efm, Irs, Gg^Efm, Irs, Gg^Efm, Irs, Gg^Efm, Cwr, Gg^Efm, Cwr, Gg^Efm, Xoi
Xoi, Irs, Irs, Gg^Efm, Irs, Gg^Efm, Irs, Irs, Irs, Gg^Efm, Irs, Gg^Efm, Irs, Irs, Xoi
Wo, Irs, Wo, Wwf, Wo, Irs^Bsb|, Wo^Bsb|, Irs^Bsb|, Wo^Bsb|, Irs^Bsb|, Wo, Wwf, Wo, Irs, Wo
Wo, Wo, Wo, Wo, Wo, Wo^Bsb|, Wo^Bsb|, Wo^Bsb|, Wo^Bsb|, Wo^Bsb|, Wo, Wo, Wo, Wo, Wo
Wo, Wo, Wo, Wo, Wo, Wo^Bsb|, Wo^Bsb|, Wo^Bsb|, Wo^Bsb|, Wo^Bsb|, Wo, Wo, Wo, Wo, Wo
Wo, Wo, Wo, Wo, Wo, Wo^Bsb|, Wo^Bsb|, Wo^Bsb|, Wo^Bsb|, Wo^Bsb|, Wo, Wo, Wo, Wo, Wo
