Ss, Ss, Sm, Gs, Ds, Gs, Ds, Ds, Ds, Ds, Ss, Gs, Gs, Sm, Ss, Gs, Gs, Ss, Gd, Sm, Ss, Gs, Gs, Gs, Gs, Gs, Gd, Gs, Ds, Gs, Ds, Gs, Ds, Gs, Ds, Ds, Ds, Gs, Ds, Gg, Ss, Gs, Gs, Gs, Gs, Gs, Sm, Gg, Ss, Ds, Ww, Wo, Wo, Ww, Ds, Gg, Ss, Gs, Gs, Gs
Ss, Ds, Gs, Sm, Ss, Gs, Ss, Sm, Ss, Ss, Gs, Ss, Gs, Ss, Sm, Ds, Ss, Ss, Ds, Gd, Sm, Ds, Ss, Ss, Sm, Ds, Gs, Sm, Sm, Sm, Sm, Gs, Gd, Gs, Ss, Gs, Gs, Gs, Ss, Ss, Ds, Gs, Sm, Gd, Ds, Gs, Ss, Ss, Ss, Ds, Ww, Wo, Wo, Wwr, Ss, Ss, Gd, Gs, Sm, Gd
Ds, Gs, Gs, Ss, Ss, Ss, Sm, Sm, Cer, Ds, Ds, Ss, Ds, Ss, Sm, Gs, Ss, Gs, Ds, Ds, Ss, Ds, Ds, Gs, Gs, Ss, Ss, Ds, Ds, Ss, Ss, Sm, Sm, Ds, Gs, Gs, Ds, Ss, Gs, Ds, Gd, Ds, Ds, Ds, Gd, Ds, Cer, Cer, Cer, Ds, Ww, Wo, Ww, Ww, Ss, Ss, Ss, Ds, Sm, Ds
Sm, Sm, Ds, Sm, Ds, Ds, Ss, Cer, 3 Ke, Cer, Gs, Sm, Ds, Ss, Ss, Sm, Gs, Sm, Ds, Sm, Ss, Gs, Ds, Ds, Gd, Ss, Ss, Ds, Sm, Ss, Gs, Ds, Ss^Vhs, Gd, Sm, Ds, Gd, Gs, Gd, Sm, Ss^Vhs, Sm, Ds, Ss, Ds, Ds, Cer, 4 Ker, Cer, Wwr, Wwr, Wo, Ww, Ds, Ds, Ss, Ss, Ds, Ds, Gd
Ss, Gs, Gs, Ds, Gs, Ds, Gs, Cer, Cer, Cer, Gs, Gd, Gs, Ds, Ds, Ds, Gs, Ss^Vhs, Ds, Ds, Gs, Gd, Gd, Gs, Gs, Gd, Ds, Ds, Sm, Gs, Gd, Ds, Sm, Ds, Gd, Sm, Ds, Sm, Gs, Gs, Gd, Ds, Ds, Ds, Ds, Gs, Sm, Cer, Ss, Ss, Ww, Wo, Ww, Ss, Ss, Ss, Ss, Gd, Ss, Ds
Gs, Gs, Gs, Ss, Gs, Ss, Gs^Ft, Ss, Gs, Ss, Ss, Ds, Gs, Ds, Ss, Ds, Gs, Ds, Ds, Ds, Gs, Ds, Ds, Ds, Ss, Sm, Sm, Gs, Sm, Gd, Ds, Sm, Ss, Ds, Ds, Gd, Ds, Sm, Gs, Ds, Sm, Ds, Sm, Gd, Gs, Sm, Ss, Ss, Ss, Ss, Ww, Wo, Wwf, Ds, Ss, Ss, Ss, Sm, Gs, Gs
Ds, Gd, Gd, Gs, Gs, Gs^Ft, Hh, Hh, Hh, Gs^Ft, Hh, Ss, Gs^Ft, Ss, Gs, Gs, Gs, Gs, Ds, Ss, Ds, Ss, Ss, Gs, Ss^Vhs, Ss, Ss, Gs, Ds, Ds, Gd, Ss, Ss, Ss, Ss, Gs, Ss, Gs, Ss, Gs, Ss, Sm, Sm, Gs, Gs, Ds, Ds, Ss, Ss, Ss^Vhs, Ds, Wwf, Wo, Ww, Ww, Ds, Ds, Gs, Ds, Ss
Ds, Ds, Ds, Gd, Gd, Hd, Hd, Hh^Ft, Hd, Hh^Ft, Hd, Hh^Ft, Hh^Ft, Gs, Gs, Gd, Gd, Gd, Gs, Ds, Gs, Gs, Gd, Gs, Gs, Gs, Gd, Ds, Ds, Gd, Ss, Ss, Ss, Gs, Gs, Gs, Gs, Gs, Gs, Gs, Gd, Gs, Gs, Gs, Ss, Ds, Ds, Ss, Ds, Ds, Ds, Ww, Wo, Wwr, Ww, Ds, Ds, Gd, Ds, Gs
Ww, Ds, Ds, Ds, Ds, Ds, Ds, Hd, Ds, Hd, Ds, Hd, Hd, Hh, Gd, Gs, Gs, Gs, Gs, Gs, Gs, Gd, Hh, Gs, Gs, Gs, Gd, Gs, Gs, Ss, Ss^Vhs, Gs, Gs, Gs, Gs, Gs, Gd, Gd, Gs, Gs, Gd, Gs, Ss, Ss, Ss, Ss, Ds, Ds, Ds, Ds, Ww, Ww, Wo, Wwr, Ww, Ss, Ds, Sm, Ss, Gs
Ww, Ww, Ww, Ds, Ds, Ds, Ds, Ds, Ds, Ds, Ds, Hd, Ds, Gd^Vc, Ds, Gd, Gd, Gs, Hh, Gs, Hh, Hh, Hh^Ft, Hh, Hh, Hh, Hh, Gs, Gs, Gs, Gd, Gd, Gs, Gd, Gs, Gd, Gs, Gs, Gd, Ss, Ss, Ss, Ss, Ss, Sm, Ww, Ww, Sm, Ww, Ww, Wwr, Wo, Ww, Ww, Ds, Ss, Ds, Sm, Ss, Gs
Ww, Ww, Ww, Ww, Ww, Ww, Ww, Ww, Ww, Ds, Ds, Ds, Ds, Ds, Ds, Ds, Ds, Gd, Hd, Hh, Hd, Hh, Hd, Hh, Hh^Ft, Hh^Ft, Hd, Gd, Gd, Gd, Gs, Gs, Gd, Gs, Gd, Gs, Gs, Gs, Ds, Ds, Ds, Ss, Ss, Ss^Vhs, Wwf, Ww, Wo, Wo, Wo, Wwr, Ww, Ww, Ss, Ds, Ds, Ds, Sm, Gd, Gs, Gs
Wwr, Ww, Ww, Ww, Ww, Ww, Ww, Ww, Ww, Ww, Ww, Ww, Ww, Ds, Ds, Ds, Ds, Ds, Ds, Hd, Hd^Vc, Hd, Ds, Hd, Hd, Hd, Ds, Hd, Ds, Gd, Gd, Gd, Ds, Gd, Ds, Gd, Ss, Ss, Ds, Ds, Sm, Sm, Ww, Ww, Wo, Wwf, Wwf, Ww, Ww, Ww, Ds, Ss, Sm, Ss, Sm, Ds, Sm, Ss, Ss, Gs
Ww, Wwr, Wwr, Ww, Ww, Ww, Ww, Ww, Ww, Ww, Ww, Ww, Ww, Ww, Ww, Ds, Ds, Ds, Ds, Ds, Ds, Ds, Ds, Ds, Ds, Hd, Ds, Ds, Ds, Ds, Ds, Ds, Ds, Ds, Ds, Ds, Ss, Ss, Ss, Sm, Ww, Wwr, Wo, Wo, Ww, Ww, Ds, Ds, Ss, Ss, Ss, Ss, Ss, Ss, Gd, Gd, Ss, Ds, Ss, Gs
Wo, Ww, Ww, Wwr, Wwr, Wwr, Ww, Ww, Wwr, Ww, Wwr, Ww, Ww, Ww, Ww, Ww, Ww, Ww, Ww, Ds, Ww, Ds, Ds, Ds, Ds, Ds, Ket, Ds, Ds, Ds, Ds, Ds, Ds, Ds, Ss, Ss, Ss, Ds, Ss, Wwf, Ww, Wwr, Ww, Ww, Sm, Sm, Ds, Ss, Ss, Ss, Ds, Ds, Gs, Gs, Ss, Ds, Ds, Ss, Gd, Ds
Ww, Wo, Wo, Ww, Wo, Ww, Wo, Ww, Ww, Ww, Ww, Ww, Ww, Ww, Ww, Ww, Wwr, Wwr, Wwr, Ww, Ww, Ww, Ww, Ww, Ww, Ww, Ww^Bw/, Ww^Bw/, Ket, Ds, Ds, Ds, Ds, Ss, Ss^Vht, Ss, Ww, Sm, Ww, Wwf, Wwf, Ww, Ds, Ds, Ds, Ds, Gd, Gs, Gs, Gd, Ss^Vhs, Gs, Gd, Gd, Ss, Ss, Ds, Gd, Ds, Ds
Ww, Ww, Ww, Wo, Ww, Wo, Ww, Wo, Wo, Ww, Wo, Wwr, Wo, Ww, Wo, Ww, Ww, Wo, Wo, Wwr, Ww, Wwr, Ss, Ss, Ss^Bh/, Ww^Bw/, Wwr, Ww, Ww, Ww, Ww, Ww, Ww, Ww, Ww, Ww, Ww, Ww, Ss, Ss, Ss, Ss, Ss, Ds, Gd, Ss, Ss, Gs, Ds, Ds, Ds, Ds, Gs, Gs, Ss, Gs, Ds, Ds, Gs, Gs
Ww, Wo, Ww, Ww, Wo, Ww, Ww, Wo, Ww, Wo, Ww, Wwr, Ww, Ww, Ww, Wwr, Wwr, Ww, Wo, Ww, Wwr, Ww, Ss, Ww^Vht, Ss^Bw\, Ss, Wwr, Wo, Ww, Wo, Wo, Wwr, Wwr, Ww, Wwr, Wo, Wo, Sm, Ds, Ds, Ss, Ss, Ds, Gs, Gs, Gs, Gs, Gs, Ss, Gd, Ss, Gs, Ss, Ss, Gs, Gs, Ds, Gs, Gs, Gs
Wo, Wo, Wo, Ww, Wo, Ww, Ww, Ww, Ww, Ww, Wo, Wo, Wo, Ww, Wo, Wwr, Wo, Ww, Wo, Wo, Wo, Wwr, Ww, Ww, Wwr, Wwr^Bh\, Ket, Ww, Ww, Ww, Ss^Bw/, Ss^Vht, Ss, Wo, Ww, Wwr, Wo, Ww, Ss^Vht, Ss, Ds, Gd, Gd, Ss, Gs, Gd, Ds, Gs, Ds, Ss, Gs, Ss, Gs, Gs, Gd, Gd, Gs, Gs, Gs^Ft, Gs^Ft
Wo, Wo, Wo, Wo, Wo, Wo, Wo, Wo, Wo, Ww, Ww, Ww, Ww, Wo, Ww, Ww, Ww, Ww, Ww, Wo, Ww, Wo, Ww, Ww, Ket, Cme^Bw/, Cme^Bw/, Cme^Bw\, Ket, Wwr^Bh/, Ss, Ss^Bw|, Ss, Ww, Wo, Wwr, Wo, Ww, Ww, Ss, Ds, Ds, Ds, Ss, Ss, Ds, Ss, Ds, Ds, Gd, Gd, Gs, Gd, Gs, Gs, Gs, Gs, Gs^Ft, Hh^Ft, Hh
Wo, Wo, Wo, Wo, Wo, Wo, Wo, Wo, Wo, Ww, Ww, Ww, Ww, Ww, Ww, Ww, Ww, Ww, Ww, Ww, Ww, Ww, Wo^Bh/, Wo^Bh/, Wo, Cme^Bw\, 2 Ket, Cme^Bw/, Wo, Wwr, Wwr, Ww^Bh|, Wo, Wo, Wo, Ww, Wwr, Ww, Ww, Ds, Ds, Ds, Ds, Gd, Gs, Ss, Ss, Ss, Gs, Gd, Gs, Gd, Gs, Gs, Gs, Gs, Hh, Hh, Hh, Hh
Wo, Wo, Wo, Wo, Wo, Wo, Wo, Wo, Wo, Wo, Wo, Ww, Wo, Ww, Wo, Wo, Wo, Wo, Ww, Ww, Ww, Ww^Vht, Ww, Ww, Wwr, Ww^Bh|, Ss, Ww^Bh|, Ww, Ww, Wo, Wo^Bw|, Wwr, Wwr, Ww, Wo, Ww, Wwr, Ww, Ket, Ds, Ds, Ds, Gd, Ss, Ss, Gs, Gs, Gs, Gs, Gd, Gd, Gs, Gs, Gs^Ft, Gs^Ft, Hh, Hh, Hh^Ft, Hh^Ft
Wo, Wo, Wo, Wo, Wo, Wo, Wo, Wo, Wo, Wo, Wo, Wo, Wo, Wo, Wo, Wo, Wo, Wo, Wo, Ww, Ww, Ww, Ww, Ww, Wwr, Ss^Vht, Ss^Bw\, Ss^Vht, Ww, Wo, Ww, Wwr^Vht, Wo^Bh\, Wo, Ss^Bh/, Ss^Vht, Wo, Wwr, Ww^Bh/, Ww^Bh/, Ket, Ds, Ds, Ds, Gd, Gs, Gs, Gd, Gs, Gs, Gs^Vht, Gd, Gs, Gd, Gs^Ft, Hh, Hh, Hh^Ft, Hh^Ft, Hh^Ft
Wo, Wo, Wo, Wo, Wo, Wo, Wo, Wo, Wo, Wo, Wo, Wo, Wo, Wo, Wo, Wo, Wo, Wo, Wo, Wo, Wo, Ww, Wo, Ww, Ww, Wwr, Ww, Ww^Bh\, Ww^Bh\, Ww, Ss, Wo, Ww^Bh/, Ket, Wwr, Ss^Bh|, Ss^Bw/, Ww^Bh/, Ww, Ww, Ww, Ds, Ds, Ds, Ds, Gd, Gs, Gs, Gd, Gs, Gd, Gd, Gs, Gs, Gs, Gs^Ft, Gs^Ft, Hh, Hh^Ft, Hh^Ft
Wo, Wo, Wo, Wo, Wo, Wo, Wo, Wo, Wo, Wo, Wo, Wo, Wo, Wo, Wo, Wo, Wo, Wo, Wo, Wo, Wo, Wo, Ww, Wo, Wo, Wo, Wo, Ww, Wo, Ss^Bw\, Ss^Vht, Ss^Bw/, Wwr, Wwr, Wo, Ss^Vht, Ww, Wo, Wwr, Ww, Ww, Ds, Ds, Ds, Ds, Gd, Gd, Gs, Gd, Gd, Gs, Gd, Gd, Gs, Gd, Gs, Gs^Ft, Hh, Hh^Ft, Hh^Ft
Wo, Wo, Wo, Wo, Wo, Wo, Wo, Wo, Wo, Wo, Wo, Wo, Wo, Wo, Wo, Wo, Wo, Wo, Wo, Wo, Wo, Ww, Ww, Ww, Ww, Wo, Ww, Wwr, Wwr, Ww, Ww, Ww, Ww, Ww, Wo, Wo, Ww, Wo, Wwr, Wwr, Ww, Ww, Ww, Ds, Ds, Gd, Gd, Gd, Gs, Gs, Gd, Gs, Gs, Gs, Gd, Gs, Gs^Vht, Hh, Hh, Hh
Wo, Wo, Wo, Wo, Wo, Wo, Wo, Wo, Wo, Wo, Wo, Wo, Wo, Wo, Wo, Wo, Wo, Wo, Wo, Wo, Wo, Wo, Ww, Ww, Ww, Ww, Wo, Ww, Ww, Wwr, Ww, Ww, Wwr, Ww, Ww, Wo, Ww, Wo, Ww, Ww, Ww, Ww, Ww, Ds, Ds, Ds, Gd, Gs, Gs, Gd, Gs, Gd, Gd, Gs, Gd, Gs, Gs^Ft, Hh, Gs^Ft, Gs^Ft
Wo, Wo, Wo, Wo, Wo, Wo, Wo, Wo, Wo, Wo, Wo, Wo, Wo, Wo, Wo, Wo, Wo, Wo, Wo, Wo, Wo, Wo, Wo, Wo, Ww, Ww, Wo, Ww, Ww, Wo, Ww, Wo, Ww, Ww, Wwr, Wwr, Ww, Wo, Ww, Ww, Ww, Ww, Ds, Ds, Ds, Ds, Hh, Hh, Hh^Vht, Gs, Gs, Gd, Gs, Gs, Gs, Gs, Gs, Gs^Ft, Gs, Gs
Wo, Wo, Wo, Wo, Wo, Wo, Wo, Wo, Wo, Wo, Wo, Wo, Wo, Wo, Wo, Wo, Wo, Wo, Wo, Wo, Wo, Wo, Wo, Wo, Wo, Ww, Ww, Ww, Wo, Wo, Ww, Wo, Ww, Wo, Wwr, Wo, Wo, Wo, Ww, Ww, Ww, Ww, Ds, Ds, Ds, Hh, Hh, Hh^Ft, Hh^Ft, Gs^Ft, Gs, Gd, Gd, Gs, Gs, Gs, Gs, Gs, Gs, Gs
Wo, Wo, Wo, Wo, Wo, Wo, Wo, Wo, Wo, Wo, Wo, Wo, Wo, Wo, Wo, Wo, Wo, Wo, Wo, Wo, Wo, Wo, Wo, Wo, Wo, Ww, Ww, Ww, Ww, Ww, Ww, Ww, Ww, Ww, Ww, Wo, Wo, Ww, Ww, Ww, Ww, Ww, Ds, Ds, Ds, Hh, Hh, Hh^Ft, Hh^Ft, Hh, Gs^Ft, Gd, Gs, Gd, Gs, Gd, Gd, Gs, Gs, Gs
Wo, Wo, Wo, Wo, Wo, Wo, Wo, Wo, Wo, Wo, Wo, Wo, Wo, Wo, Wo, Wo, Wo, Wo, Wo, Wo, Wo, Wo, Wo, Wo, Wo, Wo, Wo, Wo, Ww, Ww, Ww, Ww, Wo, Ww, Ww, Ww, Wo, Wwr, Wwr, Ww, Ww, Ww, Ww, Ds, Ds, Gs^Ft, Gs^Ft, Hh, Hh^Ft, Hh^Ft, Hh, Gs^Ft, Gs, Gs, Gs, Gs, Gs, Re^Vct, Gd, Gs
Wo, Wo, Wo, Wo, Wo, Wo, Wo, Wo, Wo, Wo, Wo, Wo, Wo, Wo, Wo, Wo, Wo, Wo, Wo, Wo, Wo, Wo, Wo, Wo, Wo, Wo, Wo, Ww, Ww, Ww, Ww, Ww, Ww, Ww, Wo, Ww, Ww, Ww, Ww, Ww, Wwr, Ww, Ww, Ds, Ds, Ds, Gs^Ft, Hh, Hh, Hh, Gs^Ft, Gd, Ce, Ce, Ce, Gs, Gd, Gs, Gs, Gd
Wo, Wo, Wo, Wo, Wo, Wo, Wo, Wo, Wo, Wo, Wo, Wo, Wo, Wo, Wo, Wo, Wo, Wo, Wo, Wo, Wo, Wo, Wo, Wo, Wo, Wo, Wo, Wo, Wo, Ww, Wo, Ww, Ww, Wo, Ww, Ww, Wo, Ww, Ww, Ww, Ww, Ww, Wwr, Ww, Ds, Ds, Ds, Hh, Hh^Ft, Hh, Gd, Gs, Ce, 1 Ke, Ce, Gd, Gs, Gs, Gd, Gs
Wo, Wo, Wo, Wo, Wo, Wo, Wo, Wo, Wo, Wo, Wo, Wo, Wo, Wo, Wo, Wo, Wo, Wo, Wo, Wo, Wo, Wo, Wo, Wo, Wo, Wo, Wo, Wo, Wo, Wo, Ww, Ww, Wo, Wo, Wo, Ww, Ww, Wo, Wo, Ww, Wwr, Ww, Wwr, Ww, Ww, Ds, Ds, Gs^Vht, Gs^Ft, Gs^Ft, Gs, Gs, Gd, Ce, Gd, Gs, Gd, Gd, Gs, Gs
Wo, Wo, Wo, Wo, Wo, Wo, Wo, Wo, Wo, Wo, Wo, Wo, Wo, Wo, Wo, Wo, Wo, Wo, Wo, Wo, Wo, Wo, Wo, Wo, Wo, Wo, Wo, Wo, Wo, Wo, Ww, Ww, Wo, Ww, Wo, Ww, Wwr, Wwr, Wo, Wwr, Ww, Ww, Ww, Ww, Ww, Ds, Ds, Ds, Gd, Gs, Gd, Gd, Gd, Gs, Gd, Gd, Gs, Gd, Gs, Gs
Wo, Wo, Wo, Wo, Wo, Wo, Wo, Wo, Wo, Wo, Wo, Wo, Wo, Wo, Wo, Wo, Wo, Wo, Wo, Wo, Wo, Wo, Wo, Wo, Wo, Wo, Wo, Wo, Wo, Wo, Ww, Ww, Ww, Wo, Ww, Ww, Wwr, Ww, Wo, Wwr, Ww, Ww, Ww, Ww, Ds, Ds, Ds, Ds, Gd, Gs, Gd, Gd, Gs, Gd, Gd, Gd, Gs, Gd, Gs, Gs
Wo, Wo, Wo, Wo, Wo, Wo, Wo, Wo, Wo, Wo, Wo, Wo, Wo, Wo, Wo, Wo, Wo, Wo, Wo, Wo, Wo, Wo, Wo, Wo, Wo, Wo, Wo, Wo, Wo, Ww, Ww, Ww, Wo, Ww, Wo, Ww, Wwr, Wo, Ww, Ww, Ww, Ww, Ww, Ww, Ds, Ds, Ds, Ds, Gd, Gs, Gd, Gs, Gs, Re^Vct, Gd, Gs, Gs, Gd, Hh, Hh
Wo, Wo, Wo, Wo, Wo, Wo, Wo, Wo, Wo, Wo, Wo, Wo, Wo, Wo, Wo, Wo, Wo, Wo, Wo, Wo, Wo, Wo, Wo, Wo, Wo, Wo, Wo, Wo, Wo, Ww, Ww, Ww, Wo, Ww, Wo, Ww, Wo, Wwr, Ww, Wo, Wo, Ww, Ww, Ww, Ds, Ds, Ds, Gd, Gd, Gd, Gd, Gd, Gd, Gd, Gd, Gs, Gs, Gd, Hh, Hh
Wo, Wo, Wo, Wo, Wo, Wo, Wo, Wo, Wo, Wo, Wo, Wo, Wo, Wo, Wo, Wo, Wo, Wo, Wo, Wo, Wo, Wo, Wo, Wo, Wo, Wo, Wo, Wo, Wo, Wo, Wo, Ww, Ww, Ww, Ww, Ww, Wo, Ww, Ww, Wwr, Wwr, Ww, Ww, Ww, Ww, Ds, Ds, Ds, Gs, Gs, Gs, Gs, Gs, Gs, Gs, Gd, Gs, Hh, Hh, Hh
Wo, Wo, Wo, Wo, Wo, Wo, Wo, Wo, Wo, Wo, Wo, Wo, Wo, Wo, Wo, Wo, Wo, Wo, Wo, Wo, Wo, Wo, Wo, Wo, Wo, Wo, Wo, Wo, Wo, Wo, Wo, Wo, Wo, Ww, Ww, Ww, Ww, Wo, Wwr, Wo, Wo, Ww, Ww, Ww, Ww, Ds, Ds, Ds, Gd, Gs, Gd, Gd, Gs, Gd, Gs, Gs, Hh, Hh, Hh, Hh
Wo, Wo, Wo, Wo, Wo, Wo, Wo, Wo, Wo, Wo, Wo, Wo, Wo, Wo, Wo, Wo, Wo, Wo, Wo, Wo, Wo, Wo, Wo, Wo, Wo, Wo, Wo, Wo, Wo, Wo, Wo, Wo, Wo, Ww, Ww, Ww, Ww, Ww, Ww, Ww, Ww, Wo, Ww, Ww, Ds, Ds, Ds, Ds, Gd, Gs, Gs, Gd, Gs, Gs, Hh, Hh, Hh, Hh, Hh, Hh
Wo, Wo, Wo, Wo, Wo, Wo, Wo, Wo, Wo, Wo, Wo, Wo, Wo, Wo, Wo, Wo, Wo, Wo, Wo, Wo, Wo, Wo, Wo, Wo, Wo, Wo, Wo, Wo, Wo, Wo, Wo, Wo, Wo, Wo, Ww, Ww, Wwr, Wwr, Ww, Ww, Wo, Wo, Ww, Ds, Ds, Ds, Ds, Ds, Gd, Gs, Gs, Gd, Gs, Gs, Hh, Hh, Hh, Hh, Hh, Hh
