Gs, Gs, Gs, Gs, Gs, Gs, Gs, Gs, Gs, Gs, Ss, Gs, Gd, Gs, Gs, Ss, Gs, Gs, Ss, Gs, Ss, Gs, Gd, Gs, Gs, Gd, Gs, Gs, Gs, Gs, Gd, Gs, Ss, Gs, Ss, Gs, Gs, Gs, Gs, Gs, Ss, Ss, Gs, Gd, Gs, Gs, Gs, Gs, Gs, Gs, Gs, Gs, Gs, Gs, Ss, Gs, Gs, Gs, Gs, Gs, Gs, Gs, Ss, Gs, Gs, Ss, Gs, Gs, Ss, Gd, Gs, Gd, Gs, Gs, Ss, Gd, Gs, Gs, Gd, Gs, Gs, Gs, Gs, Gs, Ss, Gs, Ss, Ds, Wwg, Wwg, Wwg
Ss, Ss, Gd^Em, Ss, Gs, Ss, Ss, Ss, Ss, Ss, Gs, Gs, Gs^Em, Gd, Ss^Vhs, Gs, Ss, Ss, Ss, Ss, Ss, Gs, Gs, Gs, Ss, Gd, Gs^Efm, Ss, Ss, Gs, Ss^Em, Gd^Em, Gs, Ss, Gs, Ss, Ss, Gs, Ss, Gd, Ss, Gs, Cer, Gd, Cer, Cer, Cer, Cer, Cer, Gs, Cer, Gd, Gs, Ss, Ss, Gs, Gd, Gd, Ss, Ss, Gs, Gd, Gs, Gs^Ft, Gs^Ft, Gs^Ft, Gs^Ft, Ss, Gs, Gs, Gd, Gd, Gs, Ss, Gd^Em, Gd, Ss, Ss, Ss, Ss^Em, Ss, Ss, Ss, Ss, Gd, Gd, Ds, Wwg, Wog, Wog, Wwg
Gd, Ss, Gs, Ss, Ss^Em, Gd, Ss, Gd, Gs^Ft, Gs^Ft, Gs^Ft, Ss, Gs, Gs, Ss^Em, Gs, Sm, Ss, Gs, Gs, Gs^Efm, Gs, Ss, Ss, Gs, Gs^Efm, Gd, Ss, Gs, Gs, Gs, Ss, Ss, Gs^Em, Gs, Sm, Ss, Gd, Gd, Gd, Cer, Cer, Rb, Rb, Ss, Ss, Rb, Rb, Rb, Rb, Rb, Cer, Cer, Gs, Gs, Ss, Gs, Ss, Gs, Gs, Ss^Vhs, Gd, Ss, Gs^Ft, Ss, Gs^Ft, Gs^Ft, Gs, Ss, Ss, Gs, Gs^Em, Ss, Gs, Ss, Gs, Ss, Ss, Ss, Ds, Ds, Ss, Ds, Ss, Ss, Ds, Wwg, Wwg, Wog, Wwg, Ds
Ss, Gd, Gs, Ss, Gd, Ss, Ss, Gs, Gs^Ft, Ss, Gs^Ft, Ss, Ss, Ss, Sm, Ss, Ss, Gs, Ss, Gd^Efm, Gd, Gd^Em, Gs, Gs, Ss, Gs, Gs, Gs, Gd, Gd, Ss, Gs, Gs, Ss, Gs^Em, Ss, Gd, Gs, Gs, Gs, Cer, Sm, Rb, Sm, Rb, Rb, Cer, Rb, Ss, Ss, Ss, Rb, Cer, Gs, Gd, Gd, Gs, Gs, Ss, Ss, Gs, Gs, Ss, Gs^Ft, Gs^Ft, Gs^Ft, Gs^Ft, Gs, Gs, Gd^Em, Gs, Ss, Gd, Ss, Gd, Ss, Ds, Ds, Wwg, Wwg, Wwg, Ds, Wwg, Ds, Wwg, Wwg, Wog, Wog, Wwg, Wwg, Ss
Wwg, Ss, Ss, Gs, Ss, Gd^Em, Ss, Ss, Ss, Gs^Ft, Ss, Gs^Ft, Ss, Ss, Ss, Ss^Em, Gs, Ss, Gs, Ss, Ss, Gs, Ss, Ss, Ss, Gs, Gs, Ss, Gs, Ss, Sm, Ss, Ss, Gd, Ss, Ss^Em, Gd, Ss, Ss, Ss, Cer, Rb, Ss, Ss, Sm, Cer, 4 Ket, Cer, Rb, Sm, Sm, Ss, Cer, Gs, Ss, Ss^Vhs, Ss, Ss, Ss, Gs, Gd, Gs, Gll, Gs^Ft, Gs^Ft, Gll, Gs^Ft, Ss, Ss, Gs, Ss, Gs, Ss, Gd, Ds, Ds, Wwg, Wwg, Wog, Wog, Wog, Wwg, Wog, Wwg, Wwg, Wog, Wwg, Wwg, Ds, Ss, Gs
Ss, Wwg, Wwg, Ds, Ds, Gs, Ss, Ss, Ss, Gs^Ft, Gs^Ft, Gs^Ft, Ss, Ss, Ss, Gd, Gd, Ss, Gd, Gd, Ss, Ss^Em, Ss, Gs, Gd, Ss, Gs, Ss, Gs, Gs, Ss, Ss, Gs^Vht, Gd, Ss, Gs, Ss, Ss, Rb, Rb, Sm, Sm, Rb, Rb, Ket, Cer, Cer, Cer, Ket, Rb, Ss, Ss, Rb, Gs, Gs, Ss, Ss, Ss, Gs, Gd, Gs, Gs, Gs^Ft, Gs^Ft, Gll, Gs^Ft, Gs, Gs, Ss, Gd^Em, Gd, Gs, Ss, Ss, Ds, Wwg, Wog, Wog, Wwg, Wwg, Wwg, Wwg, Wwg, Wwg, Ds, Wwg, Ds, Ds, Ss, Ss, Gs
Ss, Ss, Ss, Wwg, Ds, Ss, Ss, Gd, Gd, Gs^Ft, Gd, Gs^Ft, Ss, Ss, Gs, Gd^Em, Gs, Ss, Ss, Gs, Ss, Sm, Ss, Gs, Gs, Gd, Gs, Ss, Gs, Ss, Gd, Ss, Ss, Gs, Ss, Gs, Rb, Rb, Rb, Rb, Cer, Rb, Rb, Rb, Rb, Rb, Sm, Rb, Rb, Sm, Rb, Rb, Cer, Ss, Ss, Ss, Ss, Gs, Ss, Ss, Ss, Ss, Gd, Gs^Ft, Ss, Gs, Ss, Gd, Gs, Gs, Ss, Ss, Ds, Ds, Wwg, Wwf, Wwf, Wwg, Ds, Ss, Ss, Ds, Ss, Ds, Ss, Ds, Ss, Gd, Ss, Gs, Gd
Ds, Ss, Ss, Wwf, Wwg, Ss^Vhs, Wwg, Ds, Ss, Gs, Gd, Gs, Gs, Ss, Gs, Ss, Gd, Gs, Gs, Ss, Ss, Gs, Gs^Em, Ss, Gs, Gd, Ss, Ss, Ss, Gs, Gs, Gs, Ss, Ss, Gs, Gd, Rb, Rb, Sm, Ss, Ss, Cer, Ss, Ss, Sm, Ss, Cer, Ss, Ss, Ss, Ss, Cer, Ss, Ss, Ss, Gs, Gs, Gs, Gd, Gs, Gs, Gs, Gs, Ss, Ss^Em, Gs, Ss^Em, Gd, Gs, Ss, Ds^Vht, Ss, Wwg, Wwg, Wog, Wog, Wwg, Ds, Gd, Ss, Sm, Ss, Sm, Ss, Gs, Ss, Gs, Ss, Ss, Gs, Gd
Ss, Ss, Ds, Ss, Ss, Wwg, Ss, Wwf, Ss, Gs, Gs, Ss, Ss, Gd, Ss, Ss, Gd, Ss, Ss, Gs^Em, Ss, Ss, Ss, Gd, Gs, Gs, Ss, Sm, Ss, Gs, Gs^Em, Ss^Em, Gd, Gs, Ss, Ss, Rb, Rb, Ss, Ss, Gs, Cer, Cer, Sm, Ss, Cer, Ket, Cer, Sm, Rb, Cer, Cer, Gd, Gs, Ss, Gs, Ss, Gd, Gs, Ss, Gs, Ss, Ss, Ss, Ss, Ss, Gs, Ss, Ss, Ss, Ss, Ss, Wwg, Wog, Wwg, Wwg, Ds, Ss, Gs, Ss, Ss, Sm, Ss, Sm, Ss, Gd, Gd, Ss, Gs, Gs, Gs
Ss, Ss, Ds, Ds, Ss, Ss, Ss, Wwg, Ds, Ss, Ss, Ss, Ss^Em, Gs, Gs, Gs^Em, Ss, Ss, Ss, Ss, Gd, Gs^Ft, Gs^Ft, Ss, Gs, Ss^Vhs, Gs, Ss, Gs, Ss, Ss, Gd, Ss, Gs, Ss, Sm, Rb, Rb, Ss, Gs, Gs, Gs, Gs, Gs, Ss, Gs, Gs, Gs, Ss, Gs, Gs, Gs, Ss, Gs, Gs^Em, Gs, Ss, Gd, Ss^Em, Ss, Gs^Em, Ss, Ss^Em, Sm, Ss, Gs^Em, Ss, Gs^Em, Gd, Ss, Ss, Ds, Wwg, Wog, Wwg, Wwg, Ss, Ss, Gs, Ss, Gs, Ss, Ss, Ss, Gs^Em, Gs, Gs, Gs^Ft, Gs^Ft, Gs^Ft, Gs
Wwg, Ss, Ss, Ss, Ss, Ds, Ss, Wwg, Wwf, Ss, Ss, Ss, Sm, Ss, Ss, Sm, Ss, Ss, Ss, Gs, Ss, Gs^Ft, Gd, Ss, Ss, Gs, Gs, Gd, Ss^Em, Gs, Ss, Gs, Gd, Gs, Rb, Rb, Rb, Sm, Ss, Gd, Ss, Gs, Gd, Gs, Gs, Ss, Gs, Gs, Ss, Ss, Gs, Ss, Gs, Ss, Gs, Ss, Gs, Gs, Gs, Gs, Ss, Ss, Sm, Ss, Gd, Gs, Gs, Gs, Gd, Gs, Ss, Wwg, Wog, Wog, Wwg, Ds, Ss, Ss, Ss, Gd, Gd, Gs, Gd, Ss^Em, Ss, Gd, Gs^Ft, Gs^Ft, Gs^Ft, Gs^Ft, Gs
Wog, Wwg, Wwf, Wwg, Wwg, Ds, Ss, Ss, Wwg, Ds, Ss, Ss, Ss, Ss, Gs^Ft, Ss, Sm^Em, Ss, Ss, Gs, Gs, Gs, Ss, Gs, Gs, Ss, Gd, Gd, Gs, Ss, Gs, Ss, Ss, Ss, Rb, Rb, Gd, Ss, Gs^Ft, Gs^Ft, Gs^Ft, Gs^Ft, Gs^Ft, Gd, Gd, Ss, Gs, Gs, Gs, Gs, Gd, Ss, Gs, Gs, Ss, Gs, Gd, Gd, Ss^Em, Ss, Gs, Sm, Ss, Gs, Ss, Ss, Ds, Ss, Ss, Ds, Wwg, Wwg, Wog, Wwg, Ss, Ss, Gs, Gs, Gd, Gs, Gs, Ss, Gs, Gd, Gs, Ss, Gll, Gll, Gs^Ft, Gs^Ft, Gs
Wwg, Wog, Wwg, Wog, Wog, Wwg, Wwg, Ss, Wwg, Wwf, Ss, Ss, Ss, Gd, Ss, Gs, Sm, Sm, Ss, Ss^Em, Ss, Ss, Sm, Ss^Em, Gd, Gs, Gd, Gs^Em, Gd, Gs, Gs, Ss, Gs, Gs, Rb, Rb, Gs, Gs^Ft, Gs^Ft, Gs^Ft, Gs^Ft, Gll, Gll, Gs^Ft, Gs^Ft, Gs, Ss, Ss, Gs, Ss, Gs^Vht, Ss, Gs, Ss, Ss^Em, Gs, Ss, Ss, Gs, Ss, Ss, Gd, Ss, Gs, Ds, Ds, Wwg, Wwg, Wwg, Wwg, Wog, Wwf, Wwg, Wwg, Ss, Ss, Gd^Em, Gd, Gs, Ss, Ss, Gs, Ss, Ss, Gd, Ss, Gs^Ft, Gs^Ft, Gs^Ft, Gs^Ft, Gs
Ss, Wwg, Ss, Wwg, Wwg, Wog, Wog, Wwg, Wog, Wwg, Wwg, Ss^Vhs, Wwf, Ds, Ds, Ds, Ss, Ss, Gs, Ss, Ss, Gs, Ss, Ss, Ss, Ss^Em, Gd, Gs, Ss, Gd, Gs, Gd, Ds, Ss, Ss^Bw|, Rb, Ss, Sm, Ss, Ss, Ss, Gs^Ft, Gs^Ft, Gs^Ft, Gs, Ss, Gs, Ss, Gs, Ss, Gs, Gs, Ss, Ss, Ss, Gs, Gs^Em, Ss, Gs, Ss, Ss, Gs, Ss, Ss, Wwg, Wwg, Wog, Wwg, Wwg, Wog, Wwg, Wwg, Ds, Ss, Ss^Em, Gs, Gs, Ss, Gs, Ss, Gs, Ss, Gs, Ss, Gs^Ft, Gs^Ft, Gs^Ft, Gll, Gll, Gs^Ft, Gs
Ds, Ss, Ds, Ss, Ss, Wwg, Wwg, Wog, Wwg, Wog, Wog, Wwg, Wwg, Wwg, Wwg, Wwf, Wwg, Ss, Gd, Gd, Gs^Ft, Gs, Gs, Gs^Em, Gd, Gs, Ss, Ss, Ds, Ds, Ds, Ds, Wwg, Ds, Ds^Bw|, Ss^Bw|, Wwg, Ss, Ss, Ss, Ss, Gs, Ss, Gs, Ss, Gs, Ss, Ss, Gs, Ss, Gs, Gs, Gs, Ss, Ss, Ss, Ss, Gs, Ss, Ds, Wwg, Ss, Wwg, Wwg, Wwg, Wog, Wwg, Wwg, Wwf, Wwg, Ds, Ss, Ss, Ss, Gs, Gs, Ss, Ss, Gs^Ft, Gs^Ft, Gs^Ft, Gll, Gs^Ft, Gs^Ft, Gs^Ft, Gll, Gll, Gs, Gs, Gs^Ft, Gs
Ss, Ds, Ss, Ds, Ds, Ss, Ss, Wwg, Ss, Wwg, Wwg, Wwg, Wwg, Wwg, Wwg, Wog, Wwg, Ds, Ds, Gs^Ft, Gs^Ft, Gll, Ss, Gd, Ds, Ds, Wwg, Ss^Vhs, Wwg, Wwg, Wwg, Wwg, Wog, Wwg, Wwg^Bw|, Wwg^Bw|, Wwg, Wwg, Wwg, Wwg, Wwg, Ss, Ds, Ds, Ss, Ss, Gs, Gs, Ss, Gs, Ss, Ss, Gs, Ss, Gs, Ss, Ds, Ds, Wwg, Wwg, Wog, Wwg, Wwg, Wwf, Wwf, Wwg, Ds, Ds, Ss, Ss, Ss, Gs, Gs, Ss^Em, Ss, Ss, Gs, Gd, Gs^Ft, Gs^Vht, Gs^Ft, Gs^Ft, Gs^Ft, Gs^Ft, Gll, Gs^Ft, Gs^Ft, Gll, Gs^Ft, Gs^Ft, Ss
Ds, Ss, Ss, Ds, Ds, Ss, Ss, Wwg, Ss, Ss, Ss, Ss, Ss, Ss, Wwg, Wog, Wog, Wwg, Ss, Gs^Ft, Gll, Gs, Ss, Ds, Wwg, Wwg, Wog, Wwg, Wwg, Wog, Wwf, Wog, Wwg, Wog, Wwg^Bw|, Wwg^Bw|, Wwg, Wog, Wwg, Wog, Wog, Wwg, Wwg, Wwg, Wwg, Ds, Ds, Ds, Ds, Gs, Sm, Ss^Em, Ss^Em, Gs, Ss, Ss, Ss, Wwg, Wog, Wog, Wwg, Wwg, Ss, Ss^Vhs, Ss, Ds, Gs, Ss, Gs, Gd, Gs, Gs^Em, Gd, Ss, Gd, Gs, Gs, Gd, Ss, Gs^Ft, Ss, Gll, Ss, Gll, Gs, Gll, Ss, Gll, Gs, Ss, Gs
Ss, Ds, Ss, Ds, Ss, Ss, Wwg, Wwg, Ss^Vhs, Ss, Ds, Ds, Ds, Ss, Ss, Wwg, Wog, Wwg, Wwg, Ss, Ss, Gd, Ds, Ss, Wwg, Wog, Wwg, Wwg, Wwg, Wwg, Ds, Wwg, Ss^Vhs, Wwg, Ds^Bw|, Wwg^Bw|, Ds, Wwg, Ds, Wwg, Wwg, Wog, Wwg, Wwg, Wog, Wwg, Wwg, Wwg, Wwg, Ss, Ss, Ss, Sm, Sm, Ss, Ss, Ss, Wwg, Wog, Wwg, Ds, Ss, Gs, Gs, Ss, Gs^Em, Gd^Em, Gs, Gs, Ss, Ss, Ss, Gd, Ss, Ss, Gd, Ss, Gs, Ss, Gs, Ss, Gs, Gs, Ss, Ss, Gs, Ss, Ss, Ss, Ss, Gs
Ss, Ds, Ss, Ss, Ss, Wwg, Ss, Ds, Ds, Ds, Ds, Ds, Ss, Ss, Ds, Wwg, Wwg, Wog, Wog, Wwg, Wwg, Ds^Vht, Wwg, Wwf, Wwg, Wwg, Ss, Ss, Ss, Ds, Ss, Ss, Ss, Ds, Rb, Ds^Bw|, Ss, Ss, Ss, Ss, Ss, Wwg, Ds, Wwg, Wwg, Wog, Wog, Wog, Wwg, Ss, Wwg, Ss, Ss, Ss^Vhs, Ss, Ss, Wwg, Wwg, Wwf, Wwg, Ss, Ss, Sm, Gs, Ss, Gs, Gs, Ss, Ss, Gs, Sm, Ss, Ss, Gd, Ss, Ss, Gs, Gs, Gs, Gs, Gs, Gs, Gs, Gs, Ss, Gs, Gs, Gs, Ss, Gs, Gs
Ss, Ss, Wwg, Wwg, Wwg, Wwg, Ds, Ds, Ds, Ss, Ss, Ss, Ds, Ss, Ds, Ds, Wwg, Wwg, Wwg, Wog, Wog, Wwg, Wog, Wog, Wwg, Wwg, Ds, Ss, Ss, Ss, Gd, Gs, Ss, Ss, Rb, Rb, Gs, Gd, Gd, Gs, Sm, Ss, Gs, Ds, Ss, Wwg, Wwg, Wog, Wog, Wwg, Wog, Wwg, Wwg, Ss, Ss, Wwg, Wog, Wog, Wwg, Ds, Ss, Sm, Ss, Ss, Gs, Ss, Gs^Em, Gs, Gs, Ss, Ss, Ss, Ss, Gs, Gd, Gs, Ss^Vhs, Gs, Gs, Gd, Gs, Ss, Ss, Gs, Ss, Ss, Gs, Ss, Gs, Ss, Ss
Wwg, Wwg, Ss, Ss, Ds, Ds, Ds, Ds, Ss, Ds, Ss, Ds, Ss, Ss, Ds, Ss, Wwg, Wwg, Ss, Wwg, Wwg, Wog, Wwg, Wwg, Ss, Ds, Ss, Gd, Sm, Gs, Ss, Gs, Gd, Ss, Rb, Rb, Gd, Ss, Ss, Gs, Ss, Ss, Ss, Ss, Ss, Ss, Ss, Wwg, Wwg, Wog, Wog, Wwg, Wwg, Ss, Wwg, Wwg, Wwg, Wwg, Ss, Ds, Gd, Ss, Sm, Ss, Gs, Gs, Gs, Ss, Ss, Gs, Gs, Gs, Gs, Ss, Ss, Gd, Gs, Gs, Gd, Gd, Ss, Ss, Gs, Gs, Gs, Gs, Gs, Gs, Ss, Gs, Gs
Ss, Ss, Ds, Ss, Ss, Ss, Ds, Ss, Ss, Ds, Ds, Ds, Ss, Ds, Wwf, Wwg, Ss, Ds, Ss, Ss, Ss, Wwg, Ds, Ds, Ss, Ss, Sm, Ss, Ss, Ss, Gs, Gs, Ss, Gd, Rb, Rb, Gd, Gs, Ss, Ss, Gs, Sm, Ds, Ss, Wwg, Ss, Wwg, Ss^Vhs, Wwg, Wwg, Wog, Wog, Wog, Wwg, Wwg, Wwg, Ss, Ss, Gs, Gd, Ss, Ss, Gs, Gd, Ss, Ss, Ss, Ss, Gd, Gs, Ss, Ss, Ss, Gs, Ss, Gs, Ss, Ss, Ss, Ss, Ss, Gd, Gd, Ss, Ss, Gs, Ss, Gs, Ss, Ss, Gs
Ds, Ss, Ds, Ds, Ss, Ss, Ss, Ss, Ds, Ss, Ss, Ss, Ds, Ds, Wwg, Ds, Gs^Vht, Ss, Gs, Sm, Ss, Ss, Ss, Ss, Sm, Ss, Ss, Gs, Gs, Gd, Gd, Gd, Ss, Ss, Rb, Rb, Ss, Ss, Gd, Gd, Gs, Ss^Vhs, Ds, Wwg, Wwg, Wwg, Wog, Wwg, Wog, Wog, Wwg, Wog, Wwg, Wwg, Wwg, Wwg, Ss, Gs, Ss, Ss, Gs^Em, Ss, Ss, Ss, Gs, Gs, Gd, Gd, Ss, Ss, Gs, Gs, Gs, Ss, Gs, Gs, Gs, Gd, Gs, Gs, Ss, Ss, Ss, Gs, Gd, Gd, Gs, Gs, Gs, Ss, Gs
Ds, Ss, Ds, Ss, Ss, Ds, Ss, Ds, Ss, Ss, Ds, Ds, Wwg, Wwg, Ds, Ds, Ss, Ss, Gs^Ft, Ss, Ss, Sm, Sm, Ss, Ss^Vhs, Ss, Ss, Ss, Ss, Ss, Ss, Ss, Gs, Gs, Rb, Sm, Ss, Gs, Ss, Ss, Ds, Ds, Wwg, Wwg, Wwg, Wog, Wwg, Wog, Wwg, Wwg, Ss, Wwg, Wwg, Wwg, Wwg, Sm, Ss, Gd, Ss, Ss, Gd^Em, Gs, Gs, Gd, Ss, Gs, Ss, Ss, Ss, Sm, Ss, Gs, Ss, Ss, Gs, Ss, Gd, Gd, Ss, Ss, Gs, Ss, Gs, Ss, Gs, Gs, Gs, Gd, Ss, Ss, Gs
Ss, Ss, Ss, Ds, Ds, Ds, Ss, Ds, Ss, Ds, Wwf, Wwg, Ss, Ss, Ss, Ss, Gs^Ft, Gs^Ft, Gs^Ft, Gll, Gs^Ft, Ss, Ss, Ss, Gd, Gs, Ss, Gs^Ft, Gs^Ft, Gs^Ft, Gs^Ft, Gd, Gd, Ss, Rb, Rb, Gs, Ss, Ss, Ss, Wwg, Wwg, Wog, Wog, Wwg, Wwg, Ss, Wwg, Ss, Wwg, Ss, Ss, Ss, Ss, Ss, Ss, Gs, Gd, Gs, Gs, Ss^Vhs, Gs, Ss, Ss, Gs, Ss, Gs, Ss, Gs, Ss, Gs, Gs, Gd, Gs, Gs, Gs, Ss, Ss, Gs, Gs, Gs^Efm, Gs, Ss, Gs, Gs^Efm, Ss, Gd, Gd, Gs, Gs, Gs
Ss, Ds, Ss, Ss, Wwf, Ss, Wwg, Wwf, Wwg, Wwg, Ds, Ss, Ss, Ss, Gs, Ss, Ss, Gll, Ss, Ss, Ss, Ss, Gd, Gd, Gs, Ss, Gd, Gs^Ft, Gs^Ft, Gs^Vht, Gs, Gs^Ft, Gd, Ss, Rb, Rb, Ss, Ss, Wwg, Wwg, Wwg, Wwg, Wwg, Wwg, Ss^Vhs, Ss, Ss, Ss, Sm, Ss, Gs^Em, Sm, Ss, Ss, Ss, Gs, Gd^Em, Ss, Ss, Gs, Gd, Ss, Gs, Gs, Ss, Gs, Gs, Gd, Gs, Gd, Ss, Gd, Ss, Gs, Ss, Ss, Gs, Gs, Gs^Efm, Gs, Gs, Ss, Gs, Gs, Gs, Gs^Efm, Gs, Gs, Gs^Ft, Gs, Gs^Ft
Ss, Ds, Wwf, Wwg, Ds, Wwg, Ds, Ds, Ds, Ds, Gs, Ss, Gd, Gd, Ss, Gs, Ss, Ss, Ss^Em, Ss, Gs^Em, Ss, Ss, Ss^Em, Ss, Gs, Ss, Gs^Ft, Gll, Ss, Gs^Ft, Gs^Ft, Ss, Ss, Rb, Rb, Ds, Wwg, Wog, Wog, Wwg, Wwg, Ds, Ds, Gd, Ss, Gs, Ss, Ss, Gs, Gs, Gs, Gd, Gs, Gs, Ss, Gd, Ss, Ss, Gs, Gs, Gd, Ss, Ss, Gd, Gs, Ss, Gs, Ss, Gs, Ss, Ss, Ss, Ss, Ss, Ss, Ss, Gs, Ss, Gs, Sm, Ce, Gs, Re^Vct, Gd, Gs, Gs^Ft, Gs^Ft, Gs, Gs^Ft, Gs^Ft
Wwg, Ss, Wwg, Ds, Ss^Vhs, Ss, Ss, Ss, Ss, Ss, Ss^Em, Ss, Gd, Ss, Ss^Em, Ss, Gd, Ss, Ss, Ss, Gs, Gs, Gd, Ss^Em, Ss, Gs, Gd, Gs^Ft, Gs^Ft, Gs^Ft, Rb, Sm, Rb, Rb, Rb, Rb, Ds^Bw\, Wwg, Wog, Wwg, Ds, Ds, Ss, Ss, Gs, Gs, Gd^Em, Gd, Ss, Gs, Ss, Gd, Ss, Gs, Ss, Gs, Ss, Gs, Ss, Ss, Gs, Ss, Gs, Gs, Ss, Ss, Gs, Sm, Ss, Sm, Ss, Ss, Gs, Gs, Gs^Efm, Gs, Gs^Efm, Ss, Gs, Ce, Ce, Ce, 1 Ke, Gd, Gs, Gs^Ft, Gs^Ft, Gs^Ft, Gs^Ft, Gs^Ft, Gs
Ds, Wwg, Ds, Ds, Gd, Gd, Gd, Gs, Gd, Ss^Em, Ss, Gs, Gd, Ss, Gd, Gd, Ss, Gs, Ss^Vhs, Gs, Ss, Gd, Ss, Gs^Em, Gs, Ss, Ss, Gs, Rb, Rb, Rb, Rb, Sm, Rb, Ss, Sm, Ss^Bw\, Wwg^Bw\, Wog^Bw\, Wwg, Ds, Gd, Ss, Gs, Gd^Em, Gd^Em, Gd, Gs, Gs, Gs, Ss, Ss, Gs^Ft, Gll, Gs^Ft, Ss, Gd, Gs, Gs, Gs, Gs, Ss, Gs^Vht, Gd, Gs, Gs, Ss, Ss, Gs, Ss, Ss, Gs, Gs, Ss, Gd, Gd^Efm, Gs, Gs, Gd, Gs, Ce, Ce, Ce, Gd, Gs, Gs^Ft, Gs, Gs^Ft, Gs, Gs, Rb
Ss, Ds, Ss, Ss, Gs, Ss, Gs, Ss, Cer, Gs, Cer, Ss, Gs, Ss, Gd, Ss, Gs, Gd, Gd, Gs, Gd, Ss, Ss, Gd, Gd, Ss^Vhs, Rb, Rb, Rb, Rb, Ss, Ss, Gs, Ss, Gd, Ds, Wwg, Wwg^Bw\, Wog^Bw\, Wwg^Bw\, Ss^Bw\, Ss, Ss, Ss, Gs, Gs, Ss, Ss, Gs, Ss, Gs, Gs^Ft, Gs^Ft, Gs^Ft, Gs^Ft, Gs, Gs, Gs, Ss, Ss, Gs, Ss, Ss, Gd, Ss, Ss, Gs, Gs, Ss, Gs, Gs, Gs, Ss, Gs, Gs^Efm, Re^Vct, Ss, Gs, Rb, Ce, Rb, Ce, Rb, Gs, Rb, Re^Vct, Rb, Gs, Rb, Rb, Rb
Ss, Gd, Gd, Gs, Cer, Ket, Rb, Ket, Sm, Cer, Ss, Ket, Rb, Ss, Cer, Ss, Ss, Ss, Ss, Ss, Gs^Em, Gd, Gs^Em, Ss, Rb, Rb, Sm, Sm, Ss, Ss, Gs, Gd, Ss, Gs^Em, Gd, Ds, Wwg, Wog, Wwg, Ss^Bw\, Ds^Bw\, Sm, Rb, Gs, Ss, Ss, Gs, Gd, Gd, Gs, Ss, Gll, Gs^Ft, Gs^Ft, Gs^Ft, Gd, Gs, Ss, Gd, Gd, Ss, Gs, Gd, Ss, Gd, Gs, Ss, Gs, Ss, Ss, Gs, Ss, Ss, Gs, Gs, Gs, Rb, Rb, Rb, Rb, Rb, Rb, Rb, Rb, Rb, Rb, Rb, Rb, Rb, Rb, Gs
Ss, Gs, Ss, Ss, Cer, Sm, Ss, Ss, Ss^Vhs, Ss, Ss, Sm, Ss, Ket, Rb, Cer, Cer, Gs, Gs, Ss, Ss, Gd, Ss, Ss, Rb, Rb, Gs, Ss, Gs, Ss, Ss^Em, Ss^Em, Ss, Ss, Gd, Ds, Wwg, Wog, Wwg, Wwg, Ds, Rb, Rb, Rb, Rb, Gs, Ss, Gs, Ss, Gd, Ss, Ss, Gd, Gd, Gs, Gs, Gs, Ss, Ss, Gs, Gs, Gs, Gs, Gs, Ss, Gs, Gs, Ss, Gs, Ss, Ss, Gs, Gs, Ss, Rb, Rb, Rb, Rb, Gs, Rb, Gs, Rb, Gs, Rb, Gs^Ft, Rb, Gs^Efm, Rb, Gs^Ft, Gs, Gs
Ss, Ss, Gs, Cer, Sm, Ss, Rb, Rb, Sm, Sm, Ket, Ss, Sm, Ss, Sm, Ss, Ket, Ss, Ss, Gs, Ss, Ss, Sm, Sm, Rb, Rb, Gd, Ss, Gs, Gs^Em, Ss, Gs^Ft, Ss, Ss, Ss^Vhs, Ds, Wwg, Wog, Wwg, Wwg, Ds, Gd, Ss, Rb, Rb, Rb, Rb, Gs, Gs, Gs, Ss, Gd, Ss, Gs, Gd, Gs, Ss, Ss, Gs, Ss, Gs, Ss, Ss, Gs, Ss, Gd, Gs, Ss, Ss, Gs, Ss, Gs, Rb, Rb, Rb, Rb, Gd, Gs, Gd, Gd^Efm, Gd^Efm, Gd, Gd^Efm, Gs, Gs^Ft, Gs, Gs^Ft, Gs^Ft, Gs^Ft, Gs^Ft, Gs
Gs, Gs, Ket, Cer, Sm, Rb, Ss, Sm, Ket, Ss, Cer, Rb, Ket, Rb, Ss, Rb, Rb, Rb, Rb, Gs, Rb, Rb, Rb, Rb, Gd, Gd, Ss, Gs^Em, Gd^Em, Gd, Gs, Ss, Gd, Ds, Wwg, Wwg, Wwg, Wog, Wwg, Ds, Ss, Ss, Gs, Gs, Gs^Em, Rb, Rb, Rb, Rb, Gs^Em, Ss, Ss, Ss, Ss, Ss, Gs, Gd, Gs, Ss, Gs, Ss, Gs, Ss, Gs, Ss, Gs, Gs, Gs, Ss, Gs, Rb, Rb, Rb, Rb, Ss, Gs, Gs, Ss, Ss, Gs, Gs, Gs, Gs, Gs, Gs, Gs^Ft, Gs^Ft, Gs^Ft, Gs^Ft, Gs^Ft, Gs
Ss, Ss, Ss, Sm, Ss, Ss, Ss^Vhs, Ss, Rb, Cer, 2 Ket, Cer, Sm, Ss, Sm, Ss, Ss, Ket, Ket, Rb, Rb, Rb, Gs, Gs, Ss, Gs, Ss^Em, Ss, Ss, Ss, Ss, Ss, Gd, Ds, Wwg, Wwg, Wog, Wog, Wwg, Ss, Ds, Gd, Gd, Gs^Em, Ss, Ss, Ss, Rb, Rb, Sm, Sm, Gs, Gs, Gs^Vht, Gs, Ss, Ss, Gd, Ss, Ss, Gs, Gs, Sm, Ss, Ss, Ss, Gd, Ss, Sm, Rb, Rb, Rb, Gs, Gs, Ss, Gs, Gd, Gs, Gs, Ss, Ss, Ss, Gs, Ss, Gs, Ss, Gs^Efm, Gd, Gs, Ss, Gs
Ss, Ss, Ket, Ss, Rb, Rb, Rb, Sm, Ket, Cer, Cer, Cer, Ket, Sm, Ss^Vhs, Sm, Rb, Ss, Ket, Rb, Gs, Gs, Gs, Ss, Gd, Ss^Em, Gs, Gs, Gd, Gd, Ds, Ss, Ss, Ds, Wwg, Wwg, Wog, Wog, Wwg, Wwg, Ds, Gd, Ds, Gd, Gd, Gs, Gs, Ss, Gs, Rb, Rb, Rb, Rb, Gd^Em, Gs^Ft, Gs^Ft, Gd, Gs, Gs, Gs, Ss, Sm, Ss, Ss, Ss, Gs, Rb, Rb, Rb, Rb, Ss, Ss, Ss, Ss, Ss, Ss, Gd, Gd, Ss, Ss, Gs, Ss, Gs, Gs, Gs^Efm, Gs^Efm, Gd, Gd^Efm, Gs, Ss, Gs
Gs, Gs, Gs, Cer, Sm, Rb, Rb, Rb, Rb, Rb, Ket, Rb, Rb, Rb, Ss, Rb, Rb, Rb, Ket, Sm, Ss, Ss, Gd, Gd, Gs^Em, Gs, Gs, Ss, Ds, Ds, Wwg, Ss, Wwg, Wwg, Wog, Wwg, Wwg, Wwg, Wwg, Wwg, Wwg, Ss^Vhs, Wwg, Ds, Ss, Ss, Gs, Gd, Ss, Ss, Ss, Rb, Rb, Rb, Rb, Gs^Ft, Gs, Ss, Ss, Gd, Rb, Ss, Rb, Gs, Rb, Rb, Rb, Rb, Gd, Gs, Ss, Gs, Gs, Ss, Gs, Ss, Gs, Gs, Ss, Ss, Gs, Gs, Gs, Ss, Gs, Gs, Gs, Gs^Efm, Gs, Gs, Ss
Ss, Gs, Gs, Cer, Cer, Ss, Ss, Sm, Ss^Vhs, Sm, Rb, Sm, Ss, Sm, Ss, Ss, Rb, Ket, Rb, Sm, Gs, Ss, Ss, Ss, Ss, Ss, Ss, Ss, Wwg, Ds, Wwg, Wwg, Wwg, Wog, Wwg, Wwg, Ss, Ss, Wwg, Wwg, Wwg, Wwg, Wog, Wwg, Wwg, Ss, Ss, Gs, Gd, Gs, Gs^Em, Gs, Ss, Rb, Rb, Rb, Sm, Ss, Rb, Rb, Rb, Rb, Rb, Rb, Rb, Rb, Ss, Gs, Gs, Gs^Vht, Gd, Gs, Gd, Gs, Ss, Gs, Ss, Ss, Gs, Ss, Gs, Ss, Ss, Ss, Gs, Ss, Gs, Ss, Ss, Ss, Gs
Gs, Ss, Ss, Gs, Cer, Sm, Rb, Sm, Sm, Ss, Sm, Ss, Rb, Ss, Ss, Ss, Ket, Rb, Gs, Ss, Gd, Ss, Gs^Em, Ss, Ss, Ss, Wwg, Wwg, Wwg, Wwf, Wwg, Wwg, Wwf, Wwg, Ds, Ss, Gs^Vht, Ss, Ds, Wwg, Wwg, Wwg, Wog, Wog, Wog, Wwg, Wwg, Ss, Ds, Ss, Gd, Ss^Em, Ss, Ss, Gs, Rb, Rb, Sm, Rb, Rb, Ss, Sm, Gd, Rb, Gs, Ss, Gs^Ft, Ss, Ss, Ss, Ss, Ss, Gs, Gs, Ss, Ss, Ss, Gd, Gd, Ss, Ss, Gs, Gs, Gd, Ss, Gs, Gd, Gd, Gs, Ss, Gs
Gd, Gs, Ss, Gs, Gs, Ket, Gd, Ket, Cer, Cer, Cer, Ket, Gs, Ket, Cer, Cer, Ss, Gs, Ss, Gs, Ss, Gd^Em, Ss, Gd, Ds, Wwg, Wog, Wog, Wwg, Wwg, Wwg, Wwg, Ds, Ds, Gs, Gs, Ss, Ss, Gd, Ss^Vhs, Ds, Wwg, Wwg, Wog, Wwg, Wog, Wwg, Wwg, Wwg, Ds, Ds, Gd, Gd, Gs, Rb, Rb, Rb, Rb, Gd, Ss, Ss, Ss, Gs, Ss, Gs, Gll, Gs^Ft, Gs^Ft, Ss, Gs, Ss, Ss, Ss, Gs, Ss, Ss, Ss, Gd, Gs, Gs, Ss, Ss, Gs, Gd, Gs, Ss, Gs, Ss, Gs, Gs, Gs
Gd^Em, Gd, Gs, Ss, Ss, Gd, Gd, Gs, Ss, Gs, Gs, Gs, Gs, Ss, Ss, Gs, Ss, Ss, Gd^Em, Gs, Ss, Gs, Ss, Ds, Wwg, Wwg, Wog, Wwg, Ds^Vht, Ds, Ss, Ss, Ss, Gs, Ss, Gs^Ft, Ss, Gs, Gs, Gd, Ss, Ss, Ss, Wwg, Ds, Wwg, Wwg, Wog, Wog, Wwg, Wwg, Ds, Ds^Bw/, Rb, Rb, Rb, Ss, Gs, Ss, Ss, Gd, Gd, Ss, Gs, Ss, Ss, Ss, Ss, Gd, Gs, Gs, Ss, Gs, Ss, Ss, Ss, Ss, Ss, Gs, Ss, Gd, Gd, Ss, Ss, Ss, Gs, Ss, Ss, Gs, Ss, Ss
Gs, Gd^Em, Ss, Ss, Ss, Gs, Ss, Ss, Gs, Ss, Ss, Ss, Ss, Ss, Ss, Gd, Ss, Gs^Em, Gd, Ss, Gs, Gs, Ss, Wwg, Wwg, Wog, Wwg, Wwg, Ds, Sm, Ss, Sm, Ss, Gs, Gd, Gs^Ft, Gd, Ss, Gs, Ss, Gs^Ft, Ss, Wwg, Wwg, Ds, Ss, Ss, Wwg, Wwg, Wog, Wwg^Bw/, Ss^Bw/, Ds^Bw/, Rb, Gs^Em, Ss, Gs, Ss, Ss, Ss, Ss, Ss, Gs, Ss, Gs, Ss, Ss^Em, Gs, Ss, Gd^Em, Gd, Ss, Gs, Gs, Ss, Ss, Ss, Gs, Gs, Gd, Ss^Vhs, Gs, Gs, Gs, Ss, Gs, Ss, Gs, Ss, Gs, Gs
Ss, Ss, Sm, Gs^Em, Gd, Gs, Ss, Ss, Ss^Vhs, Sm, Gs, Gs, Ss, Ss, Ss^Em, Gs, Gs, Ss, Gs, Ss, Gd, Ss, Wwg, Wwg, Wwg, Wwg, Ds, Wwg, Wwg, Ds, Ss, Ss, Gs^Ft, Gd, Gs, Ss, Gs, Gs, Sm, Sm, Sm, Sm, Wwg, Ss, Gd, Gd, Ds, Wwg, Wwg^Bw/, Wog^Bw/, Wog^Bw/, Wwg^Bw/, Ds, Gd, Gs, Gs, Ss, Ss, Gd, Gs^Em, Gs^Em, Gs, Gs, Gd, Gs, Gd^Em, Gs, Gs, Ss, Gs^Em, Gs, Ss, Gs, Gs, Gs, Gs, Ss, Gs, Ss, Gs, Gd, Gd, Ss, Gs, Gs, Gs, Ss, Gs, Gs, Ss, Gs
Gs, Ss, Ss, Gd^Em, Gs, Ss, Sm, Gs, Ss, Ss^Em, Ss, Ss^Em, Sm, Gs, Ss, Gd, Ss, Ss, Gs, Gd, Ss, Ss, Wwg, Wog, Wwg, Ss, Ds, Wwg, Wwg, Sm, Wwg, Sm, Sm, Ss, Ss, Ss, Sm, Ss^Vhs, Wwg, Wwg, Wwg, Wwg, Sm, Sm, Ss, Gd, Rb, Rb, Ss^Bw/, Wwg^Bw/, Wog, Wwg, Ss, Ss, Gd, Ss, Gs^Em, Gs, Gs, Gd, Ss, Ss, Ss, Ss, Ss, Ss, Ss, Ss, Ss, Ss, Gd, Ss, Ss, Gs, Ss, Ss, Gd, Gs, Gs, Gd, Gs, Ss, Gs, Gs, Gs, Ss, Gs, Ss, Gs, Ss, Gs
Gs, Ss, Ss, Gs, Ss, Ss, Ss, Ss, Gs, Gs, Ss, Gs, Ss, Ss, Gs, Gs, Ss, Gs, Ss, Ss, Ss, Wwg, Wog, Wog, Wwg, Ss, Ss, Sm, Sm, Wwg, Wwg, Wwg, Wwg, Wwg, Wwg, Sm, Wwg, Wwg, Wwg, Sm, Ss, Ss, Ss^Em, Gs, Sm, Sm, Rb, Rb, Ss, Wwg, Wog, Wwg, Ss, Ds^Vht, Ss, Gs, Ss, Ss, Gd, Ss, Gd, Gs, Gd^Em, Gs, Gs, Gs, Gd, Gs, Ss, Gs, Gd^Em, Gs^Em, Ss, Gs, Gs, Gd, Ss, Gs, Ss, Ss, Gs, Ss, Gs, Gd, Gd, Gd, Ss, Gd, Gs, Gd, Gs
Gs^Ft, Ss, Gll, Ss, Gs^Ft, Gll, Gs^Ft, Gd, Gs, Ss, Ss^Em, Ss, Gs, Gs, Gd, Ss, Ss, Ss, Ss, Ss, Ds, Wwg, Wog, Wwg, Ds, Ds, Ss, Ss, Gd, Sm, Sm, Wwg, Sm, Ss, Ss, Wwg, Sm, Ss, Sm, Sm, Gs, Ss^Em, Sm, Rb, Rb, Rb, Ss^Vhs, Ds, Ss, Wwg, Wwg, Wwf, Wwg, Ss, Ds, Gd, Gd, Ss, Ss, Gd, Ss, Ss, Gd, Ss, Gs, Ss, Gd, Gd, Ss, Gs, Ss, Gs, Gs, Ss, Gs, Gs, Gs, Ss, Ss, Ss, Ss, Gs, Ss, Gs, Ss, Gs, Gs, Gs, Ss, Ss, Ss
Gs^Ft, Gs^Ft, Gs^Ft, Gs^Ft, Gs^Ft, Gs^Ft, Gs^Ft, Gd, Gs, Gd, Gs, Gs, Gs, Gd, Gs, Gd, Gs, Gs, Gs, Gs^Vht, Ds, Wwg, Wog, Wwg, Ds, Ss, Gs^Ft, Gs, Ss, Ss, Ss, Ss, Ss, Gs, Ss, Ss, Sm, Ss, Sm, Gs, Rb, Rb, Rb, Rb, Gs, Gs, Gs, Ss, Ss, Ds, Wwg, Wog, Wog, Wwg, Wwg, Ds, Gd, Gs, Ss, Gs^Em, Ss, Gs, Gs, Ss, Gs^Em, Ss, Ss, Gs, Ss, Gs, Gs, Gs, Ss, Ss, Gd, Ss, Gs, Ss, Ss, Gs, Gs, Gs, Gs, Ss, Gs, Ss, Gd, Ss, Ss, Ss, Ss
Gs^Ft, Gs^Ft, Gll, Gs^Ft, Gs^Ft, Gll, Ss, Ss, Ss, Ss, Ss, Ss, Gs, Ss^Em, Ss, Gs, Ss, Ss, Ss, Ds, Wwg, Wwg, Wwg, Wwg, Ds, Gs^Ft, Gs^Ft, Gs^Ft, Gd, Ss, Ss^Em, Sm^Em, Ss, Gd^Em, Ss, Gs, Ss, Sm, Cer, Sm, Rb, Rb, Cer, Gs, Ss, Ss, Gs, Gs, Gd, Ds, Ds, Wwf, Wwg, Wog, Wwf, Ds, Ss, Ss, Gd, Gs, Gs, Ss, Gs, Gs^Em, Ss, Ss, Ss, Gs, Ss, Ss, Gd^Em, Gd, Ss, Gs, Gd, Ss, Ss, Ss, Ss, Ss, Ss, Gd, Ss, Gs, Ss, Ss, Gd, Ss, Gs, Gs, Gs
Gs^Ft, Gs^Ft, Ss, Gll, Ss, Gs^Ft, Gs, Ss, Gs, Gs, Ss, Gs, Gd, Gs^Em, Gs, Gs, Ss, Ss, Ss, Wwg, Wog, Wwg, Wwg, Ds, Ss, Gs^Ft, Gs^Ft, Ss, Gd, Ss^Em, Gs, Ss, Gd, Ss, Gs, Gs, Rb, Cer, Rb, Cer, Rb, Cer, Ss, Cer, Ds, Ss, Ss, Ss^Em, Ss^Em, Gd, Gd, Ss^Vhs, Ds, Wwg, Wog, Wwg, Wwg, Ds, Ds, Ss, Gs, Ss, Gd, Ss, Gs^Ft, Gs^Ft, Gs^Ft, Ss, Gd, Gd, Gs^Em, Gs, Ss, Gs, Ss, Gs, Gs, Gs, Ss, Sm, Ss, Gs, Gs, Gs, Gd, Ss, Gs, Ss, Ss, Ss, Ss
Ss, Gll, Ss, Ss, Gd, Gd, Ss, Gs, Ss, Gd, Ss^Em, Ss^Em, Gs, Gd, Gs, Ss, Ss, Ss, Wwg, Wwg, Wog, Wwg, Ds, Ds, Ss, Ss, Ss, Ss, Ss, Ss, Gs, Gs, Ss, Gs, Cer, Cer, Ss, Rb, Ss, Rb, Ket, Ss, Ss, Ds, Ss, Cer, Cer, Sm, Ss, Gs, Ss^Em, Gd, Ds, Wwg, Wwg, Wog, Wog, Wwg, Wwg, Ss, Ss, Gd^Em, Gs, Ss, Gs^Ft, Gs^Ft, Gs^Ft, Gs^Ft, Gs^Ft, Ss, Ss, Gs, Ss, Ss, Gs, Ss, Gs, Ss, Gs, Ss, Gs, Ss, Ss, Gs, Gs, Ss, Gs, Gs, Ss, Ss, Ss
Gs, Ss, Ss, Ss, Gs, Gd, Gs, Ss, Ss, Gd, Gs, Gd, Ss, Ss, Gd, Gs, Ss, Ds, Wwg, Wog, Wwg, Wwg, Ss, Ss, Sm, Ss, Gs, Gs, Gs, Gd, Ss, Ss, Gs, Cer, Rb, Ss, Rb, Rb, Ket, Sm, Cer, Sm, Ket, Ds, Ss, Ss, Ss, Cer, Gs, Gs, Gs, Ss, Gd, Ss, Ss, Wwg, Wwg, Wog, Wwg, Ds, Ss, Gs, Ss, Gs^Ft, Gs^Ft, Gs^Ft, Gs^Ft, Gs^Ft, Ss, Gs, Gs, Ss, Gs, Gd, Ss, Gs, Gs, Ss, Gs, Gs, Ss, Gs, Ss, Gs, Ss, Gs, Ss, Gs, Gs, Gs, Gs
Ss, Gs, Gs, Gs, Ss^Em, Ss, Gs, Ss^Em, Gd^Em, Ss, Ss, Ss, Ss^Em, Gs, Ss, Gs, Ss, Ds, Wwf, Wwg, Wwg, Ss^Vhs, Ss, Sm, Ss, Ss, Gd, Ss, Gs, Gd, Ss, Gs, Gs, Cer, Rb, Sm, Ss, Sm, Ss, Cer, 3 Ket, Cer, Rb, Ss, Rb, Sm, Rb, Cer, Ss, Ss, Ss, Gs, Gs, Ss, Ds, Ss, Wwg, Wog, Wwg, Wwg, Ss, Ss, Gs, Ss, Ss, Gs^Ft, Gd, Gs^Ft, Gs, Gs, Ss, Ss, Ss, Gd, Gd, Ss, Ss, Gs, Gs, Ss, Ss, Gs, Ss, Gs, Gs, Gs, Ss, Ss, Gs, Ss, Gs
Gd^Em, Gd, Ss, Ss, Gs, Gs, Ss, Gd, Ds, Ds, Wwg, Ss, Ss^Vhs, Ss, Ss, Sm, Ss, Wwg, Wwg, Wwg, Wwf, Ds, Gs, Gd, Gs, Gs, Ss, Ss, Gs, Ss, Gs, Gs, Ss, Cer, Ss, Ss^Vhs, Rb, Rb, Ket, Cer, Cer, Cer, Ket, Rb, Rb, Rb, Ss, Cer, Rb, Ss, Gs, Gs, Gs, Ss, Ds, Wwg, Ss, Wwg, Wwg, Wwg, Ds, Gd, Gs, Gd, Gs, Gd, Ss, Gd, Ss, Gd, Ds, Ds, Wwg, Ds, Ds, Ds, Ds, Ss, Gd, Ss, Gs, Ss, Gs, Gs, Gd, Ss, Gd, Ss, Ss, Gs, Ss
Ss, Gs^Em, Ss, Gs, Ss, Gd, Ss^Vhs, Ss, Wwg, Wwf, Ss, Wwg, Wwf, Wwg, Wwg, Ss, Wwg, Wwg, Wwg, Wwg, Ds, Ss, Sm, Ss, Gd, Ss, Gs, Gs, Ss, Ss, Gs, Gs, Gs, Rb, Sm, Sm, Rb, Rb, Rb, Rb, Ket, Ss, Rb, Rb, Ss^Vhs, Sm, Rb, Rb, Ss, Ss, Ss, Gs, Gs, Gd, Ss, Wwg, Ss, Wwg, Wwg, Wwf, Wwg, Ss, Sm, Gs, Gd, Gd, Ds, Ds, Wwg, Ds, Wwg, Wwg, Ss, Wwg, Wwg, Wwg, Wwg, Ds, Ss, Gs, Ss, Ss, Ss, Ss, Ds, Ds, Ss, Gs, Gd, Ss, Gs
Gd, Ss, Ds, Ss, Ds, Ds, Wwg, Wwg, Ss, Ss, Ds, Ss, Ds, Ss, Ss, Wwg, Wog, Wog, Wog, Wwg, Ss, Ss, Ss^Em, Ss, Ss^Em, Gd, Ss, Ss, Gd, Gd^Em, Ss, Gs, Ss, Cer, Cer, Ss, Ss, Rb, Ss, Rb, Ss, Rb, Sm, Rb, Sm, Rb, Cer, Cer, Gd, Gs, Gs, Gs, Gs^Em, Ss, Wwg, Wwg, Ss^Vhs, Ss, Wwf, Wwg, Wwg, Ss, Ss, Ss, Ds, Ss, Wwg, Wwg, Ss, Wwg, Ss, Ss, Gd, Ss, Ds, Ds, Ds, Wwg, Wwg, Ss, Wwg, Ds, Wwg, Wwg, Wwg, Wwg, Wwg, Ss, Ds, Gd, Ss
Ds, Ds, Wwf, Ss, Wwg, Wwg, Ss, Ss, Ds, Ds, Ds, Ss, Ss, Ds, Ss, Wwg, Wog, Wog, Wwg, Wwg, Ds, Ss^Em, Gs, Ss, Ss, Ss^Em, Ss, Gs, Gd, Gs^Em, Ss, Ss, Gs, Gs, Cer, Ss, Cer, Ss, Sm, Sm, Cer, Ss, Ss, Rb, Cer, Ss, Cer, Gs, Gs, Gd^Em, Gs, Ss, Ss, Ss, Ss, Wwg, Ds, Ds, Ds, Wwg, Wog, Wwg, Wwg, Wwg, Wwg, Ss^Vhs, Wwg, Ss, Ss, Ds, Ds, Gd, Ds, Gd, Gd, Ss, Ss, Ds, Ss, Wwg, Ds, Wwg, Ds, Wwg, Ss, Ss^Vhs, Ds, Wwg, Wwg, Ds, Ss
Wwg, Wwg, Ss, Wwg, Ss, Ss, Ss, Ds, Ss, Ss, Ss, Ds, Ss, Ds, Wwg, Wwg, Wwg, Wwg, Ss^Vhs, Wwg, Wwg, Ds, Gd, Ss, Sm, Ss, Gs, Gd^Em, Ss^Em, Gs, Ss^Em, Gs, Gs, Ss, Gs, Cer, Gs, Cer, Gs, Cer, Gd, Cer, Gs, Cer, Gs, Cer, Gs, Gs^Em, Gs, Ss, Gs, Ss, Ss, Sm, Ds, Wwg, Ss, Ss, Ss, Wwg, Wwg, Wog, Wwg, Wwg, Wog, Wwg, Wwg, Wwg, Wwg, Ss, Wwg, Ss, Wwg, Ds, Ds, Ss, Ds, Ss, Gs, Ss, Ss, Ds, Ss, Ds, Ss, Gd, Ss, Ss, Wwg, Ss, Ds
Wwg, Ss, Ss^Em, Ss^Em, Ss, Ds, Ds, Ss, Ds, Ds, Ss, Ds, Ss, Wwg, Wog, Wwg, Ss, Ss, Ss, Ss, Wwg, Ss, Ss, Sm, Ss, Ss, Ss, Gs, Ss, Gs, Gs^Em, Ss, Ss, Ss, Gs, Ss, Ss, Gs, Ss, Gs, Gs, Gd, Gd, Gs, Ss, Ss, Gs^Em, Ss^Em, Gs, Ss, Gs, Gs, Ss, Ds, Wwg, Wwg, Ds, Ss, Gd, Ds, Ds, Wwg, Ss, Wwg, Wwg, Wwg, Wwg, Wog, Wog, Wwg, Ss, Wwg, Wwg, Wwg, Wwg, Ss, Ss, Ss, Ss, Gs, Gd, Ss, Gs, Ss, Ss, Gs, Ss, Ss, Ds, Wwg, Wwg
Ss, Ss, Ds, Ds, Ss, Ss, Ss, Ss, Ss, Ds, Ss, Ss, Wwg, Wwg, Wog, Wwg, Ss, Ds, Ss^Em, Ss, Wwg, Ds, Ds, Ss, Gs, Gs, Gs, Gs, Gs, Gs, Gd, Ss, Gd, Gs, Ss, Gs, Gd, Gs, Gs, Gs, Ss, Gs, Ss^Em, Gs, Gs^Em, Gs, Gs, Gs, Gs, Ss, Ss, Gd, Ds, Ds, Wwg, Ds, Gd, Ss^Em, Gs^Em, Ss, Ss, Ss, Wwg, Wwg, Ss, Ds, Ss, Wwg, Wog, Wwg, Wwg, Ss, Ds, Ds, Ss, Wwg, Ds, Ss, Ss, Gd, Ss, Gs, Ss, Ss, Ss, Gs, Ss, Gd, Gd, Ds, Ds
Ss, Ds, Ss, Ss, Ds, Ds, Ss, Ss, Ss, Ss, Wwg, Wwg, Wog, Wog, Wwg, Wwg, Ss, Ds, Ds, Ss^Em, Ss, Wwg, Ss, Ss, Gs, Ss, Ss, Gs, Ss, Gd, Gs, Ss, Gs, Gs^Em, Gd, Gd, Gs, Gd, Gs, Gs, Ss, Gs, Gs, Ss, Ss, Gs, Ss, Ss, Gs, Ss, Ss, Ss, Wwg, Wwg, Ss, Ds, Ss, Gs, Ss, Ss, Sm, Ds, Wwg, Ss, Ss, Ds, Ss, Wwg, Wwg, Wog, Wwg, Ds, Ss, Ss, Ds, Wwg, Wwg, Ds, Ds, Gd, Ss, Ss, Gs, Gs, Ss, Ss, Ss, Ss, Ss, Ss, Gs
Ss, Ds, Ds, Ds, Ds, Ds, Ss, Ss, Wwg, Wwg, Wog, Wog, Wwg, Wwg, Ss, Ss, Ds, Ss, Ds, Ss, Ss, Wwg, Wwg, Ds, Ds, Gs, Ss, Sm, Ss, Gd, Gs^Em, Ss, Gd, Ss, Gs, Gs^Em, Gs, Ss, Gs^Em, Gs, Gll, Gs^Ft, Gs^Ft, Gll, Gs^Ft, Ss, Gs, Gs, Gs, Ss, Ds, Wwg, Ds, Ds, Ss, Ss, Ss, Gd^Em, Gs, Ss, Ss, Ds, Wwg, Ss, Ss, Ss^Vhs, Sm, Ss, Wwg, Wog, Wwg, Ds, Ss, Ss, Ss, Ds, Ds, Wwg, Ds, Ss, Ss, Ss, Ss, Sm, Ss, Ss, Gs, Ss, Ss, Ss, Ss
Ss, Ss, Ds, Ss, Ss, Ss, Ss, Wwg, Wog, Wog, Wwg, Wwg, Ss, Ss, Ds, Ds, Ds, Ds, Ds, Ss, Ss, Ss, Ss, Wwg, Ss, Ss, Gs, Ss, Ss, Ss^Em, Gs, Ss, Gs, Gs, Gs, Ss, Gs, Gs^Em, Ss, Ss, Gs^Em, Gs^Ft, Gll, Gs^Ft, Gll, Gs^Ft, Gs, Ss, Ss, Ss, Wwg, Wwg, Ss, Gd, Gd, Sm, Ss^Em, Gd, Ss, Sm, Ss, Ds, Wwg, Ds, Ss, Sm, Ss, Ss, Wwg, Wog, Wwg, Ds, Gd, Gs, Gs, Ss, Ss, Wwg, Wwg, Ds, Ss, Sm, Ss, Ss, Gd, Gs, Ss, Gd, Gs, Gs, Gs
Ss, Ss, Ds, Ds, Ss, Ss, Ss, Wwg, Wwg, Wwg, Ss, Ss, Ss, Ds, Ss, Ds, Ss, Ss, Ss, Ds, Ds, Ss, Ss, Wwg, Wwg, Ds, Gs, Gs, Gs, Gs, Ss, Ss, Gs, Ss, Gs, Gs, Gs, Gs, Gs^Ft, Gs^Ft, Gs^Ft, Gll, Gs^Ft, Gs^Ft, Gs^Ft, Gs^Ft, Ss, Ss, Ss, Ds, Wwg, Ds, Ss, Ss, Gs, Gs, Gs, Ss, Gs, Ss, Gs, Wwg, Wwg, Ds, Gs, Ss, Ss, Ds, Wwg, Wog, Wwg, Ss, Ss, Gs, Gs, Gs, Ss, Ds, Wwg, Ds, Gs, Ss, Gs, Gs, Gs, Gs, Gs, Gs, Gs, Ss, Gs
