Ss, Gg, Ss, Gg, Ds, Gg, Sm, Gg, Ww, Ww, Ss, Gg, Ss, Ss, Ss, Ss, Ss, Gg, Sm, Gg, Sm, Gg, Ss, Gg, Ss, Gg, Ss, Gg, Gs, Gs, Gg, Gg, Sm, Gg, Ss, Gg, Ss, Gg, Sm, Gg, Sm, Gg, Sm, Gg, Ss, Ww, Ww, Ww, Ss, Gg, Sm, Gg, Ss, Gg, Ss, Gg, Sm, Gg, Gs, Gs, Ww, Ww, Ss, Ss, Ss, Gg, Sm, Gg, Ss, Gg, Gs, Gg, Ss, Gg, Gg
Sm, Sm, Ss, Sm, Ss, Ss, Sm, Sm, Ww, Ww, Sm, Sm, Ss, Sm, Ss, Sm, Sm, Sm, Ds, Ss, Ss, Ss, Ss, Ss, Ss, Ss, Gg, Ss, Gs, Gg, Ss, Ss, Ss, Ss, Gd, Ss, Ss, Ss, Gd, Ss, Ss, Ss, Ss, Ss, Ww, Ww, Ww, Ww, Ss, Ss, Ss, Ss, Ss, Ss, Gs, Ss, Ss, Ss, Ss, Ww, Ww, Ww, Ss, Ss, Ss, Ss, Gd, Ss, Ss, Ss, Ss, Gs, Sm, Ss, Ss
Gg, Ss, Ds, Ss, Sm, Ss, Ww, Ww, Ww, Ww, Ds, Ds, Sm, Ds, Sm, Sm, Ds, Ss, Ss^Vhs, Gg, Gs, Gs, Gs, Gg, Gg, Ss, Ss, Gs, Ss, Gg, Ss, Gs^Vht, Ss, Gs, Ss, Ss, Gg, Ss, Ss, Ss, Gg, Ss, Ww, Ww, Ww, Ww, Ww, Ww, Ss, Ss, Ss, Ss, Gs, Ss, Gg, Ss, Ss, Sm, Ss, Ww, Ww, Ss, Ss, Ss, Gs, Ss, Ss, Ss, Ss, Ss, Sm, Ss, Ss, Ss, Gg
Sm, Sm, Ss, Ss, Ss, Ss, Ww, Ww, Ss, Ss, Sm, Ds, Ss, Ss, Ss, Ss, Ss, Ss, Gg, Gs, Gg, Gg, Gg, Gs, Gg, Gg, Gg, Gg, Gg, Ss, Gg, Ss, Gs, Gs, Gs, Gs, Gs, Gs, Gs, Gs, Gg, Ww, Ww, Ww, Ww, Ww, Gs^Fds, Ss, Sm, Ss, Gs, Gs, Sm, Gs, Gs, Gg, Gg, Gs, Gs, Ww, Ww, Ss, Ss, Ss, Gs, Gs, Ss, Ss, Ss, Gs, Ss, Ss, Gs, Ss, Ss
Sm, Ss, Ds, Ss, Sm, Ss, Ww, Ww, Sm, Ss, Sm, Ss, Sm, Ds, Ss, Gd, Ss, Gg, Gg, Gg, Gs, Gg, Gg, Gg, Gg, Gg, Gg, Gg, Gg, Gg, Gg, Gs, Gg, Gs, Gg, Gg, Gg, Gg, Gg, Gg, Ww, Ww, Ww, Ww, Gs^Fds, Gs^Fds, Ss, Ss, Ss, Ss, Gg, Ss, Gg, Ss, Gg, Ss, Ss, Gs, Ss, Ww, Ww, Ww, Ww, Ss, Gg, Ss^Vhs, Ss, Gg, Gs, Gs, Gs, Gs, Gg, Sm, Ss
Gg, Sm, Ds, Ss, Ss, Ds, Ww, Ww, Ss, Ss, Ss, Ss, Sm, Ss, Gd, Sm, Ss, Gg, Gg, Gg, Gs, Gs, Gg, Gs, Gg, Gs, Gs, Gs, Gg, Gs, Gs, Gg, Gs, Gg, Gs, Gs, Gs, Gg, Gs, Gs^Vht, Wwf, Ww, Ww, Gs^Fds, Gs^Fds, Ss, Gs^Fds, Gs, Gs, Gg, Gs, Gs, Gs, Gg, Gs, Ss, Gs, Ss, Gll, Ss, Gs, Ww, Ww, Ww, Ww, Gg, Gg, Gg, Gs, Gs, Gg, Gg, Gg, Ss, Gg
Sm, Ss, Sm, Ss, Sm, Ss, Ww, Ww, Ss, Ss, Ss, Ds, Ss, Sm, Ss, Ss, Gg, Gg, Gs, Gg, Gs, Gg, Gg, Gs, Gs, Gs, Gg, Gg, Gg, Gg, Gs, Gs, Gg, Gg, Gs, Gs, Gs^Fds, Gs, Gs^Fds, Ww, Ww, Ww, Ww, Gs^Fds, Gs, Gs^Fds, Gs, Gs, Gg, Gs, Gs, Gs, Gg, Gg, Gs, Gs, Gs^Fds, Gll, Gs^Fds, Gs, Gs^Fds, Gs, Gll, Ww, Wwf, Wwf, Gg, Gg, Gs, Gg, Gs, Gg, Gs, Gg, Gg
Gg, Ss, Ss, Ss, Gs^Fds, Ds, Ww, Ww, Ds, Ss, Gs^Fds, Ss, Gs^Fds, Ss^Vhs, Gs, Gg, Gg, Gs, Gs^Fds, Gs, Gs^Fds, Gg, Gg, Gs, Gs^Fds, Gs, Gs, Gg, Gg, Gg, Gg, Gg, Gg, Gg, Gs, Gs^Fds, Gs^Fds, Gs^Fds, Ww, Ww, Ww, Wwf, Gs^Vht, Gs, Gg, Gg, Gg, Gg, Gg, Gs, Gg, Gg, Gg, Gs, Gs^Fds, Gs^Fds, Gs^Fds, Gs^Fds, Gs^Fds, Gs^Fds, Gs^Fds, Gs^Fds, Gs^Fds, Gll, Ww, Ww, Gs, Gs, Gs^Fds, Gs, Gs^Fds, Gs, Gs^Fds, Gs, Gs^Fds
Ds, Ss, Ss, Ss, Ds, Ss, Ww, Ww, Ww, Ds, Gs^Fds, Gs^Fds, Gs^Fds, Gs, Gg, Gs, Gg, Gs, Ds, Gs^Fds, Ds, Gs, Gs^Fds, Gs^Fds, Gs^Fds, Gs^Fds, Ds, Gs, Gs, Gs, Gs, Gg, Gs, Gs, Ds, Gs^Fds, Ww, Ww, Ww, Ww, Ww, Ww, Gs, Gg, Gg, Gs, Gg, Gs, Gs, Gg, Gg, Gg, Gg, Gs, Gs^Fds, Gs^Fds, Gs^Fds, Gll^Vht, Gs^Fds, Gs^Fds, Gs^Fds, Gs^Fds, Gs^Fds, Gs^Fds, Ww, Ww, Gs, Gs^Fds, Gs^Fds, Gs^Fds, Gll, Gs^Fds, Gll, Gll, Gs^Fds
Ww, Ds, Ww, Ds, Ww, Ds, Ds, Ww, Ww, Ds, Ds, Ds, Ds, Gs, Gg, Gs, Ww^Bsb|, Ds, Ww, Ds, Ww, Ds, Ww, Gs^Fds, Ww, Gs^Fds, Ww, Ds, Ds, Ds, Ds, Gs, Ds, Ds, Ww, Wwf, Ww, Wwf, Ww, Ww, Gs^Fds, Gs^Fds, Gs^Fds, Gs, Gg, Gg, Gs, Gs, Gg, Gg, Gs, Gg, Gs, Gs, Gs, Gs^Fds, Gs, Gs^Fds, Gs, Gs^Fds, Gs^Fds, Gs^Fds, Gs^Fds, Gll, Ww, Ww, Gg, Gll, Gs^Fds, Gll^Vht, Gs^Fds, Gll, Gs^Fds, Gs^Fds, Gs^Fds
Ww, Ww, Ww, Ww, Ww, Ww, Ww, Ww, Ww, Ww, Ww, Ww, Ww, Ww, Ww^Bsb|, Ww, Ww, Ww, Ww, Ww, Ww, Ww, Ww, Ww, Ww, Ww, Ww, Ww, Ww, Ww, Ww, Ss^Vhs, Ww, Ww, Ww, Ww, Ds, Ds, Ds, Gs^Fds, Ds, Gs^Fds, Gs^Fds, Gs, Gg, Gg, Gs, Gg, Gs, Gg, Gg, Gg, Gs, Gs, Gg, Gs, Gg, Gs, Gg, Gs, Gg, Gs, Gs, Gs, Ww, Ww, Gg, Gs, Gs, Gs^Fds, Gs, Gs^Fds, Gs, Gs, Gs
Ww, Ww, Ww, Ww, Ww, Ww, Ww, Ww, Ww, Ww, Ww, Ww, Ww, Ww, Ww, Ww, Ww, Ww, Ww, Ww, Ww, Ww, Ww, Ww, Ww, Ww, Ww, Ww, Ww, Ww, Ww, Ww, Ww, Ww, Ww, Ww, Ww, Ww, Ww, Ds, Ww, Ds, Ds, Gs, Gs, Gg, Gs, Gs, Gg, Gg, Gg, Gs, Gg, Gg, Gg, Gg, Gg, Gg, Gg, Gg, Ww, Gg, Ww, Wwf, Wwf, Ww, Gg, Gg, Gg, Gs, Gg, Gs, Gs, Gg, Gg
Wo, Ww, Wo, Ww, Wo, Ww, Wo, Ww, Ww, Ww, Ww, Wo, Wo, Ww, Ww^Bsb|, Ww, Ww, Ww, Ww, Wo, Ww, Ww, Wo, Ww, Ww, Ww, Wo, Ww, Ww, Ww, Ww, Ww, Ww, Ww, Ww, Ww, Ww, Ww, Ww, Ww, Ww, Ww, Ds, Gg, Gs, Gs, Gg, Gs, Gs, Gg, Gg, Gg, Gs^Fds, Gg, Gg, Gg, Gg, Gg, Wwf, Ww, Ww, Ww, Ww, Ww, Gg, Gg, Gs, Gg, Gg, Gg, Gs, Gg, Gg, Gg, Gs
Wo, Wo, Wo, Wo, Wo, Wo, Wo, Ww, Ww, Wo, Wo, Ww, Ww, Wo, Ww^Bsb|, Ww, Ww^Bsb|, Ww, Wo, Wo, Ww, Wo, Wo, Ww, Wo, Ww, Wo, Wo, Wo, Wo, Wo, Ww, Wo, Ww, Wo, Ww, Ww, Ww, Ww, Ww, Ww, Ww, Ww, Ds, Ds, Ds, Ds, Gs, Gg, Gs, Gs^Fds, Gs^Fds, Gs^Fds, Gs^Fds, Ww, Ss^Vhs, Ww, Ww, Ww, Wwf, Gs, Ww, Gg, Gg, Gg, Gs, Gs^Fds, Gs, Gs^Fds, Gs, Gs, Gs, Gs, Gs, Ds
Wo, Wo, Wo, Wo, Wo, Wo, Wo, Wo, Wo, Ww, Wo, Wo, Wo, Wo, Ww, Ww, Ww^Bsb|, Ww, Wo, Ww, Wo, Wo, Ww, Ww, Wo, Wo, Wo, Wo, Wo, Wo, Wo, Wo, Wo, Wo, Wo, Wo, Wo, Wo, Wo, Ww, Ww, Ww, Ww, Ww, Ww, Ww, Ww, Ds, Ds, Ds, Ww, Ww, Ww, Ww, Ww, Ww, Ww, Ww, Gg, Gg, Gs, Gg, Gg, Gg, Gg, Gs^Fds, Gs^Fds, Gs^Fds, Gs^Fds, Gll, Ds, Ds, Ds, Ds, Ww
Wo, Wo, Wo, Wo, Wo, Wo, Wo, Wo, Wo, Ww, Ww, Wo, Wo, Ww, Ww^Bsb|, Ww, Ww, Ww, Ww, Wo, Wo, Ww, Wo, Wo, Wo, Wo, Wo, Wo, Wo, Wo, Wo, Wo, Wo, Wo, Wo, Wo, Wo, Wo, Wo, Wo, Wo, Ww, Ww, Ww, Ww, Ww, Ww, Ds, Ww, Ww, Ww, Ww, Ww, Ww, Gs^Fds, Ww, Gs^Fds, Gs^Fds, Gs^Fds, Gg, Gg, Gg, Gs, Gs, Gs, Gs, Gll, Gs^Fds, Ds, Gs^Fds, Ds, Ww, Ww, Ww, Ww
Wo, Wo, Wo, Wo, Wo, Wo, Wo, Wo, Wo, Wo, Ww, Wo, Wwt, Wwt, Wwt^Bsb|, Wwt, Wwt^Bsb|, Ww, Wwt, Ww, Wo, Ww, Wo, Wo, Wo, Wo, Wo, Wo, Wo, Wo, Wo, Wo, Wo, Wo, Wo, Wo, Wo, Wo, Wo, Wo, Wo, Wo, Wo, Ww, Ww, Ww, Ww, Ww, Ww, Ww, Ds, Ds, Ds, Gs, Gs^Fds, Gs^Fds, Gg, Gg, Gg, Gs^Fds, Gs^Fds, Gs, Ds, Gg, Ds, Gg, Ds, Ds, Ww, Ds, Ww, Ww, Ww, Ww, Ww
Wo, Wo, Wo, Wo, Wo, Wo, Wo, Wo, Wo, Wo, Wo, Wwt, Ds^Vd, Ds, Ds, Ds, Ds, Wwt, Ds, Wwt, Wwt, Wo, Wo, Wo, Wo, Wo, Wo, Wo, Wo, Wo, Wo, Wo, Wo, Wo, Wo, Wo, Wo, Wo, Wo, Wo, Wo, Wo, Wo, Wo, Wo, Ww, Ww, Ww, Ww, Ww, Ww, Ww, Ww, Ds, Ww, Gg, Ww, Gg, Ww, Gs^Fds, Ww, Ds, Ww, Ds, Ww, Ds, Ww, Ww, Ww, Ww, Ww, Ww, Ww, Ww, Wo
Wo, Wo, Wo, Wo, Wo, Wo, Wo, Wo, Wo, Wo, Wo, Wwt, Wwt, Ds, Kvr, Gd, Kvr, Ds, Gd^Vd, Ds, Wwt, Wo, Wo, Wo, Wo, Wo, Wo, Wo, Wo, Wo, Wo, Wo, Wo, Wo, Wo, Wo, Wo, Wo, Wo, Wo, Wo, Wo, Wo, Wo, Wo, Wo, Wo, Ww, Ww, Ww, Ww, Ww, Ww, Ww, Ww, Ww, Ww, Ww, Ww, Ww, Ww, Ww, Ww, Ww, Ww, Ww, Ww, Ww, Ww, Ww, Ww, Ww, Wo, Wo, Wo
Wo, Wo, Wo, Wo, Wo, Wo, Wo, Wo, Wo, Wo, Wo, Wwt, Wwt, Cvr, Re^Edb, Cvr, Re^Edb, Cvr, Gd^Vd, Ds, Wwt, Wo, Wo, Wo, Wo, Wo, Wo, Wo, Wo, Wo, Wo, Wo, Wo, Wo, Wo, Wo, Wo, Wo, Wo, Wo, Wo, Wo, Wo, Wo, Wo, Wo, Wo, Wo, Wo, Ww, Ww, Ww, Ww, Ww, Ww, Ww, Ww, Ww, Ww, Ww, Ww, Ww, Ww, Ww, Ww, Ww, Ww, Ww, Ww, Ww, Wo, Wo, Wo, Wo, Wo
Wo, Wo, Wo, Wo, Wo, Wo, Wo, Wo, Wo, Wo, Wo, Wo, Wwt, Cvr, Re^Edb, Re^Edb, Re^Edb, 2 Kvr, Ds, Ds, Wwt, Wo, Wo, Wo, Wo, Wo, Wo, Wo, Wo, Wo, Wo, Wo, Wo, Wo, Wo, Wo, Wo, Wo, Wo, Wo, Wo, Wo, Wo, Wo, Wo, Wo, Wo, Wo, Wo, Wo, Wo, Wo, Wo, Ww, Wo, Ww, Wo, Ww, Wo, Ww, Wo, Ww, Wo, Ww, Wo, Ww, Wo, Wo, Wo, Wo, Wo, Wo, Wo, Wo, Wo
Wo, Wo, Wo, Wo, Wo, Wo, Wo, Wo, Wo, Wo, Wo, Wo, Wwt, Cvr, Kvr, Cvr, Kvr, Cvr, Ds, Wwt, Wwt, Wo, Wo, Wo, Wo, Wo, Wo, Wo, Wo, Wo, Wo, Wo, Wo, Wo, Wo, Wo, Wo, Wo, Wo, Wo, Wo, Wo, Wo, Wo, Wo, Wo, Wo, Wo, Wo, Wo, Wo, Wo, Wo, Wo, Wo, Wo, Wo, Wo, Wo, Wo, Wo, Wo, Wo, Wo, Wo, Wo, Wo, Wo, Wo, Wo, Wo, Wo, Wo, Wo, Wo
Wo, Wo, Wo, Wo, Wo, Wo, Wo, Wo, Wo, Wo, Wwt, Wwt, Ds, Ds, Gd, Gd^Vd, Gd, Ds, Wwt, Wwt, Wo, Wo, Wo, Wo, Wo, Wo, Wo, Wo, Wo, Wo, Wo, Wo, Wo, Wo, Wo, Wo, Wo, Wo, Wo, Wo, Wwt, Wwt, Wwt, Wwt, Wwt, Wo, Wo, Wo, Wo, Wo, Wwt, Wwt, Wwt, Wo, Wo, Wo, Wo, Wo, Wo, Wo, Wo, Wo, Ww, Ww, Wo, Wo, Wo, Wo, Wo, Wo, Wo, Wo, Wo, Wo, Wo
Wo, Wo, Wo, Wo, Wo, Wo, Wo, Wo, Wo, Wo, Wwt, Wwt, Ds^Vd, Ds, Ds^Bsb|, Ds, Ds^Bsb|, Ds, Wwt, Wo, Wo, Wo, Wo, Wo, Wo, Wo, Wo, Wo, Wo, Wo, Wo, Wo, Wo, Wo, Wo, Wo, Wo, Wo, Wo, Wo, Wwt, Ds, Hh^Fds, Gs^Fds, Gs^Fds, Wo, Wo, Wo, Wo, Wwt, Hh^Fds, Wwt, Gs^Fds, Wwt, Wo, Wo, Wo, Wo, Wo, Wo, Wo, Wo, Wo, Ww, Wo, Wo, Ww, Wo, Wo, Wo, Wo, Wo, Wo, Wo, Wo
Wo, Wo, Wo, Wo, Wo, Wo, Wo, Wo, Wo, Wo, Wwt, Wwt, Wwt, Wwt, Wwt^Bsb|, Wwt, Ww^Bsb|, Wwt, Wwt, Wo, Wo, Wo, Wo, Wo, Wo, Wo, Wo, Wo, Wo, Wo, Wo, Wo, Wo, Wo, Wo, Wo, Wo, Wo, Wo, Wwt, Wwt, Gs^Fds, Gg^Ve, Gg^Ve, Gs^Fds, Wwt, Wwt, Wo, Wo, Wwt, Wwt, Gg^Ve, Gs^Fds, Wwt, Wwt, Wo, Wo, Wo, Wo, Wo, Wo, Wo, Wo, Wo, Wo, Ww, Ww, Ww, Ww, Wo, Wo, Wo, Wo, Wo, Wo
Wo, Wo, Wo, Wo, Wo, Wo, Wo, Wo, Wo, Wo, Ww, Ww, Ww, Ww, Ww, Ww, Ww, Ww, Ww, Ww, Wo, Wo, Wo, Wo, Wo, Wo, Wo, Wo, Wo, Wo, Wo, Wo, Wo, Wo, Wo, Wo, Wo, Wo, Wo, Wo, Wwt, Wwt, Gs^Fds, Ds, Wwt, Gs^Fds, Wwt, Wo, Wo, Wo, Wwt, Ds, Ds, Ds, Wwt, Wo, Wo, Wo, Wo, Wo, Wo, Wo, Wo, Wo, Wo, Wo, Ww, Ww, Ww, Wo, Wo, Wo, Wo, Wo, Wo
Wo, Wo, Wo, Wo, Wo, Wo, Wo, Wo, Wo, Ww, Wo, Ww, Wo, Ww, Ww^Bsb|, Ww, Ww^Bsb|, Wo, Ww, Ww, Wo, Wo, Wo, Wo, Wo, Wo, Wo, Wo, Wo, Wo, Wo, Wo, Wo, Wo, Wo, Wo, Wo, Wo, Wo, Wo, Wwt, Wwt, Gs^Fds, Wwt, Wo, Wwt, Wo, Wo, Wo, Wo, Wo, Wwt, Wwt, Wwt, Wwt, Wo, Wo, Wo, Wo, Wo, Wo, Wo, Wo, Wo, Wo, Wo, Ww, 1 Ww, Ww, Wo, Wo, Wo, Wo, Wo, Wo
Wo, Wo, Wo, Wo, Wo, Wo, Wo, Wo, Ww, Ww, Wo, Ww, Wo, Ww, Ww, Ww, Ww^Bsb|, Wo, Wo, Ww, Ww, Wo, Wo, Wo, Wo, Wo, Wo, Wo, Wo, Wo, Wo, Wo, Wo, Wo, Wo, Wo, Wo, Wo, Wo, Wo, Wo, Wwt, Wwt, Wwt, Wo, Wo, Wwt, Wo, Wwt, Wwt, Wwt, Wo, Wo, Wwt, Wo, Wo, Wo, Wo, Wo, Wo, Wo, Wo, Wo, Wo, Wo, Wo, Ww, Ww, Ww, Wo, Wo, Wo, Wo, Wo, Wo
Wo, Wo, Wo, Wo, Wo, Wo, Wo, Wo, Ww, Wo, Wo, Wo, Ww, Ww, Ww^Bsb|, Ww, Ww, Ww, Wo, Wo, Ww, Wo, Wo, Wo, Wo, Wo, Wo, Wo, Wo, Wo, Wo, Wo, Wo, Wo, Wo, Wo, Wo, Wo, Wo, Wo, Wo, Wwt, Wo, Wo, Wo, Wwt, Ds, Wwt, Gs^Fds, Wwt, Gs^Fds, Wwt, Wo, Wo, Wo, Wo, Wo, Wo, Wo, Wo, Wo, Wo, Wo, Wo, Wo, Ww, Ww, Ww, Wo, Wo, Wo, Wo, Wo, Wo, Wo
Wo, Wwt, Wo, Wo, Wo, Wo, Wo, Ww, Wo, Wo, Ww, Ww, Ww, Ww, Ww^Bsb|, Ww, Ww^Bsb|, Ww, Ww, Wo, Wo, Ww, Wo, Wo, Wo, Wo, Wo, Wo, Wo, Wo, Wo, Wo, Wo, Wo, Wo, Wo, Wo, Wo, Wo, Wo, Wo, Wo, Wo, Wo, Wo, Wwt, Wwt, Hh^Fds, Gs^Fds, Gg^Ve, Hh^Fds, Wwt, Wo, Wo, Wo, Wo, Wo, Wo, Wo, Wo, Wo, Wo, Wo, Wo, Wo, Wo, Wo, Wo, Wo, Wo, Wo, Wo, Wo, Wo, Wo
Ww, Ww, Ww, Ww, Ww, Ww, Ww, Ww, Ww, Ww, Ww, Ww, Ww, Ww, Ww, Ww, Ww, Ww, Ww, Ww, Ww, Ww, Ww, Wo, Ww, Wo, Wo, Wo, Wo, Wo, Wo, Wo, Wo, Wo, Wo, Wo, Wo, Wo, Wo, Wo, Wo, Wo, Wo, Wo, Wo, Wo, Wo, Wwt, Wwt, Gs^Fds, Wwt, Wwt, Wo, Wo, Wo, Wo, Wo, Wo, Wo, Wo, Wo, Wo, Wo, Wo, Ww, Wo, Wo, Wo, Wo, Wo, Wo, Wo, Wo, Wo, Wo
Ww, Ww, Ww, Ww, Ww, Ww, Ww, Ww, Ww, Ww, Ww, Ww, Ww, Ww, Ww^Bsb|, Ww, Ww^Bsb|, Ww, Ww, Ww, Ww, Ww, Ww, Ww, Ww, Ww, Ww, Wo, Ww, Wo, Wo, Wo, Wo, Wo, Wo, Wo, Wo, Wo, Wo, Wo, Wo, Wo, Wo, Wo, Wo, Wo, Wo, Wo, Wo, Wwt, Wo, Wo, Wo, Wo, Wo, Wo, Wo, Wo, Wo, Wo, Wo, Wo, Ww, Ww, Wo, Wo, Wo, Wo, Wo, Wo, Wo, Wo, Wo, Wo, Ww
Ds, Ww, Ww, Ww, Ww, Ww, Ww, Ww, Ww, Ww, Ww, Ww, Ww, Ww, Ww^Bsb|, Ww, Ds^Bsb|, Ww, Ww, Ww, Ww, Ww, Ww, Ww, Ww, Ww, Ww, Ww, Ww, Ww, Ww, Wo, Wo, Wo, Wo, Wo, Wo, Wo, Wo, Wo, Wo, Wo, Wo, Wo, Wo, Wo, Wo, Wo, Wo, Wo, Wo, Wo, Wo, Wo, Wo, Wo, Wo, Wo, Wo, Wo, Wo, Wo, Ww, Wo, Wo, Ww, Wo, Wo, Wo, Wo, Wo, Wo, Ww, Ww, Ww
Gs^Fds, Ds, Ds, Ds, Gs, Gs, Gs^Fds, Ds, Ds, Ds, Ds, Ds, Gg, Gg, Gg, Gg, Gs, Ds, Ds, Ds, Ss, Ww, Ww, Ww, Ww, Ww, Ww, Ww, Ww, Ww, Ww, Ww, Ww, Ww, Ww, Wo, Wo, Wo, Wo, Wo, Wo, Wo, Wo, Wo, Wo, Wo, Wo, Wo, Wo, Wo, Wo, Wo, Wo, Wo, Wo, Wo, Wo, Wo, Wo, Wo, Wo, Wo, Wo, Wo, Wo, Wo, Wo, Wo, Ww, Wo, Ww, Ww, Ww, Ww, Ww
Gs^Fds, Gll, Gs^Fds, Gll, Gs^Fds, Gs^Fds, Gs^Fds, Gs^Fds, Gs^Fds, Gs, Gs, Gs, Gs, Gs, Gg, Gg, Gg, Gs, Gs, Gs, Gg, Ss, Ww, Ww, Ww, Ds, Ds, Ww, Ww, Ww, Ww, Ww, Ww, Ww, Ww, Ww, Ww, Wo, Ww, Wo, Wo, Wo, Wo, Wo, Wo, Wo, Wo, Wo, Wo, Wo, Wo, Wo, Wo, Wo, Wo, Wo, Wo, Wo, Wo, Wo, Wo, Wo, Ww, Wo, Ww, Ww, Ww, Ww, Ww, Ww, Ww, Ww, Ww, Ww, Ds
Gs^Fds, Gs^Fds, Gll, Gs^Fds, Gs^Fds, Gs^Fds, Gll, Gs^Fds, Gs^Fds, Gs, Gg, Gs, Gs^Fds, Gs, Gs, Gg, Gg, Gs, Gs^Fds, Gs^Fds, Gs^Fds, Ss, Ww, Ww, Ww, Ss, Gs, Ds, Ds, Ds, Ds, Ww, Ww, Ww, Ww, Ww, Ww, Ww, Ww, Ww, Ww, Wo, Wo, Wo, Wo, Wo, Wo, Wo, Ww, Wo, Ww, Wo, Ww, Wo, Ww, Wo, Ww, Wo, Ww, Ww, Ww, Ww, Ww, Ww, Ww, Ww, Ww, Ww, Ww, Ww, Ww, Ww, Gs^Fds, Gs^Fds, Gs^Fds
Gll, Gs^Fds, Gs^Fds, Gs^Fds, Gs^Fds, Gll, Gs, Gll, Gs^Fds, Gs, Gg, Gs^Fds, Gg^Ve, Gs^Fds, Gs, Gg, Gg, Gs, Gs, Gs^Fds, Gs^Fds, Gs^Fds, Gll, Ww, Wwf, Ww, Ww, Gs, Gs^Efm, Gs^Vht, Gs, Gs^Fds, Gs^Fds, Ww, Ds, Ww, Ww, Ww, Ww, Ww, Ww, Ww, Ww, Ww, Ww, Ww, Ww, Ww, Ww, Ww, Ww, Ww, Ww, Ww, Ww, Ww, Ww, Ww, Ww, Ww, Ww, Ww, Ww, Ww, Ww, Ww, Ww, Ww, Ds, Ww, Ds, Ds, Gs^Fds, Gs^Fds, Gll
Gs, Gs^Fds, Gs, Gs, Gs, Gs, Gs, Gs^Fds, Gs, Gs, Gs, Gs^Fds, Gll, Gs^Fds, Gs, Gg, Gg, Gg, Gg, Gll^Ve, Gs^Fds, Gs^Fds, Gs, Ds, Ww, Wwf, Wwf, Ds, Gs^Fds, Gg^Efm, Gll^Efm, Gs, Gs^Fds, Gs, Gs, Ds, Ds, Ww, Ww, Ww, Ww, Ww, Ww, Ww, Ww, Ww, Ww, Ww, Ww, Ww, Ww, Ww, Ww, Ww, Ww, Ww, Ww, Ww, Ww, Ww, Ww, Ww, Ds, Ww, Ds, Ww, Ds, Ds, Gs^Fds, Ds, Gs, Gs, Gll, Gs^Fds, Gll
Gg, Gs, Gg^Efm, Gg, Gg, Gg, Gg, Gs, Gg, Gg, Gg, Gs, Gs, Gs, Gg, Gg, Gg, Gg, Gg, Gs, Gs, Gs^Fds, Gs, Gs, Gs^Fds, Ww, Ww, Ww, Gs^Fds, Gs, Gs^Fds, Gs^Fds, Gs^Efm, Gs^Efm, Gll^Efm, Gs, Gs, Ds, Gs^Fds, Gs^Fds, Gs^Fds, Ww, Ds, Ww, Ww, Ww, Ww, Ww, Ds, Ww, Gs^Fds, Ww, Gs^Fds, Ww, Gs^Fds, Ww, Ds, Ww, Ds, Ds, Ds, Ds, Gs, Ds, Gs, Ds, Gg, Gs, Gs^Fds, Gs^Fds, Gs^Fds, Gs^Fds, Gs^Fds, Gs^Fds, Gs^Fds
Gg, Gg^Efm, Gg^Efm, Gg^Ve, Gs, Gg, Gg, Gg, Gs, Gg, Gs^Efm, Gg^Efm, Gg^Efm, Gg, Gg, Gg, Gs, Gs^Efm, Gg, Gg^Efm, Gg, Gs, Gs, Gg, Gll, Gs^Fds, Ww, Ww, Ds, Gs^Fds, Gs, Gg^Efm, Gg, Gs^Fds, Gll, Gs^Fds, Gs^Fds, Gs, Gs, Gll, Gs^Fds, Gs^Fds, Gs, Ds, Ds, Ds, Ds, Ds, Gs, Gs, Gs^Fds, Gs^Fds, Gs^Fds, Gs^Fds, Gs^Fds, Gs^Fds, Gs, Ds, Gs, Gs, Gs, Gs, Gs^Efm, Gg, Gs, Gs, Gg, Gs, Gs, Gs^Fds, Gs^Fds, Gll^Ve, Gs^Fds, Gs^Fds, Gs
Gs, Gs, Gs, Gg, Gs, Gg, Gs, Gs^Efm, Gg^Efm, Gg, Gg, Gs, Gg^Efm, Gs, Gs, Gs, Gg, Gg, Gg, Gg, Gs^Efm, Gs, Gs^Fds, Gs, Gs^Fds, Gs^Fds, Ww, Ww, Ww, Ds, Gll, Gs, Gs, Gs^Fds, Gs^Fds, Gll, Gs, Gs^Fds, Gs, Gs^Fds, Gll, Gs^Fds, Gg, Gs, Gs, Gs, Gs, Gs, Gs, Gs, Gs, Gll, Gs^Efm, Gg^Ve, Gs, Gs^Fds, Gs, Gg, Gg, Gs^Efm, Gs, Gg, Gg, Gg, Gg, Gg, Gg, Gg, Gg, Gs, Gs, Gs^Fds, Gs, Gll, Gs
Gs^Fds, Gs^Fds, Gs^Fds, Gs, Gs^Fds, Gs, Gs^Fds, Gs, Gs, Gg, Gg, Gg, Gs^Efm, Gs, Gg, Gs, Gg, Gs, Gg, Gg, Gs^Efm, Gs^Fds, Gg^Ve, Gs^Fds, Gs^Fds, Gs^Fds, Ww, Ww, Ww, Ds, Gs^Fds, Gs^Fds, Gs^Fds, Gll, Gs^Fds, Gs^Fds, Gll, Gs, Gg, Gg, Gg, Gs, Gg^Efm, Gg^Efm, Gg, Gg^Efm, Gs, Gg, Gs^Efm, Gs, Gs, Gs, Gg^Efm, Gg, Gg, Gs, Gg, Gg, Gs, Gs, Gs, Gs, Gs, Gg, Gs, Gg, Gs, Gg, Gg^Efm, Gg, Gs, Gs, Gg^Efm, Gs, Gg
Gll, Gs^Fds, Gll, Gs^Fds, Gll, Gs^Fds, Gll, Gs^Fds, Gs^Fds, Gs, Gg, Gg, Gs^Efm, Gg, Gg, Gg, Gs, Gs, Gg, Gg^Efm, Gs, Gs^Fds, Gs^Fds, Gs^Fds, Gs^Fds, Gll, Gll, Ww, Wwf, Wwf, Ds, Gs^Fds, Gs^Fds, Gll, Gs, Gll, Gs^Fds, Gs^Fds, Gll, Gs^Efm, Gs^Efm, Gg^Efm, Gs, Gg, Gs, Gs, Gs^Fds, Gs, Gs, Gg, Gg, Gs, Gs, Gg, Gs, Gg, Gg^Efm, Gs, Gs, Gg, Gs, Gg, Gs, Gs, Gs^Fds, Gs, Gs, Gg, Gs^Efm, Gs, Gg, Gg^Efm, Gs^Efm, Gg, Gg
Gs^Fds, Gs^Fds, Gs^Fds, Gs^Fds, Gs^Fds, Gll, Gs, Gll, Gs^Fds, Gs, Gg, Gg, Gg, Gs, Gg, Gg, Gs, Gs^Efm, Gg, Gg, Gg, Gs, Gs, Gll, Gs^Fds, Gs^Fds, Gs, Ds, Ww, Ww, Ww, Gll, Gs^Fds, Gs, Gs, Gs^Fds, Gll, Gs^Fds, Gs^Fds, Gs^Fds, Gs, Gg^Efm, Gs, Gg, Gs, Gs^Fds, Gs^Fds, Gs^Fds, Gs^Fds, Gs, Gs, Gg, Gg, Gs^Efm, Gg, Gg, Gg, Gs, Gg, Gs, Gs, Gs, Gs^Fds, Gs^Fds, Gs^Fds, Gs^Fds, Gs^Fds, Gs, Gs^Fds, Gs^Efm, Gs, Gs, Gs, Gg, Gg
Gs^Fds, Gll, Gs^Fds, Gs^Fds, Gg, Gs^Fds, Gg, Gs^Fds, Gs^Fds, Gs, Gg, Gg, Gg, Gs, Gg, Gg, Gs, Gs, Gg, Gg, Gg, Gg, Gs, Gs^Fds, Gs^Fds, Gs^Fds, Gg, Ds, Ww, Ww, Ww, Ww, Gg, Gs, Gg, Gs^Fds, Gs^Fds, Gll, Gg, Gs^Fds, Gs^Fds, Gg^Efm, Gg, Gg, Gs^Fds, Gs^Fds, Gg, Gs^Fds, Gg, Gs^Fds, Gs^Fds, Gs, Gg, Gg^Efm, Gg, Gg, Gg, Gg, Gg, Gg, Gg, Gs^Fds, Gs^Fds, Gs^Fds, Gs^Fds, Gs^Fds, Gg, Gs^Fds, Gg, Gll, Gs^Fds, Gs^Fds, Gg, Gg, Gg
