Ss, Ss, Ss, Gg, Ss, Ss, Sm, Gg, Gg, Ss, Gg, Gg, Ss, Gg, Ss, Gg, Ss, Gg, Gg, Gg, Gg, Gg, Gg, Gg, Ss, Gg, Sm, Gg, Gg, Gg, Gg, Gg, Gg, Gg, Sm, Gg, Ss, Ss, Ss, Ss, Sm, Ss, Sm, Gg, Ww, Gg, Ww, Ww, Ww, Gg, Ss, Gg, Gg, Gg, Ss, Gg, Ss, Gg
Ss, Ss, Gs, Gs, Gg, Gg, Ss, Gs, Gs, Gs, Gg, Ss, Gg, Sm, Ss, Ss, Gs, Sm, Sm, Ss, Gs, Gs, Ss, Ss, Sm, Sm, Gg, Ss, Ss, Sm, Ss, Ss, Gs, Ss, Ss, Ss, Ww, Ss, Ww, Gs, Ww, Gs, Ww, Ww, Ww, Ww, Ww, Ww, Ww, Ss, Gg, Gs, Ss, Ss, Gs^Es, Sm, Gg, Sm
Ss, Gs, Gg, Gs, Sm, Sm, Gg, Ss, Gg, Ss, Ss, Ss, Ss, Ss, Ss, Ss, Gs, Gs, Ss, Gs, Sm, Sm, Ss, Ss, Sm, Ss, Gg, Ss, Ww, Gs, Ww, Ww, Ww, Ww, Ww, Ww, Ww, Ww, Ww, Ww, Ww, Ww, Ww, Ww, Ww, Ww, Ww, Ww, Ss, Ss, Ss, Ss, Ss, Sm, Ss, Gs^Es, Ss, Ss
Ss, Ss, Ss, Sm, Ss, Ss, Ss, Sm, Ss, Ss, Gg, Sm, Sm, Gg, Ss, Ss, Ss, Gg, Ss, Ss, Ss, Ss, Gs, Gs, Ss, Ss, Ww, Ww, Ww, Ww, Ww, Ww, Ww, Ww, Ww, Ww, Ww, Ww, Ww, Ww, Ww, Ww, Ww, Ww, Ww, Ww, Ss, Ss, Ss, Ss, Gg, Gs, Ss, Gg^Vd, Ss, Ss, Ss, Gg
Gg, Ss, Ss, Ss, Ss, Ss, Gg, Ss, Ss, Gs, Ss, Ss, Ss, Sm, Gg, Sm, Gg, Ss, Ss, Ss, Ss, Gg, Gs, Gg, Ss, Gs, Ww, Ww, Ww, Ww, Ww, Ww, Ww, Ww, Ss, Ww, Ww, Ww, Sm, Ww, Ss, Ss, Ww, Ww, Ww, Ss, Gs, Gs, Sm, Sm, Ss, Gg, Ss, Ss, Gs, Gg, Ss, Gg
Ss, Ss, Sm, Ss, Sm, Gs, Gs, Gg, Sm, Gs, Gg, Ss, Gg, Ss, Ss, Ss, Ss, Ss, Ss, Gg, Ss, Ss, Ss, Ss, Gg, Ww, Ww, Ww, Ww, Ww, Gs^Vd, Ww, Ss, Sm, Ss, Ss, Ss, Ss, Ss, Ss, Ww, Ww, Ww, Ww, Ds, Ss, Ss, Sm, Gs, Ss, Gs, Ss, Sm, Gs, Ss, Ss, Gs, Gg
Ss, Ss, Gg, Sm, Ss, Sm, Ss, Ss, Ss, Ss, Ss, Ss, Ss, Gg, Gg, Ss, Gs, Gg, Sm, Gg, Gg, Ss, Gg, Gg, Ww, Ww, Ww, Ww, Ss, Sm, Sm, Sm, Ds, Sm, Ds, Ss, Rd, Rr^Pr|, Ds, Ds, Wwf, Ww, Ss, Ds^Vd, Ss, Ss, Ss, Gd, Ss, Ss, Gs, Gg, Ss, Sm, Ss, Ss, Gs, Gg
Ss, Ss, Sm, Sm, Gs, Ss, Gg, Gg, Gg, Gg, Gs, Gg, Gs, Gg, Ss, Sm, Gs, Gs, Ss, Ss, Ss, Gs, Gs, Gs, Ww, Ww, Ww, Ss, Ss, Rr^Pr|, Gd, Ss, Ds, Ds^Es, Cte, Ss, Ss, Ss, Ss, Ww, Ww, Wwf, Ds, Ss, Ss, Sm, Sm, Ss, Sm, Gg, Gg^Es, Ss, Sm, Ss, Ss, Ss, Ss, Gg
Gg, Ss, Gg, Gs, Gg, Gg, Ss, Gs, Ss, Gg, Ss, Gs, Sm, Ss, Ss, Ss, Sm, Ss, Gg^Vd, Ss, Sm, Ss, Ss, Ww, Ww, Ww, Ww, Sm, Ss, Gd, Ss, Ss, Cte, Rb, Cte, Rb, Cte, Rb, Ds, Ww, Ww, Ds, Ss, Ds, Ds, Ds^Es, Ss, Ds, Ss, Gd, Gs^Es, Gg, Ss, Gg^Es, Sm, Ss, Ss, Ss
Ss, Ss, Ss, Ss, Ss, Ss, Gg, Ss, Sm, Sm, Gg, Ss, Ss, Gg, Ww, Ww, Ww, Ww, Ww, Ww, Ww, Ww, Ww, Ww, Ww, Ww, Ss, Ss, Gd, Gd^Vd, Ss, Rb, Rb^Es, Cte, 5 Kte, Cte, Rb, Rb, Ds, Wwf, Ds, Ss, Ds, Ss, Ds, Ds, Ss, Ds, Ss, Gs, Ss, Gg, Ss, Ss, Ss, Ss, Ss, Gg
Ss, Gg, Ss, Gg, Sm, Gg, Gs, Gg, Ss, Ss, Gg, Ss, Ww, Ww, Ww, Ww, Ww, Ww, Ww, Ww, Ww, Ww, Ww, Ww, Ww, Ww, Ss, Ds, Ss, Ss, Ds, Rb^Es, Rb, Cte, Cte, Cte, Rb^Es, Ds, Ww, Ww, Kte, Ds, Ds^Esd, Ds^Esd, Rb^Es, Ds, Ds, Ds, Ss, Ss, Gs, Ss, Gg, Gg^Vd, Sm, Gs, Ss, Gg
Sm, Sm, Gg, Gs, Gg, Gs, Ss, Ss, Ss, Gg, Ww, Ww, Ww, Ww, Ww, Ww, Ww, Ww, Ss, Ww, Ww, Ww, Ww, Ww, Ss, Ww, Ww, Ww, Wwf, Ds, Ww, Ds^Es, Ds, Rb, Cte, Rb, Ds^Es, Ds, Wwf, Ww, Ds, Ds, Rb, Ds, Rr^Pr|, Ds, Rb, Kte, Rb, Ss, Ss, Gs, Gs, Gs, Sm, Ss, Gg, Gg
Ss, Ss, Ss, Ss, Ss, Ss, Ss, Sm, Ss, Gs, Ww, Ww, Ww, Ww, Ss, Ss, Ss, Ss, Ss, Sm, Sm, Sm, Ds, Ss, Rd, Ss, Ss, Ss, Kte, Ww, Ww, Wwf, Ww, Ds, Wwf, Ds, Ww, Ww, Ds^Esd, Ds^Esd, Ds, Rb, Rd^Esd, Rd^Esd, Rb, Ds^Es, Rb^Esd, Ds, Ds, Rb^Es, Gd, Ss, Ss, Ss, Sm, Ss, Gs^Es, Gs
Ss, Ss, Ss, Ss, Ss, Gg, Sm, Gg, Ss, Gs, Ww, Ww, Ww, Sm, Ss, Sm, Ss, Ss, Rb, Ss, Rb, Ss, Rb, Rd, Rb^Es, Rb^Es, Gd^Xfw, Rd, Rd, Ds, Ds, Ds, Ds, Ww, Ds, Ww, Ds, Ds^Vd, Ds^Esd, Rd, Ds^Esd, Rd^Esd, Rd^Vd, Ds, Ds, Rb^Es, Rb^Esd, Rb^Esd, Rb, Gd^Xfw, Rb, Gd^Es, Gd, Ss, Gg, Gs^Es, Gg, Gg
Ss, Ss, Gg, Ss, Gg, Ss, Ss, Gg, Ss, Gg, Ww, Ww, Ss, Ss, Sm, Ss, Rb, Rb, Rb^Es, Rb, Ds, Rb, Ds, Ss, Kte, Ds^Es, Ds, Ds, Ds, Ds^Es, Gd^Xfw, Gd^Xfw, Kte, Ds, Ds, Ds, Kte, Gd^Xfw, Gd^Xfw, Rd, Rd, Rd, Rd, Rb, Rd, Rb, Rb, Ds, Rb, Rb, Kte, Gd^Es, Ss, Ss, Gg, Ss^Es, Ss, Ss
Gg, Ss, Ss, Ss, Ss, Sm, Ss, Ss, Ss, Ss, Ww, Ww, Ss, Ss, Ss, Ss, Rb, Rb^Es, Ds, Ds, Ss, Ds, Gd^Xfw, Ds, Ds, Rb, Rb, Ds^Es, Ds^Esd, Gd^Xfw, Rd^Esd, Rd, Cte, Cte, Kte, Cte, Cte, Rd, Rd^Esd, Gd^Xfw, Ds^Es, Rd, Ds, Ds^Esd, Rd, Ds, Rd, Rb, Ds, Ds, Rb^Es, Gd, Ss, Ss, Gg^Es, Gs^Es, Gs, Gg
Gs, Gs, Gg, Gg, Gg, Ss, Gg, Gs, Ww, Ww, Ww, Ww, Ww, Ss, Ss, Rb, Ss, Ss, Ss, Ss, Kte, Ds, Ds^Esd, Ds^Es, Rd^Vd, Ds, Rd, Ds^Esd, Rd, Gd^Xfw, Rd, Rd, Kte, Mv, Cte, Mv, Kte, Rd, Rd^Esd, Gd^Xfw, Ds, Ds^Es, Rb, Ds^Esd, Rb, Rd^Vd, Rd^Esd, Rd^Es, Ds^Es, Ds^Es, Gd^Xfw, Gd, Gs, Ss, Ss, Sm, Ss, Ss
Ss, Gg, Ss, Sm, Gg, Gs, Ss, Ww, Ww, Ww, Ww, Ww, Ww, Sm, Ss, Rb, Gd, Ss, Ds, Ds, Ds, Ds^Esd, Ds, Rd^Es, Rd, Ds, Rr^Pr|, Rd, Rd^Esd, Gd^Xfw, Kte, Cte, Mv, Cte, Kte, Cte, Mv, Cte, Kte, Gd^Xfw, Ds, Rd, Rd, Rb^Es, Rr^Pr|, Rb^Es, Rd^Esd, Rd, Rb, Rd, Rb, Gd, Ss, Gs, Ss, Sm, Gs, Gg
Sm, Ss, Ss, Ss, Gs, Gs, Ww, Ww, Ww, Ww, Ss, Ww, Gd^Vd, Ss, Ss, Gd, Ss, Rb, Rb, Gd^Xfw, Ds^Es, Ds^Esd, Rd^Esd, Rd, Rd^Esd, Ds, Rd^Esd, Rd^Esd, Rd^Esd, Rd, Rd, Cte, Kte, Cte, Cte, Cte, Kte, Cte, Ds^Esd, Rd, Ds, Ds^Esd, Rd, Rd^Es, Ds, Rd, Rb, Rd^Esd, Rb, Rb, Kte, Gd, Gs, Ss, Gs, Sm, Gg, Gg
Gg, Ss, Sm, Ss, Ww, Ww, Ww, Ww, Ww, Ww, Sm, Ss, Sm, Ss, Ss, Ss, Gd, Gd, Rb, Ds, Ds, Rd, Ds, Ds^Esd, Rd, Rd, Rd, Rd^Esd, Rd, Ds^Esd, Ds, Rd, Cte, Mv, Kte, Mv, Cte, Rd, Ds, Ds^Esd, Rd, Rd, Ds, Rd, Rd, Ds, Rd, Rb, Rb, Gd, Ds, Ss, Gs, Gg^Es, Gs^Es, Gg^Es, Ss, Gg
Sm, Ss, Sm, Gg^Vd, Ww, Ww, Ww, Ww, Ww, Ww, Ss, Ss, Sm, Ss, Gd, Gd, Rb^Es, Rb, Rd, Kte, Rd, Rd, Rd, Cte, Cte, Cte, Cte, Cte, Rd, Gd^Xfw, Ds, Rd, Kte, Cte, Rd, Cte, Kte, Rd, Ds, Gd^Xfw, Rd, Cte, Cte, Cte, Cte, Cte, Ds^Esd, Rd, Rb^Es, Gd, Gd^Xfw, Ss, Ss, Gs^Vd, Ss, Gg, Gg, Ss
Sm, Ss, Gs, Ww, Ww, Ww, Ww, Ww, Ss, Ss, Ss, Ss, Ss, Gd, Gd^Es, Rb^Es, Ds, Ss, Ds, Ds, Ds, Rd^Es, Ds, Rd, Cte, 4 Kte, Cte, Rd, Ds, Rd, Ds, Rd, Gd^Xfw, Rd, Rd, Rd, Gd^Xfw, Rd, Rd^Vd, Ds, Ds^Esd, Ds, Cte, 2 Kte, Cte, Ds, Ds^Esd, Rb, Rb^Es, Gd, Gd, Gd, Ss, Ss, Ss, Gg, Gg, Gs
Sm, Gs, Ww, Ww, Ww, Ww, Ss, Gs^Es, Sm, Sm, Ss, Gd, Gd^Es, Ss, Gd, Rb^Es, Rb, Ss, Rd, Gd^Xfw, Rd^Es, Rd^Es, Rd, Cte, Rd, Cte, Rd, Ds, Ds, Rd^Esd, Rd^Esd, Rd^Esd, Ds^Es, Gd^Xfw, Gd^Xfw, Gd^Xfw, Ds^Esd, Ds, Ds, Ds, Ds, Rd, Rd, Cte, Rd, Cte, Rd^Esd, Rd, Ds, Rb, Kte, Gd, Gs, Gs, Ss, Ss, Ss, Gg
Ss, Sm, Ww, Ww, Ww, Ww, Ss, Gs^Es, Ss, Ss, Gs, Gd^Es, Gd, Ss, Ss, Gd, Ss, Rb, Rb, Ds, Ds, Rd, Rd, Rd, Rd, Cte, Ds, Ds, Rd^Es, Rd^Vd, Rd^Es, Rd^Es, Ds, Rd, Rd, Rb, Ds, Ds^Esd, Ds, Rb^Es, Ds, Rb, Rb, Cte, Rd, Rd, Rd^Es, Rd, Rb, Gd, Gd, Gd, Gs, Gs, Ss, Gg, Ss, Ss
Ss, Sm, Ww, Ww, Ww, Gg^Vd, Ss, Ss, Gg, Gs, Gs, Gs^Es, Ss, Ss, Sm, Ss, Gd, Gd, Ds, Kte, Rb, Ds, Rd, Rd^Es, Ds^Es, Rd^Es, Rd, Rd, Rd, Rb^Es, Ds, Ds^Esd, Ds^Esd, Ds, Rb, Rd^Vd, Rd, Rr^Pr|, Rd, Rd^Es, Rd^Vd, Rd^Esd, Rd^Esd, Rd^Esd, Rb, Rb^Es, Rb, Kte, Gd, Gd, Ss, Ss, Gs, Ss, Sm, Ss, Ss, Gg
Ss, Ww, Ww, Ww, Ww, Ss, Ss, Sm, Ss, Ss, Ss, Ss, Ss, Ss, Ss, Gd, Ss, Ss, Ds, Rb, Rb, Gd^Xfw, Rb, Ds, Ds, Ds^Esd, Ds^Esd, Ds, Ds, Ds, Rd, Rd, Rb^Vd, Ds^Es, Rd, Ds, Rd, Ds^Esd, Ds, Ds, Ds^Esd, Ds, Rb, Rb, Gd, Gd^Xfw, Gd, Gd, Ss, Gg, Ss, Gg, Gs, Gg, Gg, Gg, Ss, Gg
Ss, Sm, Ww, Ww, Ww, Gs, Ss, Sm, Ss, Gg, Gg, Gs, Sm, Ss, Ss, Rb, Rb, Ss, Rb, Ds, Rb, Rb, Ds, Kte, Ds, Rb, Ds, Kte, Rb, Rb, Ds^Es, Rb, Rb, Rb, Rb, Rb, Rb^Es, Rb, Ds, Kte, Ds, Gd^Xfw, Ds, Kte, Rb, Gg, Ss, Gg, Gs, Gs, Ss, Gs, Ss, Ss, Gg, Ss, Gg^Es, Gg
Ss, Sm, Ww, Ww, Ww, Gs, Gg^Es, Gg, Gs, Ss, Gg, Ss, Gs, Gd, Ss, Rb, Rb, Ss, Gd, Rb, Rb, Gd, Rb, Gd, Rb, Gd^Xfw, Rb, Ds, Ds^Es, Gd^Xfw, Ds, Ds, Rb, Ds^Esd, Gd, Ds, Gd, Gd^Xfw, Rb, Ds, Rb, Gd, Rb, Rb, Rb, Gg, Gs, Gs, Gg, Ss, Gg^Vd, Gg, Sm, Gs, Gs, Ss, Gs^Es, Gg
Gg, Ss, Gs, Ww, Ww, Ww, Ss, Ss, Ss, Ss, Gs, Gg^Es, Gs^Es, Gd, Ss, Gd, Gd, Gd, Gd, Gd, Gd, Rb^Es, Gd^Es, Gd, Gd, Rb, Rb, Rb, Rb, Rb, Rb, Kte, Rb, Gd^Xfw, Rb, Kte, Rb, Rb^Es, Rb^Es, Rb, Gd, Rb, Rb^Es, Rb, Gg, Gs^Es, Rb, Gs, Ss, Ss, Ss, Ss, Sm, Sm, Gg, Gg, Gg, Gs
Gg, Ss, Ss, Ww, Ww, Ww, Ww, Sm, Gs, Ss, Sm, Gs, Ss, Ss, Gs, Gs, Gs, Gg, Ss, Gg, Ss, Gd, Rb, Gd, Rb^Es, Gd, Gd, Gd, Gd, Gd, Gd, Rb, Rb, Rb, Rb, Rb, Gd, Gd, Gd^Es, Gd^Es, Gd, Rb, Rb, Rb, Gs, Gs, Gg, Ss, Ss, Ss, Ss, Ss, Ss, Ss, Ss, Ss, Gg, Gs
Gg, Gg, Ss, Ss, Ww, Ww, Ww, Ww, Sm, Sm, Gs, Ss, Ss, Gs, Ss, Ss, Gs, Gs, Gs, Ss, Rb, Rb^Vd, Gs, Gg, Gs, Rb, Gs, Gd^Es, Gs, Rb, Gg, Gd, Gs, Gd, Gd, Gd, Gs^Es, Rb^Es, Gs, Gd, Rb^Es, Rb, Gs, Gs, Ss, Ss, Ss, Gg, Ss, Gs, Gs, Gs, Gs, Gg, Ss, Ss, Ss, Gg
Gg, Ss, Ss, Gg, Ww, Ww, Ww, Ww, Ww, Gg, Gs, Ss, Gg, Gs, Ss, Gs, Rb, Rb, Gs, Gs, Gs, Rb, Gs^Es, Gs, Gg, Gs, Rb^Es, Gs, Gs, Gs^Es, Gs^Es, Gs^Es, Gs, Gs, Gs^Es, Gs^Es, Gs, Gg, Gs^Es, Gs, Gs, Gs, Gg^Vd, Ss, Ss, Gs, Gs, Ss, Sm, Ss, Ss, Gs^Es, Gg, Ss, Gs, Gs, Ss, Gg
Sm, Ss, Ss, Ss, Gg, Ww, Ww, Ww, Ww, Gg^Vd, Sm, Ss, Ss, Gs, Gg, Rb, Ss, Gs, Ss, Gs, Gs, Rb, Rb, Gg^Es, Rb, Rb, Rb, Rb, Gg, Rb, Rb, Gs, Rb, Gs^Es, Gg, Gs, Gg^Es, Gs^Es, Gg, Rb, Gs, Rb, Ss, Ss, Gg, Gs, Gs, Gg, Ss, Gs, Gg, Gg^Es, Ss, Ss, Gg, Gg, Ss, Ss
Ss, Sm, Ss, Ss, Ss, Gs^Vd, Ww, Ww, Ww, Ww, Ss, Sm, Gg, Gs^Es, Gs^Es, Ss, Ss, Gg, Rb, Rb, Gs, Ss, Rb, Ss, Ss, Gs, Gs, Gs, Gs, Gs, Gs, Gg^Vd, Gs, Rb, Gg, Gs, Gs, Rb, Gs, Gs, Gg, Gs, Ss, Gg, Sm, Gs, Ss, Ss, Gg, Ss, Gs, Ss, Gs, Gg, Gg, Ss, Ss, Gg
Ss, Sm, Ss, Gg, Gg, Sm, Sm, Ww, Ww, Ww, Ss, Ss, Ss, Ss, Gg, Gg, Ss, Gg, Ss, Rb, Rb^Es, Gg, Gs^Es, Gg^Es, Gs, Ss, Ss, Rb, Rb, Gg, Gs, Rb^Es, Rb, Rb, Gs, Gs, Rb, Gs, Rb, Gg, Ss, Ss, Ss, Sm, Ss, Ss, Ss, Ss, Ss, Gg, Ss, Gs, Ss, Ss, Ss, Ss, Ss, Gg
Ss, Gg, Gg, Ss, Gg, Sm, Ss, Ww, Ww, Ww, Ww, Ss, Gs^Es, Ss, Gg, Ss, Ce, Gs, Ce, Rb, Ce, Rb^Es, Ss, Gs, Rb, Rb, Rb, Ss, Gs, Gg^Es, Rb, Rb, Ss, Gs, Rb, Rb, Rb, Gs, Ss, Gg, Gg, Ss, Ss, Sm, Gg, Ss, Ss, Gg, Ss, Ss, Ss, Ss, Gs, Gs, Ss, Ss, Ss, Ss
Gg, Ss, Ss, Sm, Ss, Ss, Gg, Ww, Ww, Ww, Ww, Gs^Es, Gs^Es, Ss, Ss, Ss, Rb, Ce, 1 Ke, Ce, Rb, Rb, Gg, Ss, Rb, Gs^Es, Gs^Es, Gg^Es, Ss, Rb, Ss, Rb, Rb, Gs, Gs, Gs, Rb, Rb, Ss, Ss, Ss, Gg, Ss, Ss, Ss, Sm, Sm, Ss, Sm, Gg, Sm, Gg, Ss, Ss, Gg, Ss, Gs, Gg
Sm, Sm, Ss, Ss, Gs, Gs, Ww, Ww, Ww, Ww, Ww, Gs, Ss, Ss, Ss, Gs, Ce, Ce, Ce, Ce, Ce, Ss, Gg, Rb, Gg, Rb, Ss, Gg, Ss, Ss, Rb, Rb, Rb, Gg, Ke, Gs, Gs, Ss, Gg^Es, Gg^Es, Ss, Ss, Gs^Es, Gg, Gs, Gg, Gs, Gg, Ss, Ss, Ss, Ss, Sm, Sm, Gs^Es, Gg^Es, Ss, Gg
Sm, Gg, Sm, Ss, Gg, Ww, Ww, Ww, Ww, Ww, Gs^Es, Ss, Ss, Ss, Ss, Gg, Rb, Gg, Gs, Rb, Rb, Gg, Gs, Ss, Sm, Ss, Ss, Ss, Ss, Rb, Ss, Ss, Ce, Gs^Es, Ce, Gs, Ce, Ss, Ss, Ss, Gg, Gs, Gs^Es, Sm^Es, Ss, Ss, Ss, Ss, Gs, Gg, Gg^Vd, Ss, Gg, Gs^Es, Ss, Ss, Ss, Gg
Ss, Sm, Ss, Ss, Ww, Ww, Ww, Ww, Ww, Gg^Vd, Gs^Es, Gg^Es, Ss, Gg, Rb^Es, Ss, Ss, Rb, Ss, Rb, Gg, Ss, Gs, Ss, Ds, Ss, Ss, Ss, Ss, Rb, Rb, Ss, Ss, Ce, 3 Ke, Ce, Ss, Gg, Ss, Ss, Sm, Gg^Es, Ss, Ss, Ss, Ss, Ss, Gs, Sm, Gs^Es, Gg, Ss, Ss, Ss, Gg, Gg, Ss, Gg
Ss, Ss, Ss, Ww, Ww, Ww, Ww, Ww, Ss, Ss, Ss, Ss, Ss, Gg^Es, Gs, Gs^Es, Gg^Es, Rb, Rb, Ss, Ss, Ss, Gg^Vd, Gg, Ss, Ss, Gs^Es, Ss, Ss, Ds, Rb, Gg, Rb^Es, Ce, Ce, Ce, Ss, Ds, Ss, Ss, Ss, Ss, Ss, Gg, Sm, Gs, Gg, Ss, Ss, Ss, Gg^Es, Gs, Ss, Gg, Gs, Sm, Gg, Gg
Gg, Gg, Ss, Ww, Ww, Ww, Gs, Gg, Ss, Ss, Gs, Gg, Gg, Rb, Ss, Gg^Es, Rb, Rb, Rb, Ss, Gg, Ss, Sm, Sm, Ss, Gg^Es, Gs^Es, Gg^Es, Ss, Ss, Gs, Gg^Es, Rb, Gs^Es, Ce, Gg, Ss, Ds, Ss, Ss, Gg, Ss, Gg, Sm, Gg, Ss, Gs, Ss, Gg, Ss, Ss, Gg, Ss, Sm, Gs, Gs, Ss, Ss
Gg, Gg, Ss, Ww, Ww, Ww, Gg, Ss, Ss, Gs, Gg, Gg, Gg, Ss, Gg, Ss, Gg, Ss, Rb, Gg, Ss, Ss, Gg, Gg, Gg, Ss, Gg, Gs, Gg, Gg, Gg, Gs, Gg, Rb, Rb, Gs, Gg, Ss, Ss, Gg, Gg, Ss, Ss, Sm, Gg, Gg, Gg, Gs, Gs, Gg, Sm, Sm, Gg, Ss, Gg, Ss, Ss, Gg
