Wo, Wo, Wo, Wo, Wo, Wo, Wo, Wo, Wo, Wo, Wo, Wo, Wo, Wo, Wo, Wo, Wo, Wo, Wo, Wo, Wo, Wo, Wo, Wo, Wo, Wo, Wo, Wo, Wo, Wo, Wo, Wo, Wo, Wo, Wo, Wo, Wo, Wo, Wo, Wo, Wo, Wo, Wo, Wo, Wo, Wo, Wo, Wo
Wo, Wo, Wo, Wo, Wo, Wo, Wo, Wo, Wo, Wo, Wo, Wo, Wo, Wo, Wo, Wo, Wo, Wo, Wo, Wo, Wo, Wo, Wo, Wo, Wo, Wo, Wo, Wo, Wo, Wo, Wo, Wo, Wo, Wo, Wo, Wo, Wo, Wo, Wo, Wo, Wo, Wo, Wo, Wo, Wo, Wo, Wo, Wo
Wo, Wo, Wo, Wo, Wo, Wo, Wo, Wo, Wo, Wo, Wo, Wo, Wo, Wo, Wo, Wo, Wo, Wo, Wo, Wo, Wo, Wo, Wo, Wo, Wo, Wo, Wo, Wo, Wo, Wo, Wo, Wo, Wo, Wo, Wo, Wo, Wo, Wo, Wo, Wo, Wo, Wo, Wo, Wo, Wo, Wo, Wo, Wo
Wo, Wo, Wo, Wo, Wo, Wo, Wo, Wo, Wo, Wo, Wo, Wo, Wo, Wo, Wo, Wo, Wo, Wo, Wo, Wo, Wo, Wo, Wo, Wo, Wo, Wo, Wo, Wo, Wo, Wo, Wo, Wo, Wo, Wo, Wo, Wo, Wo, Wo, Wo, Wo, Wo, Wo, Wo, Wo, Wo, Wo, Wo, Wo
Wo, Wo, Wo, Wo, Wo, Wo, Wo, Wo, Wot, Wo, Wot, Wo, Wo, Wo, Wo, Wo, Wo, Wo, Wo, Wo, Wo, Wo, Wo, Wo, Wo, Wo, Wo, Wo, Wo, Wo, Wo, Wo, Wo, Wo, Wot, Wo, Wot, Wot, Wot, Wot, Wot, Wo, Wo, Wo, Wo, Wo, Wo, Wo
Wo, Wo, Wo, Wo, Wo, Wo, Wot, Wot, Wot, Wot, Wot, Wot, Wot, Wot, Wot, Wot, Wot, Wot, Wot, Wot, Wot, Wot, Wot, Wot, Wot, Wo, Wo, Wo, Wo, Wo, Wo, Wo, Wo, Wo, Wot, Wot, Wot, Wot, Wot, Wot, Wot, Wot, Wot, Wo, Wo, Wo, Wo, Wo
Wo, Wo, Wo, Wo, Wo, Wot, Wot, Wot, Wot, Wot, Wot, Wot, Wwrt, Wot, Wot, Wot, Wot, Wot, Wot, Wot, Wwrt, Wwrt, Wwrt, Wwrt, Wwrt, Wot, Wot, Wo, Wo, Wo, Wot, Wot, Wot, Wot, Wot, Wot, Wwt, Wot, Wot, Wot, Wot, Wot, Wot, Wo, Wo, Wo, Wo, Wo
Wo, Wo, Wo, Wo, Wot, Wot, Wot, Wot, Wwrt, Wot, Wwrt, Wwrt, Wwt, Wwrt, Wwrt, Wwrt, Wwrt, Wwt, Wwt, Wwt, Wwt, Wwrt, Wwt, Wwt, Wwt, Wwrt, Wwrt, Wot, Wot, Wot, Wot, Wot, Wot, Wot, Wwrt, Wwrt, Wwrt, Wwt, Wwt, Wot, Wot, Wot, Wot, Wot, Wo, Wo, Wo, Wo
Wo, Wo, Wo, Wot, Wot, Wot, Wot, Wot, Wot, Wwrt, Wwt, Wwt, Wwt, Wwt, Wwt, Wwt, Wwt, Wwt, Wwt, Wwt, Hd, Hd, Hd, Hd, Wwt, Wwt, Wwrt, Wot, Wot, Wot, Wot, Wot, Wot, Wwrt, Ds, Ds, Ds, Ds, Ds, Wwrt, Wot, Wot, Wot, Wot, Wo, Wo, Wo, Wo
Wo, Wo, Wo, Wot, Wot, Wot, Wot, Wot, Wwt, Wwt, Ds, Ds, Ds, Wwt, Wwt, Wwt, Wwf, Ds, Ds, Ds, Hd, Hd, Hd, Hd, Hd, Wwt, Wot, Wot, Wot, Wot, Wot, Wot, Wwt, Wwt, Kv, Cv^Efm, Cv^Efm, Kv, Ds, Wwrt, Wot, Wot, Wot, Wot, Wo, Wo, Wo, Wo
Wo, Wo, Wot, Wot, Wot, Wot, Wwrt, Wwt, Wwt, Wwt, Ds, Gll^Ftr, Ds, Ds, Kv, Ds, Ds, Wwf, Hh^Ftr, Hh^Ftr, Hh^Ftr, Hh^Ftr, Hh^Ftr, Hd, Hd, Wwt, Wwt, Wot, Wot, Wot, Wot, Wwt, Wwt, Ds, Gll^Ftr, Gll^Ftr, Cv^Efm, Cv^Efm, Ds, Wwt, Wot, Wot, Wot, Wot, Wo, Wo, Wo, Wo
Wo, Wo, Wot, Wot, Wot, Wwrt, Wwt, Wwt, Ds, Ds, Gll^Ftr, Gll^Ftr, Kv, Cv^Efm, Gg^Efm, Cv^Efm, Kv, Wwt, Hh^Ftr, Mm, Mm, Mm, Hh^Ftr, Ds, Ds, Wwt, Wwr, Wwt, Wwt, Wot, Wot, Wot, Wwt, Ds, Gg^Ve, Gll^Ftr, Gll^Ftr, Kv, Ds, Wwt, Wot, Wot, Wot, Wo, Wo, Wo, Wo, Wo
Wo, Wo, Wo, Wot, Wot, Wwrt, Wwt, Wwt, Ds, Gll^Ftr, Gll^Ftr, Gg^Ve, Cv^Efm, Gg^Fet, Cv^Efm, Gg^Fet, Cv^Efm, Ww^Ewf, Ww^Ewf, Mm, Mv, Hh^Ftr, Hh^Ftr, Gll^Ftr, Ds, Ds, Ds, Wwrt, Wwrt, Wwt, Wwt, Wot, Wwt, Ds, Ds, Ds, Gll^Ftr, Ds, Wwt, Wwt, Wot, Wot, Wo, Wo, Wo, Wo, Wo, Wo
Wo, Wo, Wo, Wot, Wot, Wwrt, Wwt, Wwt, Wwt, Ds, Gll^Ftr, Gll^Ftr, Cv^Efm, Cv^Efm, Kv, Cv^Efm, Cv^Efm, Ww^Ewf, Hh^Ve, Hh^Ftr, Mm, Mm, Hh^Ftr, Gll^Ftr, Gll^Ftr, Gll^Ftr, Gll^Ftr, Ds, Ds, Wwt, Wwt, Wwt, Wwt, Wwt, Ww, Ds, Ds, Ds, Wwt, Wot, Wot, Wot, Wo, Wo, Wo, Wo, Wo, Wo
Wo, Wo, Wo, Wot, Wot, Wot, Wot, Wwt, Wwt, Ds, Ds, Ds, Kv, Gg^Fet, Gg^Fet, Gg^Fet, Kv, Hh^Ftr, Mm, Mv, Mm, Hh^Ve, Gll^Ftr, Gll^Efm, Gll^Efm, Gg^Fet, Gll^Ftr, Gll^Ftr, Ds, Ds, Ds, Wwt, Wwt, Ww, Ds, Wwf, Wwf, Wwt, Wwt, Wot, Wot, Wot, Wot, Wo, Wo, Wo, Wo, Wo
Wo, Wo, Wo, Wot, Wot, Wot, Wot, Wwrt, Wwt, Wwt, Wwt, Ds, Gll^Ftr, Cv^Efm, Kv, Cv^Efm, Mm, Hh^Ftr, Mm, Mm, Mm, Hh^Ftr, Gll^Efm, Gll^Efm, Gg^Fet, Gll^Efm, Gg^Ve, Gll^Ftr, Gll^Ftr, Gll^Ftr, Ds, Wwt, Wwt, Ds, Gll^Ftr, Gll^Ftr, Ds, Wwt, Wwt^Bsb/, Wwt, Wwt, Wot, Wot, Wot, Wo, Wo, Wo, Wo
Wo, Wo, Wo, Wo, Wot, Wot, Wot, Wwrt, Wwrt, Wwt, Wwt, Ds, Ds, Rp, Rp, Rp, Rp, Hh^Ftr, Mm, Hh^Ftr, Hh^Ftr, Hh^Ftr, Gll^Efm, Gg^Fet, Gll^Efm, Gll^Efm, Gg^Fet, Gll^Ftr, Gg^Fet, Gll^Ftr, Ds, Ds, Wwf, Wwf, Rp, Gll^Efm, Cv, Ds^Bsb/, Ds^Bsb/, Wwt^Bsb/, Wwt, Wwt, Wot, Wot, Wo, Wo, Wo, Wo
Wo, Wo, Wo, Wo, Wot, Wot, Wot, Wot, Wot, Wot, Wwt, Wwt, Wwt, Ds, Gll^Ftr, Gll^Ftr, Gll^Ftr, Rp, Rp, Gll^Ftr, Gll^Ftr, Gg^Fet, Gll^Ftr, Gll^Efm, Gll^Ftr, Gll^Efm, Gll^Efm, Gll^Efm, Gg^Fet, Gll^Ftr, Gll^Ftr, Gll^Ftr, Rp, Wwf^Bsb/, Gll^Ftr, Rp, Cv, 1 Kv, Ds^Bsb/, Wwt^Bsb/, Wwt, Wwt, Wot, Wot, Wo, Wo, Wo, Wo
Wo, Wo, Wo, Wo, Wot, Wot, Wot, Wot, Wot, Wwrt, Wwrt, Wwt, Wwt, Ds, Gll^Ftr, Gll^Efm, Gg^Fet, Gg^Fet, Gg^Fet, Rp, Rp, Gll^Ftr, Gll^Ftr, Gg^Fet, Gll^Efm, Gll^Ftr, Gll^Ftr, Gg^Fet, Gll^Ftr, Gll^Ftr, Rp, Rp, Ds, Wwf, Wwf, Gll^Ftr, Gll^Ftr, Cv, Ds, Wwt, Wwt, Wot, Wot, Wot, Wo, Wo, Wo, Wo
Wo, Wo, Wo, Wot, Wot, Wot, Wot, Wot, Wwrt, Wwrt, Wwrt, Wwt, Ds, Ds, Gll^Ftr, Gll^Efm, Gg^Fet, Gg, Gg^Efm, Gll^Ftr, Rp, Gll^Ftr, Gll^Ftr, Gll^Ftr, Gll^Ftr, Gg^Fet, Gll^Ftr, Gll^Ftr, Rp, Rp, Gll^Ftr, Gll^Ftr, Ds, Ds, Wwf, Gll^Ftr, Wwf, Gll^Ftr, Ds, Wwrt, Wot, Wot, Wot, Wo, Wo, Wo, Wo, Wo
Wo, Wo, Wot, Wot, Wot, Wot, Wot, Wot, Wwt, Wwt, Ds, Ds, Ds, Gll^Ftr, Gg^Fet, Gg^Fet, Gg^Fet, Gll^Efm, Ww^Ewf, Wwt, Ww^Ewf, Rp, Rp, Rp, Rp, Gll^Ftr, Rp, Rp, Gll^Ftr, Gll^Ftr, Gg^Fet, Gll^Ftr, Gll^Ftr, Ds, Ds, Wwf, Gll^Ftr, Wwf, Wwrt, Wwrt, Wot, Wot, Wot, Wo, Wo, Wo, Wo, Wo
Wo, Wo, Wot, Wot, Wot, Wot, Wwrt, Wwrt, Wwt, Wwt, Ds, Gll^Ftr, Gll^Ftr, Gll^Ftr, Gg^Fet, Gg, Gll^Efm, Ww^Ewf, Ww^Ewf, Ww^Ewf, Gg^Fet, Ww^Ewf, Gll^Ftr, Gll^Ftr, Gll^Ftr, Rp, Gll^Ftr, Gll^Ftr, Gg^Fet, Gg^Ve, Gll^Ftr, Gll^Ftr, Gll^Ftr, Gll^Ftr, Gg^Fet, Gll^Ftr, Ds, Ds, Wwt, Wwt, Wwt, Wot, Wot, Wo, Wo, Wo, Wo, Wo
Wo, Wot, Wot, Wot, Wwrt, Wwrt, Wwt, Wwt, Ds, Wwf, Wwf, Gll^Ftr, Gll^Efm, Gll^Efm, Gg^Fet, Gg^Fet, Gll^Efm, Wwt, Ww^Ewf, Kv, Gg^Fet, Gg^Fet, Gll^Ftr, Gg^Fet, Rp, Rp, Rp, Gll^Ftr, Gll^Ftr, Gll^Ftr, Cv, Gll^Efm, Gll^Efm, Gll^Ftr, Gll^Ftr, Gll^Ftr, Gll^Ftr, Ds, Ds, Wwt, Wwt, Wot, Wot, Wot, Wo, Wo, Wo, Wo
Wo, Wot, Wot, Wwrt, Wwrt, Wwt, Wwt, Ds, Ds, Gll^Ftr, Wwf, Gll^Ftr, Gll^Ftr, Gll^Efm, Gll^Ftr, Gg^Fet, Gg, Ww^Ewf, Ww^Ewf, Ww^Ewf, Ww^Ewf, Ww^Ewf, Gll^Ftr, Gll^Ftr, Rp, Gg^Fet, Gll^Ftr, Rp, Gll^Efm, Cv, Gg^Fet, Cv, Gll^Efm, Gll^Ftr, Gll^Ftr, Gg^Fet, Gll^Ftr, Ds, Ds, Wwt, Wwt, Wot, Wot, Wot, Wo, Wo, Wo, Wo
Wo, Wot, Wot, Wwt, Wwt, Wwt, Ds, Ds, Gg^Ve, Gll^Ftr, Wwf, Ds, Gll^Ftr, Gll^Ftr, Gll^Ftr, Gg^Fet, Gg^Fet, Gg^Fet, Wwf, Wwt, Gll^Ftr, Gll^Ftr, Gg^Fet, Gg^Ve, Rp, Gg^Fet, Gll^Ftr, Gll^Ftr, Gll^Efm, Cv, Cv, Cv, Gll^Ftr, Gg^Fet, Gg^Ve, Gll^Ftr, Ds, Ds, Ds, Wwt, Wwt, Wot, Wot, Wot, Wo, Wo, Wo, Wo
Wo, Wot, Wot, Wot, Wwt, Wwt, Wwt, Ds, Ds, Gll^Ftr, Gll^Ftr, Wwf, Ds, Ds, Ds, Ds, Wwf, Wwf, Gll^Ftr, Gll^Ftr, Gll^Ftr, Gll^Ftr, Rp, Rp, Gll^Ftr, Gll^Ftr, Gll^Efm, Gll^Efm, Gg^Fet, Gll^Ftr, Gll^Ftr, Gll^Efm, Gll^Efm, Gll^Ftr, Gll^Ftr, Ds, Ds, Ds, Wwt, Wwt, Wot, Wot, Wot, Wo, Wo, Wo, Wo, Wo
Wo, Wo, Wot, Wot, Wwrt, Wwt, Wwt, Ds, Ds, Gll^Ftr, Gll^Ftr, Wwf, Wwt, Ww^Ewf, Ww, Wwf, Gll^Ftr, Gll^Ftr, Gll^Efm, Gg^Fet, Rp, Rp, Gg^Fet, Gll^Ftr, Gg^Fet, Gll^Ftr, Gll^Ftr, Gll^Efm, Gll^Ftr, Gg^Ve, Gll^Ftr, Gll^Ftr, Gll^Ftr, Ds, Ds, Ds, Wwt, Wwt, Wwt, Wwt, Wot, Wot, Wo, Wo, Wo, Wo, Wo, Wo
Wo, Wo, Wo, Wot, Wot, Wwrt, Wwt, Ds, Ds, Ds, Ds, Ds, Wwt, Ww^Ewf, Wwt, Ds, Ds, Ds, Gll^Ftr, Gg^Fet, Rp, Gg^Fet, Gg^Ve, Gll^Ftr, Gll^Efm, Gll^Ftr, Gll^Ftr, Ds, Gll^Ftr, Rp, Gll^Ftr, Ds, Ds, Ds, Ww, Wwt, Wwt, Wwt, Wot, Wot, Wot, Wot, Wot, Wo, Wo, Wo, Wo, Wo
Wo, Wo, Wo, Wot, Wot, Wwrt, Wwrt, Wwt, Wwt, Wwt, Wwf, Wwf, Ww, Ww^Ewf, Ww^Ewf, Ds, Gll^Ftr, Gg^Ve, Gs^Ft, Gll^Ftr, Rp, Gg^Fet, Gll^Ftr, Gll^Ftr, Gll^Efm, Gll^Ftr, Gll^Ftr, Ds, Ds, Rp, Rp, Ds, Wwt, Wwt, Wwt, Wwt, Wwt, Wwt, Wwt, Wot, Wot, Wot, Wot, Wo, Wo, Wo, Wo, Wo
Wo, Wo, Wo, Wot, Wot, Wwrt, Wot, Wot, Wwt, Wwt, Ds, Ds, Ds, Ds, Ds, Wwf, Ss, Gll^Ftr, Gll^Ftr, Rp, Gll^Ftr, Gll^Ftr, Gg^Ve, Gll^Ftr, Gll^Ftr, Ds, Ds, Ds, Wwt, Wwt, Wwt, Ww^Bsb\, Rp, Ds, Ds, Ds, Ds, Ds, Wwt, Wwt, Wot, Wot, Wot, Wot, Wo, Wo, Wo, Wo
Wo, Wo, Wot, Wot, Wwrt, Wwrt, Wwt, Wwt, Wwt, Ds, Gll^Ftr, Gll^Ftr, Gll^Ftr, Gll^Ftr, Gll^Ftr, Wwf, Ss, Ww^Ewl, Rp, Rp, Gll^Ftr, Gg^Fet, Gll^Ftr, Ds, Ds, Ds, Wwt, Wwrt, Wot, Wot, Wwt, Wwt, Ds, Rp, Gll^Ftr, Gll^Ftr, Gll^Ftr, Ds, Ds, Wwt, Wot, Wot, Wot, Wot, Wo, Wo, Wo, Wo
Wo, Wo, Wot, Wot, Wot, Wwrt, Wwt, Wwt, Ds, Ds, Gll^Ftr, Gll^Ftr, Gg^Fet, Gll^Ftr, Cv, Ww^Ewl, Wwf^Bsb/, Wwf^Bsb/, Ss, Ss, Ss, Gll^Ftr, Ds, Ds, Ds, Wwt, Wwrt, Wwrt, Wot, Wot, Wwt, Ds, Gll^Ftr, Rp, Rp, Gll^Efm, Gg^Fet, Gll^Ftr, Ds, Wwt, Wot, Wot, Wot, Wot, Wot, Wo, Wo, Wo
Wo, Wot, Wot, Wot, Wot, Wot, Wwt, Ds, Ds, Ds, Gll^Ftr, Gg^Fet, Gg^Ve, Gll^Ftr, Rp, Ss^Bsb/, Ww^Ewl, Ww^Ewl, Ww^Ewl, Wwf, Ss, Gll^Ftr, Ds, Ds, Ds, Wwrt, Wwt, Wot, Wo, Wot, Wwt, Ds, Gll^Ftr, Gll^Ftr, Rp, Gll^Efm, Gll^Ftr, Gll^Ftr, Ds, Wwt, Wot, Wot, Wot, Wot, Wot, Wo, Wo, Wo
Wo, Wot, Wot, Wot, Wwrt, Wwrt, Wwt, Ds, Ds, Gll^Ftr, Gg^Fet, Gll^Ftr, Gll^Ftr, Gll^Ftr, Rp, Ss, Ss, Wwf, Wwf, Ss, Wwf, Ds, Wwf, Ds, Wwt, Wwt, Wot, Wot, Wo, Wot, Wwt, Ds, Ds, Rp, Gg^Fet, Rp, Gll^Ftr, Ds, Wwt, Wwt, Wot, Wot, Wot, Wot, Wot, Wo, Wo, Wo
Wo, Wot, Wot, Wwrt, Wwrt, Wwt, Wwt, Ds, Ds, Gll^Ftr, Gll^Ftr, Gll^Ftr, Gll^Ftr, Gg^Fet, Rp, Gll^Ftr, Gll^Ftr, Ss, Ss, Wwf, Cv, Wwf, Wwf, Wwrt, Wwrt, Wwt, Wot, Wo, Wot, Wot, Wwt, Wwt, Wwf^Bsb/, Rp, Rp, Rp, Ds, Ds, Wwt, Wot, Wot, Wot, Wot, Wot, Wo, Wo, Wo, Wo
Wo, Wot, Wot, Wwrt, Wwt, Wwt, Wwt, Ds, Ds, Ds, Cv, Gll^Ftr, Rp, Rp, Gll^Ftr, Gll^Ftr, Gll^Ftr, Ss, Gll^Ftr, Gll^Ftr, Gll^Ftr, Ds, Ds, Wwrt, Wwt, Wot, Wo, Wo, Wot, Wwt, Ds, Rp, Rp, Wwf^Bsb/, Wwt, Wwt, Wwt, Wwt, Wot, Wot, Wot, Wot, Wot, Wo, Wo, Wo, Wo, Wo
Wo, Wot, Wot, Wwrt, Wwrt, Wwt, Ds, Ds, Ds, Cv, Cv, Rp, Gll^Ftr, Gll^Ftr, Ww^Ewf, Gll^Ftr, Gll^Ftr, Gll^Ftr, Gll^Ftr, Gll^Ftr, Gg^Fet, Ds, Ds, Wwt, Wwt, Wot, Wot^Bsb\, Wot^Bsb\, Kv, Ds, Gll^Ftr, Rp, Gll^Ftr, Ds, Ds, Wwt, Wwt, Wot, Wot, Wot, Wot, Wot, Wot, Wo, Wo, Wo, Wo, Wo
Wo, Wot, Wot, Wot, Wwrt, Wwt, Ds, Ds, Wwf, Kv, Cv, Cv, Wwf, Gll^Ftr, Ww^Ewf, Ww^Ewf, Gll^Ftr, Gll^Ftr, Gg^Fet, Gg^Ve, Gll^Ftr, Gll^Ftr, Ds, Wwrt, Wwt, Wot, Wot^Bsb\, Wwt^Bsb\, Kv, Cv, Rp, Rp, Gll^Ftr, Gll^Ftr, Ds, Wwt, Wwt, Wwt, Wot, Wot, Wot, Wot, Wot, Wot, Wo, Wo, Wo, Wo
Wo, Wot, Wot, Wot, Wot, Wwt, Wwt, Wwf, Ds, Gll^Ftr, Gll^Ftr, Gll^Ftr, Gll^Ftr, Ww^Ewf, Ww^Ewf, Ww^Ewf, Wwf, Gll^Ftr, Gll^Ftr, Gll^Ftr, Gg^Fet, Ds, Wwt, Wwt, Wot, Wot, Wwt, Kv, Cv, Cv, Gll^Ftr, Hh^Ftr, Hh^Ftr, Mm, Ds, Ds, Ds, Wwt, Wwt, Wot, Wot, Wot, Wot, Wot, Wot, Wo, Wo, Wo
Wo, Wot, Wot, Wot, Wot, Wwt, Wwt, Ds, Ds, Gll^Ftr, Gg^Fet, Gll^Efm, Gll^Ftr, Gll^Ftr, Gll^Efm, Gll^Ftr, Gll^Ftr, Wwf, Wwf, Gll^Ftr, Ds, Ds, Wwt, Wwrt, Wot, Wwt, Ds, Ds, Ds, Gll^Ftr, Mm, Mv, Mm, Mm, Gll^Ftr, Gll^Ftr, Ds, Wwt, Wwt, Wot, Wot, Wot, Wot, Wot, Wot, Wo, Wo, Wo
Wo, Wot, Wot, Wot, Wwrt, Wot, Wwt, Ds, Ds, Gll^Ftr, Gll^Ftr, Gll^Efm, Gll^Efm, Gll^Efm, Kv, Gll^Ftr, Gll^Efm, Gll^Ftr, Gll^Ftr, Wwf, Ww, Wwrt, Wot, Wot, Wot, Wwt, Ds, Gll^Ftr, Gll^Ftr, Gll^Ftr, Hh^Ftr, Mm, Hh^Ftr, Hh^Ftr, Gll^Ftr, Gll^Ftr, Ds, Ds, Wwt, Wot, Wot, Wot, Wot, Wot, Wo, Wo, Wo, Wo
Wo, Wo, Wot, Wot, Wot, Wwrt, Wwt, Ds, Ds, Gll^Ftr, Gll^Ftr, Gll^Ftr, Gll^Ftr, Gll^Efm, Gll^Efm, Gll^Efm, Gll^Ftr, Gll^Efm, Gll^Ftr, Ds, Wwt, Wwrt, Wwrt, Wo, Wot, Wwt, Wwt, Ds, Gll^Ftr, Hh^Ftr, Mm, Mm, Hh^Ftr, Gg^Fet, Gll^Ftr, Ds, Wwt, Wwt, Wwt, Wot, Wot, Wot, Wot, Wot, Wo, Wo, Wo, Wo
Wo, Wo, Wo, Wot, Wot, Wwrt, Wot, Wwt, Wwt, Ds, Ds, Ds, Gll^Ftr, Gg^Ve, Gll^Ftr, Gg^Fet, Gg^Ve, Gll^Efm, Ds, Ds, Wwt, Wwt, Wwrt, Wot, Wwt, Wwt, Wwt, Ds, Ds, Gll^Ftr, Gll^Ftr, Gll^Ftr, Gll^Ftr, Gll^Ftr, Ds, Ds, Wwt, Wwt, Wwt, Wwt, Wot, Wot, Wot, Wot, Wo, Wo, Wo, Wo
Wo, Wo, Wo, Wot, Wot, Wwrt, Wwrt, Wwt, Wwt, Wwt, Wwt, Ds, Gll^Ftr, Gll^Ftr, Gll^Ftr, Gll^Ftr, Gll^Ftr, Gll^Ftr, Ds, Wwt, Wwt, Wwt, Wwt, Wwt, Wwt, Wwt, Wwt, Wwt, Wwt, Ds, Gll^Ftr, Gll^Ftr, Gll^Ftr, Ds, Wwt, Wwt, Wwt, Wwt, Wot, Wwt, Wot, Wot, Wot, Wot, Wot, Wo, Wo, Wo
Wo, Wo, Wot, Wot, Wot, Wot, Wot, Wwrt, Wot, Wwt, Wwt, Ds, Ds, Gll^Ftr, Ds, Gll^Ftr, Ds, Ds, Wwt, Wwt, Wwt, Wwt, Wot, Wwt, Wwrt, Wwrt, Wot, Wwt, Wwt, Ds, Gll^Ftr, Ds, Ds, Ds, Wwt, Wwt, Wot, Wot, Wot, Wot, Wot, Wot, Wot, Wot, Wot, Wo, Wo, Wo
Wo, Wo, Wo, Wot, Wot, Wot, Wot, Wot, Wot, Wwt, Wwt, Wwt, Wwt, Ds, Ww, Ds, Ww, Wwt, Wwt, Wwt, Wwt, Wwt, Wwrt, Wwrt, Wwrt, Wwrt, Wwrt, Wot, Wwt, Ds, Ds, Ds, Wwt, Wwt, Wot, Wot, Wot, Wot, Wot, Wot, Wot, Wot, Wot, Wot, Wo, Wo, Wo, Wo
Wo, Wo, Wo, Wo, Wo, Wot, Wot, Wot, Wot, Wot, Wwrt, Wot, Wot, Wwt, Wwt, Wwt, Wwt, Wwt, Wot, Wwt, Wot, Wot, Wot, Wot, Wot, Wot, Wwrt, Wwrt, Wwrt, Wwt, Wwt, Wwt, Wwt, Wwt, Wwrt, Wot, Wot, Wot, Wot, Wot, Wot, Wot, Wot, Wot, Wo, Wo, Wo, Wo
Wo, Wo, Wo, Wo, Wo, Wot, Wot, Wot, Wot, Wot, Wot, Wwrt, Wwrt, Wot, Wwrt, Wot, Wwrt, Wot, Wwrt, Wwrt, Wot, Wot, Wot, Wot, Wot, Wot, Wot, Wwrt, Wot, Wwrt, Wwrt, Wwt, Wwrt, Wwrt, Wot, Wot, Wot, Wot, Wot, Wot, Wot, Wot, Wot, Wo, Wo, Wo, Wo, Wo
Wo, Wo, Wo, Wo, Wo, Wo, Wo, Wot, Wot, Wot, Wot, Wot, Wot, Wwrt, Wot, Wwrt, Wot, Wwrt, Wot, Wot, Wot, Wot, Wo, Wot, Wot, Wot, Wot, Wot, Wot, Wwrt, Wot, Wwrt, Wot, Wot, Wot, Wot, Wot, Wot, Wot, Wot, Wot, Wot, Wo, Wo, Wo, Wo, Wo, Wo
Wo, Wo, Wo, Wo, Wo, Wo, Wo, Wo, Wo, Wot, Wo, Wot, Wo, Wot, Wo, Wot, Wot, Wot, Wo, Wo, Wo, Wo, Wo, Wo, Wo, Wot, Wo, Wot, Wot, Wot, Wot, Wot, Wot, Wot, Wot, Wot, Wot, Wot, Wo, Wot, Wo, Wo, Wo, Wo, Wo, Wo, Wo, Wo
Wo, Wo, Wo, Wo, Wo, Wo, Wo, Wo, Wo, Wo, Wo, Wo, Wo, Wo, Wo, Wo, Wo, Wo, Wo, Wo, Wo, Wo, Wo, Wo, Wo, Wo, Wo, Wo, Wo, Wot, Wo, Wot, Wot, Wot, Wot, Wot, Wo, Wo, Wo, Wo, Wo, Wo, Wo, Wo, Wo, Wo, Wo, Wo
Wo, Wo, Wo, Wo, Wo, Wo, Wo, Wo, Wo, Wo, Wo, Wo, Wo, Wo, Wo, Wo, Wo, Wo, Wo, Wo, Wo, Wo, Wo, Wo, Wo, Wo, Wo, Wo, Wot, Wo, Wot, Wo, Wo, Wo, Wo, Wo, Wo, Wo, Wo, Wo, Wo, Wo, Wo, Wo, Wo, Wo, Wo, Wo
