Xof, Xof, Xof, Xof, Xof, Xof, Xof, Xof, Xof, Xof, Xof, Xof, Xof, Xof, Uue^Efs, Ias, Uue^Efs, Xoi, Uue^Efs, Irs, Uue^Efs, Xoi, Uue^Efs, Ias, Uue^Efs, Xoi, Uue^Efs, Irs, Uue^Efs, Xoi, Uue^Efs, Ias, Uue^Efs, Xof, Xof, Xof, Xof, Xof, Xof, Xof, Xof, Xof, Xof, Xof, Xof, Xof
Xof, Xof, Xof, Xof, Xof, Xof, Xof, Xof, Xof, Xof, Xof, Xof, Xof, Xof, Uue^Efs, Ias, Uue^Efs, Xoi, Uue^Efs, Irs, Uue^Efs, Xoi, Uue^Efs, Ias, Uue^Efs, Xoi, Uue^Efs, Irs, Uue^Efs, Xoi, Uue^Efs, Ias, Uue^Efs, Xof, Xof, Xof, Xof, Xof, Xof, Xof, Xof, Xof, Xof, Xof, Xof, Xof
Xof, Xof, Xof, Xof, Xof, Xof, Xof, Xof, Xof, Xof, Xof, Xof, Xof, Xof, Uue^Efs, Ias, Uue^Efs, Xoi, Uue^Efs, Irs, Uue^Efs, Xoi, Uue^Efs, Ias, Uue^Efs, Xoi, Uue^Efs, Irs, Uue^Efs, Xoi, Uue^Efs, Ias, Uue^Efs, Xof, Xof, Xof, Xof, Xof, Xof, Xof, Xof, Xof, Xof, Xof, Xof, Xof
Xof, Xof, Xof, Xof, Xof, Xof, Xof, Xof, Xof, Xof, Xof, Xof, Xof, Xof, Uue^Efs, Ias, Uue^Efs, Xoi, Uue^Efs, Irs, Uue^Efs, Xoi, Uue^Efs, Ias, Uue^Efs, Xoi, Uue^Efs, Irs, Uue^Efs, Xoi, Uue^Efs, Ias, Uue^Efs, Xof, Xof, Xof, Xof, Xof, Xof, Xof, Xof, Xof, Xof, Xof, Xof, Xof
Xof, Xof, Xof, Xof, Xof, Xof, Xof, Xof, Xof, Xof, Xof, Xof, Xof, Xof, Xof, Ias, Ias, Xoi^Efs, Ce, 3 Ke, Ce, Xoi^Efs, Uue^Efs, Ias, Uue^Efs, Xoi^Efs, Ce, 1 Ke, Ce, Xoi^Efs, Ias, Ias, Xof, Xof, Xof, Xof, Xof, Xof, Xof, Xof, Xof, Xof, Xof, Xof, Xof, Xof
Xof, Xof, Xof, Xof, Xof, Xof, Xof, Xof, Xof, Xof, Xof, Xof, Xof, Xof, Xof, Uue, Ias, Ce, Ias, Ce, Ias, Ce, Ias, Ias, Ias, Ce, Ias, Ce, Ias, Ce, Ias, Uue, Xof, Xof, Xof, Xof, Xof, Xof, Xof, Xof, Xof, Xof, Xof, Xof, Xof, Xof
Xof, Xof, Xof, Xof, Xof, Xof, Xof, Xof, Xof, Xof, Xof, Xof, Xof, Xof, Xof, Uue^Efs, Uue, Ias, Gd^Fetd, Gd^Fetd, Uue^Efs, Ias, Gd^Fetd, Ias, Gd^Fetd, Ias, Uue^Efs, Gd^Fetd, Gd^Fetd, Ias, Uue, Uue^Efs, Xof, Xof, Xof, Xof, Xof, Xof, Xof, Xof, Xof, Xof, Xof, Xof, Xof, Xof
Xof, Xof, Xof, Xof, Xof, Xof, Xof, Xof, Xof, Xof, Xof, Xof, Xof, Xof, Xof, Xof, Uue^Efs, Ias, Gd^Fetd, Xoi, Xoi, Xoi, Gd^Fetd, Ias, Gd^Fetd, Xoi, Xoi, Xoi, Gd^Fetd, Ias, Uue^Efs, Xof, Xof, Xof, Xof, Xof, Xof, Xof, Xof, Xof, Xof, Xof, Xof, Xof, Xof, Xof
Xof, Xof, Xof, Xof, Xof, Xof, Xof, Xof, Xof, Xof, Xof, Xof, Xof, Xof, Xof, Xof, Uue^Efs, Ias, Gd^Fetd, Xoi, Xoi, Xoi, Gd^Fetd, Ias, Gd^Fetd, Xoi, Xoi, Xoi, Gd^Fetd, Ias, Uue^Efs, Xof, Xof, Xof, Xof, Xof, Xof, Xof, Xof, Xof, Xof, Xof, Xof, Xof, Xof, Xof
Xof, Xof, Xof, Xof, Xof, Xof, Xof, Xof, Xof, Xof, Xof, Xof, Xof, Xof, Xof, Xof, Uue^Efs, Ias, Gd^Fetd, Xoi, Xoi, Xoi, Gd^Fetd, Ias, Gd^Fetd, Xoi, Xoi, Xoi, Gd^Fetd, Ias, Uue^Efs, Xof, Xof, Xof, Xof, Xof, Xof, Xof, Xof, Xof, Xof, Xof, Xof, Xof, Xof, Xof
Xof, Xof, Xof, Xof, Xof, Xof, Uue^Ve, Xof, Xof, Xof, Xof, Xof, Xof, Xof, Xof, Xof, Uue^Efs, Ias, Gd^Fetd, Xof^Efs, Xof^Efs, Xof^Efs, Gd^Fetd, Ias, Gd^Fetd, Xof^Efs, Xof^Efs, Xof^Efs, Gd^Fetd, Ias, Uue^Efs, Xof, Xof, Xof, Xof, Xof, Xof, Xof, Xof, Xof, Uue^Ve, Xof, Xof, Xof, Xof, Xof
Xof, Xof, Xof, Xof, Xof, Gd^Fetd, Uue^Ebn, Uue, Xof, Xof, Xof, Xof, Xof, Xof, Gd^Fetd, Xof, Uue, Ias, Ias, Gd^Fetd, Gd^Fetd, Gd^Fetd, Ias, Ias, Ias, Gd^Fetd, Gd^Fetd, Gd^Fetd, Ias, Ias, Uue, Xof, Gd^Fetd, Xof, Xof, Xof, Xof, Xof, Xof, Uue, Uue^Ebn, Gd^Fetd, Xof, Xof, Xof, Xof
Xof, Xof, Gd^Fetd, Uue^Ve, Uue, Uue, Uue, Gd^Fetd, Xof, Xof, Xof, Xof, Xof, Xof, Uue, Uue, Ias, Ias, Uue, Ias, Ias, Ias, Uue, Xof, Uue, Ias, Ias, Ias, Uue, Ias, Ias, Uue, Uue, Xof, Xof, Xof, Xof, Xof, Xof, Gd^Fetd, Uue, Uue, Uue, Uue, Gd^Fetd, Xof
Xof, Xof, Uue, Uue^Ebn, Gd^Fetd, Xof, Xof, Xof, Xof, Xof, Xof, Gd^Fetd, Uue, Uue, Ias, Ias, Uue, Uue, Xof, Uue, Ias, Uue, Xof, Xof, Xof, Uue, Ias, Uue, Xof, Uue, Uue, Ias, Ias, Uue, Uue, Gd^Fetd, Xof, Xof, Xof, Xof, Xof, Xof, Gd^Fetd, Uue^Ebn, Uue^Ve, Xof
Xof, Xof, Xof, Uue, Xof, Xof, Xof, Xof, Gd^Fetd, Xof, Uue, Uue, Ias, Ias, Uue, Uue, Xof, Gd^Fetd, Xof, Uue, Ias, Uue, Gd^Fetd, Xof, Gd^Fetd, Uue, Ias, Uue, Xof, Gd^Fetd, Xof, Uue, Uue, Ias, Ias, Uue, Uue, Xof, Gd^Fetd, Xof, Xof, Xof, Xof, Uue, Xof, Xof
Xof, Xof, Uue^Ve, Uue, Gd^Fetd, Xof, Gd^Fetd, Xof, Uue, Uue, Ias, Ias, Uue, Uue, Xof, Gd^Fetd, Xof, Xof, Xof, Uue, Ias, Uue, Xof, Xof, Xof, Uue, Ias, Uue, Xof, Xof, Xof, Gd^Fetd, Xof, Uue, Uue, Ias, Ias, Uue, Uue, Xof, Gd^Fetd, Xof, Gd^Fetd, Uue, Gd^Fetd, Xof
Xof, Xof, Gd^Fetd, Uue^Ebn, Uue, Xof, Uue, Uue, Ias, Ias, Uue, Uue, Xof, Gd^Fetd, Xof, Xof, Uue^Ve, Gd^Fetd, Ias, Uue, Ias, Uue, Gd^Fetd, Xof, Gd^Fetd, Uue, Ias, Uue, Ias, Gd^Fetd, Uue^Ve, Xof, Xof, Gd^Fetd, Xof, Uue, Uue, Ias, Ias, Uue, Uue, Xof, Uue, Uue^Ebn, Uue^Ve, Xof
Xof, Xof, Xof, Ias, Ias, Uue, Ias, Ias, Ias, Uue, Xof, Gd^Fetd, Xof, Xof, Xof, Xof, Gd^Fetd, Uue^Eb, Ias, Ias, Ias, Uue, Xof, Xof, Xof, Uue, Ias, Ias, Ias, Uue^Eb, Gd^Fetd, Xof, Xof, Xof, Gd^Fetd, Xof, Uue, Ias, Uue, Ias, Ias, Uue, Ias, Ias, Xof, Xof
Xof, Gd^Fetd, Uue, Uue, Ias, Ias, Uue, Uue, Ias, Uue, Uue, Xof, Gd^Fetd, Xof, Gd^Fetd, Xof, Xof, Uue, Xof, Uue^Eb, Ias, Uue, Xof, Gd^Fetd, Xof, Uue, Ias, Uue^Eb, Xof, Uue, Xof, Xof, Gd^Fetd, Xof, Uue, Uue, Ias, Ias, Xof, Uue, Uue, Ias, Ias, Uue, Xof, Xof
Xof, Xof, Uue, Ias, Uue, Uue, Gd^Fetd, Xof, Uue, Ias, Ias, Uue, Uue, Xof, Uue, Xof, Uue, Uue, Ias, Ias, Uue, Ias, Ias, Uue^Ve, Ias, Ias, Uue, Ias, Ias, Uue, Ias, Uue, Uue, Uue, Ias, Ias, Uue, Uue, Xof, Gd^Fetd, Xof, Uue, Ias, Uue, Gd^Fetd, Xof
Xof, Xof, Uue, Ias, Uue, Xof, Xof, Xof, Gd^Fetd, Uue, Uue, Ias, Ias, Ias, Ias, Ias, Ias, Ias, Uue, Xof, Gd^Fetd, Xof, Uue, Ias, Uue, Xof, Gd^Fetd, Xof, Uue, Ias, Uue, Ias, Ias, Ias, Ias, Uue, Xof, Gd^Fetd, Xof, Xof, Gd^Fetd, Uue, Ias, Uue, Xof, Xof
Xof, Gd^Fetd, Uue, Ias, Uue, Gd^Fetd, Xof, Xof, Xof, Xof, Uue, Ias, Uue, Uue, Uue, Uue, Xof, Uue, Gd^Fetd, Xof, Xof, Xof, Uue, Ias, Uue, Xof, Xof, Xof, Gd^Fetd, Uue^Ve, Gd^Fetd, Uue, Xof, Uue, Ias, Uue, Gd^Fetd, Xof, Xof, Xof, Xof, Uue, Ias, Uue, Xof, Xof
Xof, Xof, Uue, Ias, Uue, Xof, Xof, Gd^Fetd, Uue, Xof, Uue, Ias, Uue, Xof, Xof, Gd^Fetd, Xof, Xof, Xof, Xof, Xof, Gd^Fetd, Uue, Ias, Uue, Gd^Fetd, Xof, Xof, Xof, Xof, Xof, Xof, Gd^Fetd, Uue, Ias, Uue, Xof, Xof, Xof, Xof, Gd^Fetd, Uue, Ias, Uue, Gd^Fetd, Xof
Xof, Xof, Uue, Ias, Ias, Uue, Ias, Uue, Ias, Uue, Ias, Ias, Uue, Gd^Fetd, Xof, Xof, Xof, Xof, Xof, Xof, Xof, Xof, Uue, Ias, Uue, Xof, Xof, Xof, Xof, Xof, Xof, Xof, Xof, Uue, Ias, Uue, Gd^Fetd, Xof, Xof, Xof, Xof, Uue, Ias, Uue, Xof, Xof
Xof, Gd^Fetd, Uue, Ias, Uue, Ias, Uue, Ias, Uue, Ias, Uue, Ias, Uue, Xof, Uue, Gd^Fetd, Uue, Gd^Fetd, Uue, Gd^Fetd, Uue, Xof, Uue, Ias, Uue, Xof, Uue, Gd^Fetd, Uue, Gd^Fetd, Uue, Gd^Fetd, Uue, Uue, Ias, Uue, Xof, Xof, Xof, Xof, Gd^Fetd, Uue, Ias, Uue, Xof, Xof
Xof, Xof, Uue, Ias, Uue, Uue, Xof, Uue, Xof, Xof, Uue, Ias, Ias, Uue, Ias, Uue, Ias, Uue, Ias, Uue, Ias, Ias, Ias, Ias, Ias, Ias, Ias, Uue, Ias, Uue, Ias, Ias, Ias, Ias, Ias, Uue, Xof, Xof, Gd^Fetd, Xof, Uue, Uue, Ias, Uue, Gd^Fetd, Xof
Xof, Xof, Uue, Ias, Uue, Gd^Fetd, Xof, Xof, Xof, Gd^Fetd, Uue, Ias, Uue, Ias, Gd^Fetd, Ias, Uue, Ias, Ias, Ias, Uue, Uue, Uue, Uue, Uue, Uue, Uue, Ias, Uue, Ias, Gd^Fetd, Uue, Uue, Uue, Uue^Eb, Uue, Xof, Uue^Ve, Uue^Eb, Ias, Ias, Ias, Ias, Uue, Xof, Xof
Xof, Gd^Fetd, Uue, Ias, Uue, Xof, Gd^Fetd, Uue^Ve, Gd^Fetd, Xof, Uue, Ias, Uue, Xof, Xof, Xof, Gd^Fetd, Uue, Ias, Uue, Gd^Fetd, Xof, Gd^Fetd, Xof, Xof, Xof, Uue, Ias, Uue, Xof, Xof, Xof, Xof, Gd^Fetd, Uue^Ve, Gd^Fetd, Xof, Uue, Gd^Fetd, Uue, Xof, Uue, Ias, Uue, Xof, Xof
Xof, Xof, Uue, Ias, Uue, Xof, Uue, Uue^Eb, Uue, Xof, Uue, Ias, Uue, Gd^Fetd, Xof, Xof, Xof, Uue, Ias, Uue, Xof, Xof, Xof, Xof, Xof, Gd^Fetd, Uue, Ias, Uue, Gd^Fetd, Xof, Xof, Xof, Xof, Xof, Xof, Xof, Xof, Xof, Xof, Gd^Fetd, Uue, Ias, Uue, Gd^Fetd, Xof
Xof, Xof, Uue, Ias, Uue, Xof, Uue, Ias, Uue, Xof, Ias, Ias, Uue, Xof, Xof, Xof, Gd^Fetd, Uue, Ias, Uue, Gd^Fetd, Xof, Xof, Xof, Xof, Xof, Uue, Ias, Uue, Xof, Xof, Xof, Xof, Xof, Xof, Xof, Xof, Xof, Gd^Fetd, Xof, Uue, Uue, Ias, Uue, Xof, Xof
Xof, Gd^Fetd, Uue, Ias, Ias, Uue, Ias, Ias, Ias, Uue, Ias, Uue, Xof, Gd^Fetd, Xof, Xof, Uue, Uue, Ias, Uue, Xof, Xof, Xof, Xof, Xof, Gd^Fetd, Uue, Ias, Uue, Gd^Fetd, Xof, Xof, Xof, Xof, Xof, Xof, Gd^Fetd, Xof, Uue, Uue, Ias, Ias, Uue, Xof, Xof, Xof
Xof, Xof, Xof, Uue, Uue, Ias, Uue, Xof, Uue, Ias, Uue, Uue^Ve, Xof, Xof, Uue, Gd^Fetd, Ias, Ias, Uue, Gd^Fetd, Xof, Xof, Xof, Xof, Xof, Xof, Uue, Ias, Uue, Uue^Ve, Gd^Fetd, Xof, Xof, Xof, Gd^Fetd, Xof, Uue, Uue, Ias, Ias, Uue, Ias, Ias, Xof, Xof, Xof
Xof, Xof, Xof, Gd^Fetd, Uue, Ias, Uue^Ve, Xof, Uue, Ias, Uue, Xof, Uue, Gd^Fetd, Ias, Ias, Uue, Uue, Gd^Fetd, Xof, Xof, Xof, Xof, Xof, Xof, Gd^Fetd, Uue, Ias, Ias, Uue, Uue, Xof, Gd^Fetd, Xof, Uue, Uue, Ias, Ias, Uue, Uue, Xof, Uue, Ias, Uue, Xof, Xof
Xof, Xof, Xof, Xof, Uue, Ias, Ias, Uue, Uue, Ias, Uue, Uue, Ias, Ias, Uue, Uue, Gd^Fetd, Xof, Xof, Xof, Xof, Xof, Xof, Xof, Xof, Xof, Gd^Fetd, Uue, Uue, Ias, Ias, Uue, Uue, Uue, Ias, Ias, Uue, Uue, Xof, Gd^Fetd, Xof, Uue, Ias, Uue, Xof, Xof
Xof, Xof, Xof, Gd^Fetd, Xof, Uue, Uue, Ias, Ias, Ias, Ias, Ias, Uue, Uue, Gd^Fetd, Xof, Xof, Xof, Xof, Xof, Xof, Xof, Xof, Xof, Xof, Xof, Xof, Xof, Gd^Fetd, Uue, Uue, Ias, Ias, Ias, Uue, Uue, Xof, Gd^Fetd, Xof, Xof, Gd^Fetd, Uue, Ias, Uue, Xof, Xof
Xof, Xof, Xof, Xof, Xof, Xof, Ias, Ias, Uue, Ias, Ias, Uue, Uue, Xof, Xof, Xof, Xof, Xof, Xof, Xof, Xof, Xof, Xof, Xof, Xof, Xof, Xof, Xof, Xof, Xof, Gd^Fetd, Uue, Uue, Ias, Uue, Gd^Fetd, Xof, Xof, Xof, Xof, Xof, Uue, Ias, Uue, Xof, Xof
Xof, Xof, Xof, Xof, Xof, Uue, Ias, Uue, Xof, Uue, Gd^Fetd, Ias, Ias, Uue, Uue, Gd^Fetd, Xof, Xof, Xof, Xof, Xof, Xof, Xof, Xof, Xof, Xof, Xof, Xof, Xof, Xof, Xof, Xof, Uue, Ias, Uue, Xof, Xof, Xof, Xof, Xof, Gd^Fetd, Uue, Ias, Uue, Xof, Xof
Xof, Xof, Uue^Ve, Gd^Fetd, Uue, Gd^Fetd, Ias, Uue, Gd^Fetd, Xof, Xof, Uue, Gd^Fetd, Ias, Ias, Uue, Uue, Gd^Fetd, Xof, Xof, Xof, Xof, Xof, Xof, Xof, Xof, Xof, Xof, Xof, Xof, Xof, Gd^Fetd, Uue, Ias, Uue, Gd^Fetd, Xof, Xof, Xof, Xof, Xof, Uue, Ias, Uue, Xof, Xof
Xof, Xof, Uue, Uue^Eb, Uue, Uue, Ias, Uue, Xof, Xof, Xof, Xof, Xof, Uue, Gd^Fetd, Ias, Ias, Uue, Uue, Gd^Fetd, Xof, Xof, Xof, Xof, Xof, Xof, Xof, Xof, Xof, Xof, Gd^Fetd, Xof, Uue, Ias, Uue, Xof, Xof, Xof, Xof, Xof, Gd^Fetd, Uue, Ias, Gd^Fetd, Uue^Ve, Xof
Xof, Xof, Xof, Gd^Fetd, Xof, Gd^Fetd, Ias, Uue, Xof, Gd^Fetd, Xof, Xof, Xof, Xof, Xof, Uue, Gd^Fetd, Ias, Ias, Uue, Uue, Gd^Fetd, Xof, Xof, Xof, Xof, Xof, Xof, Gd^Fetd, Xof, Uue, Uue, Ias, Ias, Xof, Gd^Fetd, Xof, Xof, Gd^Fetd, Xof, Uue, Uue, Ias, Uue^Eb, Uue, Xof
Xof, Xof, Xof, Xof, Xof, Uue, Ias, Uue, Uue, Uue, Uue, Xof, Gd^Fetd, Xof, Uue, Xof, Xof, Uue, Gd^Fetd, Ias, Ias, Uue, Xof, Xof, Xof, Xof, Gd^Fetd, Xof, Uue, Uue, Ias, Ias, Uue, Uue, Gd^Fetd, Xof, Gd^Fetd, Xof, Uue, Uue, Ias, Ias, Ias, Gd^Fetd, Xof, Xof
Xof, Xof, Uue^Ve, Gd^Fetd, Uue, Gd^Fetd, Ias, Ias, Ias, Ias, Ias, Ias, Ias, Ias, Ias, Uue, Gd^Fetd, Xof, Xof, Uue, Ias, Gd^Fetd, Xof, Xof, Xof, Xof, Uue, Uue, Ias, Ias, Uue, Uue, Gd^Fetd, Xof, Xof, Xof, Uue, Uue, Ias, Ias, Uue, Uue, Ias, Uue, Xof, Xof
Xof, Xof, Uue, Uue^Eb, Uue, Uue, Ias, Uue, Xof, Gd^Fetd, Xof, Uue, Uue, Uue, Uue, Ias, Ias, Uue, Uue, Uue, Ias, Ias, Gd^Fetd, Xof, Gd^Fetd, Ias, Ias, Ias, Uue, Uue, Gd^Fetd, Xof, Xof, Xof, Gd^Fetd, Uue, Ias, Ias, Uue, Uue, Xof, Uue, Ias, Gd^Fetd, Uue^Ve, Xof
Xof, Xof, Xof, Gd^Fetd, Xof, Gd^Fetd, Ias, Uue, Gd^Fetd, Xof, Xof, Gd^Fetd, Xof, Xof, Gd^Fetd, Uue, Uue, Ias, Ias, Ias, Gd, Gd, Re, Xof, Gd, Gd^Fetd, Gd, Ias, Ias, Xof, Xof, Xof, Gd^Fetd, Uue, Ias, Ias, Uue, Uue, Xof, Gd^Fetd, Xof, Uue, Ias, Uue^Eb, Uue, Xof
Xof, Xof, Xof, Xof, Xof, Uue, Ias, Uue, Xof, Xof, Xof, Xof, Xof, Xof, Xof, Xof, Uue, Ias, Gd^Fetd, Gd^Fetd, Re^Ve, Re, Qxua^Cov, Re, Qxua^Cov, Re, Re^Ve, Gd^Fetd, Ias, Xof, Xof, Xof, Xof, Uue, Ias, Uue, Xof, Gd^Fetd, Xof, Xof, Gd^Fetd, Uue, Ias, Gd^Fetd, Xof, Xof
Xof, Xof, Uue^Ve, Gd^Fetd, Uue, Uue, Ias, Uue, Xof, Gd^Fetd, Xof, Xof, Xof, Gd^Fetd, Uue, Uue, Ias, Ias, Gd, Re, Rb, Rb, Qxua^Cov, Qxua, Qxua^Cov, Rb, Rb, Gd^Fetd, Xof, Xof, Uue, Gd^Fetd, Uue, Uue, Ias, Uue, Gd^Fetd, Xof, Gd^Fetd, Xof, Uue, Uue, Ias, Uue, Gd^Fetd, Xof
Xof, Xof, Uue, Uue^Eb, Uue, Uue, Ias, Uue, Ias, Uue, Uue, Gd^Fetd, Uue, Uue, Ias, Ias, Uue, Ias, Gd^Fetd, Re, Rb, Qxua^Cov, Qxua, Qxua^Cov, Qxua, Qxua^Cov, Rb, Re, Gd, Ias, Ias, Uue, Ias, Ias, Ias, Uue, Uue, Xof, Uue, Uue, Ias, Ias, Uue, Uue, Xof, Xof
Xof, Xof, Xof, Gd^Fetd, Xof, Uue, Ias, Ias, Uue, Ias, Ias, Uue, Ias, Ias, Uue, Uue, Xof, Xof, Gd^Fetd, Re, Rb, Rb^Cov, Re^Cov, 2 Re^Kov, Re^Cov, Rb^Cov, Rb, Re, Gd^Fetd, Ias, Gd^Fetd, Ias, Uue, Uue, Uue, Ias, Ias, Uue, Ias, Ias, Uue, Uue, Xof, Gd^Fetd, Xof, Xof
Xof, Xof, Xof, Xof, Xof, Gd^Fetd, Gd^Fetd, Gd^Fetd, Xof, Uue, Uue, Ias, Uue, Uue, Xof, Gd^Fetd, Xof, Xof, Gd^Fetd, Re^Ve, Re, Re, Gd^Fetd, Gd^Fetd, Gd^Fetd, Re, Re^Ve, Re, Gd^Fetd, Xof, Xof, Xof, Gd^Fetd, Xof, Gd^Fetd, Uue, Uue, Ias, Uue, Uue, Xof, Gd^Fetd, Xof, Xof, Xof, Xof
Xof, Xof, Xof, Xof, Xof, Xof, Xof, Xof, Xof, Gd^Fetd, Xof, Gd^Fetd, Xof, Gd^Fetd, Xof, Xof, Xof, Xof, Xof, Gd^Fetd, Gd^Fetd, Gd^Fetd, Xof, Xof, Xof, Gd^Fetd, Gd^Fetd, Gd^Fetd, Xof, Xof, Xof, Xof, Xof, Xof, Xof, Xof, Gd^Fetd, Uue, Xof, Gd^Fetd, Xof, Xof, Xof, Xof, Xof, Xof
Xof, Xof, Xof, Xof, Xof, Xof, Xof, Xof, Xof, Xof, Xof, Xof, Xof, Xof, Xof, Xof, Xof, Xof, Xof, Xof, Xof, Xof, Xof, Xof, Xof, Xof, Xof, Xof, Xof, Xof, Xof, Xof, Xof, Xof, Xof, Xof, Xof, Xof, Xof, Xof, Xof, Xof, Xof, Xof, Xof, Xof
