Xoi, Xoi, Xoi, Xoi, Xoi, Xoi, Xoi, Xoi, Xoi, Xoi, Xoi, Xoi, Xoi, Xoi, Xoi, Irs, Irs, Irs, Xoi, Xoi, Xoi, Xoi, Xoi, Xoi, Xoi, Xoi, Xoi, Xoi, Xoi, Xoi, Xoi, Xoi, Xoi, Xoi, Xoi
Xoi, Xoi, Xoi, Xoi, Xoi, Xoi, Xoi, Xoi, Xoi, Xoi, Xoi, Xoi, Xoi, Xoi, Xoi, Irs, Irs^Cov, Irs, Xoi, Xoi, Xoi, Xoi, Xoi, Xoi, Xoi, Xoi, Xoi, Xoi, Xoi, Xoi, Xoi, Xoi, Xoi, Xoi, Xoi
Xoi, Xoi, Xoi, Xoi, Xoi, Xoi, Xoi, Xoi, Xoi, Xoi, Xoi, Xoi, Xoi, Xoi, Xoi, Irs^Cov, Irs^Kov, Irs^Cov, Xoi, Xoi, Xoi, Xoi, Xoi, Xoi, Xoi, Xoi, Irs^Eb, Xoi, Xoi, Xoi, Xoi, Xoi, Xoi, Xoi, Xoi
Xoi, Xoi, Xoi, Xoi, Xoi, Xoi, Irs^Eb, Xoi, Xoi, Xoi, Xoi, Xoi, Xoi, Xoi, Xoi, Irs^Cov, Irs^Cov, Irs^Cov, Xoi, Xoi, Xoi, Xoi, Xoi, Xoi, Irs, Irs, Irs, Irs, Irs^Ebn, Xoi, Xoi, Xoi, Xoi, Xoi, Xoi
Xoi, Xoi, Xoi, Xoi, Irs^Eb, Irs, Irs, Irs, Xoi, Xoi, Irs^Ebn, Xoi, Xoi, Xoi, Xoi, Irs, Irs^Cov, Irs, Xoi, Xoi, Xoi, Xoi, Irs^Ebn, Xoi, Xoi, Irs, Irs, Irs, Irs, Xoi, Xoi, Xoi, Xoi, Xoi, Xoi
Xoi, Xoi, Xoi, Xoi, Irs, Irs, Rr^Pr/, Xoi^Efs, Irs, Irs, Irs, Irs, Irs, Xoi, Xoi^Efs, Irs^Cov, Irs, Irs^Cov, Xoi^Efs, Xoi, Irs, Irs, Wog, Irs, Irs, Xoi^Efs, Rr^Pr\, Irs, Irs, Xoi, Xoi, Xoi, Xoi, Xoi, Xoi
Xoi, Xoi, Xoi, Xoi, Xoi, Xoi, Irs, Irs, Irs, Irs, Irs, Irs, Irs, Irs, Irs, Irs, Irs, Irs, Irs, Irs, Wog^Bsb\, Wog^Bsb\, Irs, Wog, Wog, Irs, Irs, Xoi, Xoi, Xoi, Xoi, Xoi, Xoi, Xoi, Xoi
Xoi, Xoi, Xoi, Xoi, Irs, Irs, Irs, Irs, Irs, Irs, Xoi, Irs, Irs, Irs, Irs, Irs, Irs, Irs, Wog, Wog, Irs, Irs, Xoi, Irs, Irs, Wog, Wog, Irs, Irs, Xoi, Xoi, Xoi, Xoi, Xoi, Xoi
Xoi, Xoi, Xoi, Xoi, Irs, Irs, Irs, Irs, Xoi, Xoi, Xoi, Xoi, Xoi, Irs, Irs, Irs, Wog, Wog, Irs, Irs, Xoi, Xoi, Xoi, Xoi, Xoi, Irs, Irs, Wog, Wwg, Xoi, Xoi, Xoi, Xoi, Xoi, Wog
Xoi, Xoi, Xoi, Xoi, Irs, Irs, Xoi, Xoi, Xoi, Xoi, Xoi, Xoi, Xoi, Xoi, Xoi, Irs, Wog, Irs, Xoi, Xoi, Xoi, Xoi, Xoi, Xoi, Xoi, Xoi, Xoi, Irs, Irs, Wwg, Wwg, Xoi, Wog, Wog, Xoi
Xoi, Xoi, Xoi, Xoi, Irs, Irs, Xoi, Xoi, Xoi, Xoi, Xoi, Xoi, Xoi, Xoi, Xoi, Xoi, Wog, Xoi, Xoi, Xoi, Xoi, Xoi, Xoi, Xoi, Xoi, Xoi, Xoi, Irs, Irs, Xoi, Xoi, Wog, Xoi, Xoi, Xoi
Xoi, Xoi, Xoi, Xoi, Irs, Irs, Xoi^Efs, Xoi, Irs, Irs, Irs, Xoi, Xoi, Xoi, Xoi, Xoi, Wog, Xoi, Xoi, Xoi, Xoi, Xoi, Irs, Irs, Irs, Xoi, Xoi^Efs, Irs, Irs, Xoi, Xoi, Xoi, Xoi, Xoi, Xoi
Xoi, Xoi, Xoi, Xoi, Irs, Irs, Irs, Irs, Irs, Irs, Irs, Irs, Irs, Xoi, Xoi^Efs, Xoi, Wwg, Xoi, Xoi^Efs, Xoi, Irs, Irs, Irs, Irs, Irs, Irs, Irs, Irs, Irs, Xoi, Xoi, Xoi, Xoi, Xoi, Xoi
Xoi, Xoi, Xoi, Xoi, Irs, Irs, Irs, Irs, Irs, Irs, Irs, Irs, Irs, Irs, Irs, Irs, Wwg, Irs, Irs, Irs, Irs, Irs, Irs, Irs, Irs, Irs, Irs, Irs, Irs, Xoi, Xoi, Xoi, Xoi, Xoi, Xoi
Xoi, Xoi, Xoi, Xoi, Irs^Ebn, Irs, Xoi^Efs, Xoi, Xoi^Efs, Irs, Irs, Irs, Irs, Irs, Xoi, Irs, Wwg, Irs, Xoi, Irs, Irs, Irs, Irs, Irs, Xoi, Xoi, Xoi, Irs, Irs^Ebn, Xoi, Xoi, Xoi, Xoi, Xoi, Xoi
Xoi, Xoi, Xoi, Xoi, Xoi^Efs, Xoi^Efs, Irs, Irs, Irs, Xoi^Efs, Xoi^Efs, Irs, Irs, Irs, Xoi, Irs, Wwg, Irs, Xoi, Irs, Irs, Irs, Xoi, Xoi, Irs, Irs^Eb, Irs, Xoi, Xoi, Xoi, Xoi, Xoi, Xoi, Xoi, Xoi
Xoi, Xoi, Xoi, Xoi, Irs, Irs, Irs, Irs, Irs, Irs, Irs, Xoi, Irs, Irs, Xoi, Rp, Wwg, Rp, Xoi, Irs, Irs, Xoi, Irs, Irs, Irs, Irs, Irs, Irs, Irs^Eb, Xoi, Xoi, Xoi, Xoi, Xoi, Xoi
Xoi, Xoi, Xoi, Xoi^Efs, Irs, Irs, Irs, Irs, Irs, Irs, Xoi, Xoi, Irs, Irs, Xoi, Rp, Wwg, Rp, Xoi, Irs, Irs, Xoi, Xoi, Irs, Irs, Irs, Irs, Irs, Irs, Xoi, Xoi, Xoi, Xoi, Xoi, Xoi
Xoi, Xoi, Xoi, Xoi^Efs, Irs, Irs, Irs, Irs, Rr^Pr/, Xoi^Efs, Irs, Irs, Irs, Irs, Xoi, Rp, Wog, Rp, Xoi, Irs, Irs, Irs, Irs, Xoi^Efs, Rr^Pr\, Irs, Irs, Irs, Irs, Xoi, Xoi, Xoi, Xoi, Xoi, Xoi
Xoi, Xoi, Xoi, Xoi, Irs, Irs, Xoi^Efs, Xoi, Irs, Irs, Irs, Irs, Xoi^Efs, Xoi^Efs, Gll, Gll, Wog, Gll, Gll, Xoi^Efs, Xoi^Efs, Irs, Irs, Irs, Irs, Xoi, Xoi^Efs, Irs, Irs, Xoi, Xoi, Xoi, Xoi, Xoi, Xoi
Xoi, Xoi, Xoi, Xoi, Xoi, Xoi^Efs, Irs, Irs, Irs, Irs, Xoi^Efs, Xoi^Efs, Gll, Gll, Xoi, Xoi, Wwg, Xoi, Xoi, Gll, Gll, Xoi^Efs, Xoi^Efs, Irs, Irs, Irs, Irs, Xoi^Efs, Xoi, Xoi, Xoi, Xoi, Xoi, Xoi, Xoi
Xoi, Xoi, Xoi, Xoi, Irs, Irs, Irs, Irs, Irs, Xoi, Gll, Gll, Rp, Xoi, Gs^Ftp, Gs^Ftp, Wwg, Gs^Ftp, Gs^Ftp, Xoi, Rp, Gll, Gll, Xoi, Irs, Irs, Irs, Irs, Irs, Xoi, Rp, Rp^Eb, Rp, Xoi, Xoi
Xoi, Xoi, Xoi, Xoi, Irs, Irs, Irs, Irs, Irs, Xoi, Gll, Rp, Xoi, Xoi, Gs^Ftp, Gs^Ftp, Wwf^Ii, Gs^Ftp, Gs^Ftp, Xoi, Xoi, Rp, Gll, Xoi, Irs, Irs, Irs, Irs, Irs, Xoi, Rp, Qxe, Rp, Xoi, Xoi
Xoi, Xoi, Xoi, Xoi, Irs, Irs, Irs, Irs, Irs, Xoi, Gll, Xoi^Efs, Rp, Xoi, Gs^Ftp, Wwf^Ii, Wwf^Fet, Wwf^Ii, Gs^Ftp, Xoi, Rp, Xoi^Efs, Gll, Xoi, Irs, Irs, Irs, Irs, Irs, Xoi, Rp, Rp, Rp, Xoi, Xoi
Xoi, Xoi, Xoi, Xoi, Irs, Irs, Irs, Irs, Xoi, Xoi, Xoi, Gll, Gll, Gll, Gs^Ftp, Wwf^Ii, Wwf^Ii, Wwf^Ii, Gs^Ftp, Gll, Gll, Gll, Xoi, Xoi, Xoi, Irs, Irs, Irs, Irs, Xoi, Xoi, Rp, Xoi, Xoi, Xoi
Xoi, Xoi, Xoi, Xoi, Irs, Irs, Irs, Xoi, Cud, Cud, Qxe, Xoi, Xoi, Xoi, Gs^Ftp, Gs^Ftp, Wwf, Gs^Ftp, Gs^Ftp, Xoi, Xoi, Xoi, Qxe, Cud, Cud, Xoi, Irs, Irs, Irs, Xoi, Xoi, Rr^Pw|, Xoi, Xoi, Xoi
Xoi, Xoi, Xoi, Xoi, Irs, Irs, Irs, Xoi, Qxe, Kud, Cud, Cud, Irs, Xoi, Gs^Ftp, Gs^Ftp, Wwg, Gs^Ftp, Gs^Ftp, Xoi, Irs, Cud, Cud, Kud, Qxe, Xoi, Irs, Irs, Irs, Xoi, Xoi, Rp, Xoi, Xoi, Xoi
Xoi, Xoi, Xoi, Xoi, Irs, Irs, Irs, Xoi, Xoi, Cud, Irs, Irs, Irs, Xoi, Xoi, Gs^Ftp, Wwg, Gs^Ftp, Xoi, Xoi, Irs, Irs, Irs, Cud, Xoi, Xoi, Irs, Irs, Irs, Xoi, Xoi, Rp, Xoi, Xoi, Xoi
Xoi, Xoi, Xoi, Xoi, Irs, Irs, Irs, Irs, Irs, Xoi, Irs, Irs, Irs, Irs, Irs^Ebn, Xoi, Wog, Xoi, Irs^Ebn, Irs, Irs, Irs, Irs, Xoi, Irs, Irs, Irs, Irs, Irs, Xoi, Xoi, Rp, Xoi, Xoi, Xoi
Xoi, Xoi, Xoi, Xoi, Rr^Pr\, Irs, Irs, Irs, Irs, Xoi^Efs, Rr^Pr\, Irs, Irs, Irs, Irs, Xoi, Wog, Xoi, Irs, Irs, Irs, Irs, Rr^Pr/, Xoi^Efs, Irs, Irs, Irs, Irs, Irs, Xoi, Xoi, Rr^Pw|, Xoi, Xoi, Xoi
Xoi, Xoi, Irs, Irs, Irs, Xoi, Irs, Irs, Irs, Irs, Xoi, Xoi, Irs, Irs, Irs, Xoi, 1 Wog, Xoi, Irs, Irs, Irs, Xoi, Xoi, Irs, Irs, Irs, Irs, Irs, Rr^Pw/, Xoi, Irs, Irs, Xoi, Xoi, Xoi
Xoi, Irs, Irs, Irs, Irs, Xoi, Irs, Irs, Irs, Xoi, Irs, Irs, Irs^Ebn, Irs, Irs, Xoi, Wog, Xoi, Irs, Irs, Irs^Ebn, Irs, Irs, Xoi, Irs, Irs, Irs, Xoi, Irs, Irs, Irs, Irs, Irs^Eb, Xoi, Xoi
Xoi, Irs^Eb, Irs, Irs, Irs, Xoi, Irs, Irs, Irs, Xoi, Xoi, Irs, Xoi, Irs, Xoi, Xoi, Wog, Xoi, Xoi, Irs, Xoi, Irs, Xoi, Xoi, Irs, Irs, Irs, Xoi, Irs, Irs, Irs, Irs, Xoi, Xoi, Xoi
Xoi, Xoi, Xoi, Irs, Irs^Eb, Xoi, Irs, Irs, Irs, Xoi, Irs, Xoi^Efs, Irs, Xoi, Irs, Irs, Wwg, Irs, Irs, Xoi, Irs, Xoi^Efs, Irs, Xoi, Irs, Irs, Irs, Xoi, Irs^Ebn, Irs, Xoi, Xoi, Xoi, Xoi, Xoi
Xoi, Xoi, Xoi, Xoi, Xoi, Xoi, Xoi, Irs, Irs, Irs, Irs, Irs, Irs, Irs, Irs, Irs, Wwg, Irs, Irs, Irs, Irs, Irs, Irs, Irs, Irs, Irs, Xoi, Xoi, Xoi, Xoi, Xoi, Xoi, Xoi, Xoi, Xoi
Xoi, Xoi, Xoi, Xoi, Xoi, Xoi, Xoi, Xoi, Xoi, Irs, Irs, Irs, Irs, Irs, Irs, Irs, Wwg, Irs, Irs, Irs, Irs, Irs, Irs, Irs, Xoi, Xoi, Xoi, Xoi, Xoi, Xoi, Xoi, Xoi, Xoi, Xoi, Xoi
Xoi, Xoi, Xoi, Xoi, Xoi, Xoi, Xoi, Xoi, Xoi, Xoi, Xoi, Xoi, Xoi, Xoi, Xoi, Irs, Wwg, Irs, Xoi, Xoi, Xoi, Xoi, Xoi, Xoi, Xoi, Xoi, Xoi, Xoi, Xoi, Xoi, Xoi, Xoi, Xoi, Xoi, Xoi
Xoi, Xoi, Xoi, Xoi, Xoi, Xoi, Xoi, Xoi, Xoi, Xoi, Xoi, Xoi, Xoi, Xoi, Xoi, Ds, Wwg, Ds, Xoi, Xoi, Xoi, Xoi, Xoi, Xoi, Xoi, Xoi, Xoi, Xoi, Xoi, Xoi, Xoi, Xoi, Xoi, Xoi, Xoi
Xoi, Xoi, Xoi, Xoi, Xoi, Xoi, Xoi, Xoi, Xoi, Xoi, Xoi, Xoi, Xoi, Xoi, Ds, Ds, Wwg, Ds, Ds, Xoi, Xoi, Xoi, Xoi, Xoi, Xoi, Xoi, Xoi, Xoi, Xoi, Xoi, Xoi, Xoi, Xoi, Xoi, Xoi
