Dd^Ftd, Dd^Ftd, Dd^Ftd, Ds, Wwt, Wwt, Wwt, Wwt, Wwt, Wwt, Wwt, Wwt, Wwt, Wwt, Wwrt, Wwt, Wwt, Wot, Wot, Wot, Wot, Wot, Wot, Wot, Wot, Wot, Wwrt, Wot, Wot, Wot, Wot, Wot, Wwrt, Wot, Wot, Wot, Wot, Wot, Wot, Wot, Wot, Wot, Wwrt, Wot, Wot, Wot, Wot, Wot, Wot, Wot, Wot, Wot, Wot, Wot, Wot, Wot, Wot, Wot, Wot, Wot, Wot, Wot
Gd^Fts, Dd^Ftd, Dd^Ftd, Ds^Esd, Ds, Wwt, Ds, Wwt, Wwt, Wwt, Wwt, Wwt, Wwt, Wwt, Wwt, Wwrt, Wwt, Wwt, Wot, Wot, Wot, Wot, Wot, Wot, Wot, Wot, Wot, Wwrt, Wot, Wwrt, Wot, Wot, Wot, Wot, Wot, Wot, Wot, Wot, Wot, Wwrt, Wot, Wot, Wot, Wwrt, Wwrt, Wot, Wot, Wot, Wot, Wot, Wot, Wot, Wot, Wot, Wot, Wot, Wwrt, Wot, Wot, Wot, Wot, Wot
Gd, Gd^Fts, Gd, Ds, Ds, Ds, Ds^Esd, Ds, Ds, Wwt, Wwt, Wwt, Wwt, Wwt, Wwt, Wwrt, Wwt, Wwt, Wwt, Wot, Wot, Wot, Wot, Wot, Wot, Wot, Wot, Wot, Wot, Wot, Wot, Wot, Wot, Wot, Wot, Wot, Wot, Wot, Wot, Wot, Wot, Wot, Wot, Wot, Wot, Wot, Wot, Wot, Wot, Wot, Wot, Wwrt, Wot, Wwrt, Wot, Wot, Wot, Wot, Wwrt, Wwrt, Wwrt, Wot
Gd, Gd, Gd^Es, Gd, Dd^Ftd, Ds^Esd, Hd, Ds, Ds, Ds, Wwt, Wwt, Wwt, Wwt, Wwt, Wwrt, Wwrt, Wwt, Wwt, Wwt, Wwt, Wwt, Wwt, Wwt, Wwt, Wot, Wwt, Wot, Wwt, Wot, Wwt, Wot, Wot, Wot, Wot, Wot, Wot, Wot, Wot, Wot, Wot, Wot, Wot, Wot, Wot, Wot, Wot, Wot, Wot, Wot, Wot, Wot, Wot, Wot, Wot, Wot, Wot, Wot, Wot, Wot, Wot, Wwrt
Gd, Gd, Gd, Gd^Fts, Gd, Hd, Hd, Hd, Ds^Esd, Ds, Ds, Wwt, Wwt, Wwt, Wwt, Wwt, Wwt, Wwt, Wwt, Wwt, Wwrt, Wwrt, Wwrt, Wwt, Wwt, Wwt, Wwt, Wwt, Wwt, Wwt, Wwt, Wwt, Wwrt, Wwrt, Wwrt, Wwrt, Wwrt, Wot, Wwt, Wot, Wot, Wot, Wot, Wot, Wot, Wot, Wot, Wot, Wot, Wot, Wot, Wot, Wot, Wot, Wot, Wot, Wot, Wot, Wot, Wot, Wot, Wot
Gd, Gd, Gd, Gd^Fts, Gd^Var, Dd^Ftd, Dd^Ftd, Dd^Ftd, Dd^Ftd, Ds, Ds, Ds, Wwt, Wwt, Wwt, Wwt, Wwt, Wwt, Wwt, Wwt, Wwt, Wwt, Wwt, Wwt, Wwt, Wwt, Wwt, Wwt, Wwt, Wwt, Wwt, Wwt, Wwt, Wwt, Wwt, Wwt, Wwt, Wwt, Wwt, Wwt, Wot, Wot, Wot, Wot, Wot, Wot, Wot, Wot, Wot, Wot, Wot, Wot, Wot, Wot, Wot, Wot, Wot, Wot, Wot, Wot, Wot, Wot
Gd, Gd^Es, Gd, Gd, Gd, Gd^Fts, Gd^Fts, Gd, Gd^Fts, Gd, Ds, Ds, Ds^Esd, Wwt, Wwt, Wwt, Ds^Esd, Wwt, Ds, Wwt, Wwt, Wwt, Wwt, Wwt, Wwt, Wwt, Wwt, Wwt, Wwt, Wwt, Wwt, Wwt, Wwt, Wwt, Wwt, Wwt, Wwt, Wwt, Wwt, Wwt, Wwt, Wot, Wot, Wot, Wot, Wot, Wot, Wot, Wot, Wot, Wwt, Wwt, Wwt, Wwt, Wwt, Wot, Wot, Wot, Wot, Wot, Wot, Wot
Gd, Gd^Es, Rd, Gd, Gd, Gd, Gd, Gd, Gd, Gd, Gd, Ds, Ds, Ds, Ds, Ds, Ds, Ds, Ds, Ds, Ds, Ds, Ds, Wwt, Wwt, Wwt, Wwt, Wwt, Wwt, Wwt, Wwt, Wwt, Wwt, Wwt, Wwt, Wwt, Wwt, Wwt, Wwt, Wwt, Wwt, Wot, Wot, Wot, Wwt, Wot, Wwt, Wot, Wwt, Wwt, Wwt, Wwt, Wwt, Wwt, Wwrt, Wwt, Wwt, Wot, Wot, Wot, Wot, Wot
Gd, Gd, Gd^Es, Rd, Gd^Eba, Rd, Gd, Gd^Es, Gd^Es, Gd, Gd, Gd, Gd, Ds, Ds, Ds, Gd, Ds, Gd, Ds, Ds, Ds, Ds, Ds, Ds, Ds, Ds, Ds, Ds, Ds, Ds, Ds, Ds, Ds, Ds, Wwt, Wwt, Wwt, Wwt, Wwt, Wwt, Wwt, Wwt, Wwt, Wwt, Wwt, Wwt, Wwt, Wwt, Wwt, Wwt, Wwt, Wwt, Wwrt, Wwt, Wwrt, Wwrt, Wwt, Wwt, Wot, Wot, Wot
Gd, Gd, Gd^Es, Gd^Es, Gd, Gd, Arr, Gd, Gd, Gd, Gd^Es, Gd, Gd, Gd, Gd, Gd, Rd, Gd, Gd, Re^Vct, Gd, Gd, Gd, Ce, Ds, Ce, Ds, Ds, Ds, Hd, Hd, Ds, Hd, Ds, Ds, Ds, Wwrt, Wwrt, Wwt, Wwrt, Wwt, Wwt, Wwt, Wwt, Wwt, Wwt, Wwt, Wwt, Wwt, Wwt, Wwt, Wwt, Wwt, Wwt, Wwt, Wwt, Wwt, Wwrt, Wwt, Wwt, Wwt, Wwt
Gd, Rd, Rd, Gd, Gd, Arr, Arr, Arr, Gd, Gd, Gd^Var, Gd^Es, Rd, Gd, Gd, Gd, Gd, Rd, Gd^Fts, Gd, Gd, Gd, Ce, Ce, 1 Ke, Ce, Ce, Gd, Dd^Ftd, Dd^Ftd, Dd^Ftd, Hd, Hd, Ds^Esd, Ds, Ds, Wwt, Wwt, Wwt, Wwrt, Wwt, Wwrt, Wwrt, Wwt, Wwrt, Wwrt, Wwt, Wwrt, Wwt, Wwt, Ds, Wwt, Ds, Wwt, Wwt, Wwt, Wwt, Wwt, Wwt, Wwt, Wwt, Wwt
Gd, Gd, Gd, Gd, Gd, Gd, Gd^Es, Gd, Gd^Es, Gd, Gd, Gd, Gd^Es, Gd^Es, Gd, Rd, Gd, Gd^Fts, Gd^Fts, Rd, Gd, Gd, Ce, Gd, Gd, Gd, Ce, Gd, Re^Vct, Dd^Ftd, Dd^Ftd, Hd, Ds, Ds, Wwt, Wwt, Wwt, Wwt, Wwt, Wwt, Ds, Ds, Ds, Wwt, Wwt, Wwt, Wwt, Wwt, Wwt, Ds, Ds, Ds, Ds^Esd, Ds, Ds, Wwt, Wwt, Wwt, Wwt, Wwrt, Wwrt, Wwt
Arr, Gd, Gd, Gd, Rd, Gd, Gd, Gd^Es, Rd, Rd, Gd, Gd, Gd^Es, Gd, Arr, Gd, Gd, Gd, Rd, Gd^Fts, Gd, Gd, Gd, Gd, Gd, Gd, Gd, Gd^Fts, Gd^Fts, Gd^Fts, Gd, Hd, Ds^Esd, Ds, Wwt, Wwt, Wwt, Wwt, Wwt, Ds, Dd^Ftd, Dd^Ftd, Ds^Esd, Ds^Esd, Wwt, Wwt, Wwt, Wwt, Wwt, Wwt, Ds^Esd, Ds, Ds, Ds^Esd, Ds, Wwt, Wwt, Wwt, Wwt, Wwt, Wwt, Wwt
Arr, Arr, Gd, Gd, Gd, Gd, Gd, Gd, Gd, Gd, Gd, Rd^Es, Gd, Gd, Gd, Gd, Arr, Gd, Gd, Gd^Fts, Rd, Gd, Gd, Gd, Gd^Es, Gd, Rd, Gd, Gd, Gd, Gd, Ds^Esd, Ds, Ds, Wwt, Wwt, Wwrt, Wwrt, Wwrt, Ds^Esd, Ds, Dd^Ftd, Dd^Ftd, Ds, Wwt, Wwt, Wwt, Wwt, Wwt, Wwf, Ds, Ds, Hd, Ds, Ds, Ds, Ds, Wwt, Wwt, Wwt, Wwt, Wwt
Arr, Arr, Gd, Gd, Rd, Gd, Hhd, Hhd, Hhd, Hhd, Gd, Gd, Gd, Gd, Gd, Gd, Gd, Gd, Gd^Es, Gd, Gd, Gd, Gd^Es, Gd, Rd, Re^Vct, Gd, Gd, Rd, Gd, Gd, Ds, Ds^Esd, Ds, Wwf, Wwt, Wwt, Wwt, Wwt, Wwf, Ds, Dd^Ftd, Ds, Ds, Wwrt, Wwt, Wwrt, Wwt, Wwt, Ds, Ds, Hd, Hd, Hd, Hd, Ds, Ds^Esd, Ds, Wwt, Wwt, Wwt, Wwt
Gd, Gd, Gd, Gd, Gd^Fts, Hhd, Md, Md, Md, Hhd, Hhd, Gd, Gd, Rd, Rd, Gd^Es, Gd, Gd, Gd, Gd^Es, Gd, Gd, Gd, Gd, Gd, Gd, Rd, Gd, Gd, Rd^Es, Gd, Ds^Esd, Ds, Ds, Ds, Wwt, Wwt, Wwt, Wwt, Wwt, Wwt, Ds, Wwt, Wwt, Wwt, Wwrt, Wwt, Wwt, Wwt, Ds^Esd, Ds, Hd, Hd, Hd, Hd, Dd^Ftd, Ds, Ds, Wwt, Wwt, Wwt, Wwt
Gd^Es, Gd, Rd, Rd, Gd^Fts, Hhd^Fts, Hhd, Md, Md, Md, Hhd^Fts, Gd^Fts, Gd, Gd, Rd, Gd, Gd, Arr, Gs^Var, Gd, Gd, Gd, Gd, Gd, Gd, Gd, Gd, Rd, Gd, Rd^Es, Gd, Gd, Gd, Ds, Ds, Wwt, Wwt, Wwt, Wwt, Wwt, Wwt, Wwf, Wwt, Wwt, Wwt, Wwt, Wwt, Wwt, Wwf, Ds, Ds, Dd^Ftd, Hd, Hd, Hd, Dd^Ftd, Ds, Ds, Wwt, Wwt, Wwt, Wwt
Gd, Gd^Es, Gd, Rd, Gd, Gd, Gd, Hhd, Md, Md, Hhd, Gd^Fts, Gd, Gd, Gd, Gd, Gd^Fts, Arr, Arr, Arr, Gd, Gd, Gd, Gd, Arr, Rd, Gd^Fts, Gd, Gd, Gd^Es, Gd^Fts, Gd^Fts, Dd^Ftd, Ds, Ds, Ds^Esd, Wwt, Wwt, Wwt, Wwt, Wwt, Wwf, Wwt, Wwt, Ds, Wwt, Ds^Esd, Wwf, Ds, Ds, Ds, Dd^Ftd, Dd^Ftd, Dd^Ftd, Gd, Gd, Ds, Ds, Wwt, Wwt, Wwt, Wwt
Gd, Gd, Gd, Gd, Gd, Gd^Es, Rd, Hhd, Hhd, Hhd, Gd, Gd, Gd, Gd, Rd^Es, Gd, Gd, Gd, Gd, Gd, Gd, Gd, Gd, Gd, Gd, Arr, Gd, Gd^Fts, Gd, Gd, Gd^Fts, Gd, Dd^Ftd, Dd^Ftd, Dd^Ftd, Ds^Esd, Wwt, Wwt, Wwt, Wwt, Ds^Esd, Ds^Esd, Ds, Ds, Ds, Ds^Esd, Ds, Ds, Ds, Ds, Gd, Gd^Fts, Gd^Fts, Gd^Var, Gd^Fts, Gd^Fts, Ds, Ds, Ds, Wwt, Wwt, Wwt
Gd, Gd, Gd, Arr, Gd, Gd^Es, Rd, Gd, Gd, Gd, Gd, Gd^Edpp, Gd, Gd, Gd, Gd^Es, Rd^Es, Gd, Gd, Gd, Gd, Rd, Gd, Gd, Arr, Arr, Gd^Fts, Gd^Fts, Gd, Gd^Es, Gd, Gd^Fts, Dd^Ftd, Dd^Ftd, Ds, Wwt, Wwt, Wwt, Ds, Ds, Ds, Ds, Ds, Ds, Gd, Ds, Gd, Ds^Edpp, Gd, Gd, Gd^Fts, Gd, Gd, Gd^Fts, Gd, Gd, Ds^Esd, Ds, Ds, Wwt, Wwt, Wwt
Rp, Gd, Gs^Var, Gd, Gd, Rd^Ecf, Gd^Es, Gs^Var, Gd^Es, Gd^Es, Hhd, Gd, Hhd, Gd, Gd, Gd, Gd, Gd, Gd, Gd, Gd^Var, Gd, Gd^Edpp, Gd, Gd, Gd, Gd, Gd, Gd, Rd^Es, Gd, Gd^Fts, Gd^Fts, Dd^Ftd, Ss, Wwt, Wwt, Ds, Dd^Ftd, Dd^Ftd, Dd^Ftd, Gd^Fts, Gd, Gd, Rd^Es, Gd, Gd, Gd, Rd, Gd, Gd^Fts, Gd^Fts, Rd, Gd, Gd^Fts, Gd, Gd, Ds, Ds^Esd, Ds, Ds, Wwt
Rd, Rp, Rp, Gd, Gd, Gd, Gd, Gd, Gd, Gd, Hhd, Hhd, Arr, Arr, Arr, Gd^Fts, Gd, Gd, Rd, Rd, Rd, Gd, Rd, Gd, Gd, Gd, Gd, Gd, Rd, Gd, Gd, Sm, Ss, Ss, Wwt, Wwt, Ss, Ds, Dd^Ftd, Dd^Ftd, Gd^Fts, Gd^Fts, Gd, Gd^Es, Gd, Gd^Es, Gd, Gd, Gd, Gd, Gd, Gd, Gd^Eba, Gd, Gd, Rd, Gd^Es, Gd, Gd^Es, Ds, Ds, Ds
Gd, Gd, Gd, Rp, Car, Car, Car, Car, Gd, Gd, Hhd, Hhd, Hhd, Arr, Gd, Gd, Gd, Gd, Gd^Fts, Gd^Fts, Gd, Gd, Gd, Gd, Rd, Gd^Es, Gd, Rd, Gd, Gd, Sm, Sm, Wwt, Wwt, Wwt, Wwt, Ss, Gd, Gd, Gd^Fts, Rd, Gd^Fts, Gd, Gd, Arr, Gd, Arr, Gd^Fts, Gd, Gd, Rd^Es, Rd, Gd, Gd, Hhd, Gd, Hhd, Gd^Es, Gd, Gd, Gd, Ds
Gd, Gd^Ecf, Gd, Gd, Car, 2 Kar, Rp, Car, Gd, Gd, Gd, Hhd, Hhd, Hhd, Gd, Gd, Rd, Gd, Gd, Gd^Fts, Gd, Gd, Gd, Rd, Gd, Gd, Gd, Gd, Gd, Gd, Wwt, Wwt, Wwt, Wwt, Sm, Ss, Sm, Gd, Gd^Es, Gd^Fts, Gd^Fts, Gd, Gd, Gd, Arr, Arr, Rd, Arr, Gd, Gd, Gd^Es, Gd, Hhd, Hhd^Var, Md, Hhd, Md, Hhd, Hhd, Gd, Gd, Gd
Gd, Gd^Es, Gd, Car, Car, Rd, Gd, Rp, Rp, Gd^Ecf, Rp, Gd, Rp, Gd, Gd, Gd, Rd, Gd, Gd^Es, Gd, Gd, Gd, Arr, Gd, Gd, Gd^Es, Gd^Edpp, Gd, Wwt, Wwt, Wwt, Wwt, Gd, Gd^Gor, Gd, Sm, Gd, Gd^Edpp, Gd^Es, Gd, Gd, Gd, Gd^Fts, Arr, Arr, Rd, Gd, Gd, Gd, Rd, Gd^Es, Gd, Hhd, Md, Md, Md, Md, Md, Hhd, Gd, Gd, Gd
Gd, Gd, Wwt, Gd, Gd, Gd, Gd^Ecf, Gd^Es, Gd^Es, Rp, Gd, Rp, Gd, Rp, Rp, Rp, Gd, Rd, Rp, Gd^Es, Gd^Es, Rd, Gd, Gd, Rd, Gd, Gd, Gd, Wwt, Wwt, Sm, Gd^Fts, Gd^Fts, Gd, Gd, Gd, Gd, Gd, Gd, Gd, Gd^Es, Gd, Gd, Gd^Fts, Gd, Arr, Gd, Gd^Var, Gd, Rd^Es, Gd, Gd, Car, Hhd, Hhd, Hhd, Hhd, Md, Md, Hhd, Gd^Es, Gd
Ss, Wwt, Wwt, Wwt, Wwt, Gd, Gd, Gd, Gs^Var, Rp, Gd, Gd, Hhd, Rd, Hhd, Gd, Gd^Fts, Gd, Gd, Rp, Rp, Gd, Rp, Gd, Gd, Rd, Gd, Gd, Wwt, Wwt, Wwt, Gd^Fts, Gd, Gd, Gd, Rd, Gd, Gd^Fts, Rd, Gd, Rd, Gd^Es, Gd, Gd^Es, Gd, Gd^Es, Gd^Es, Gd, Gd, Rd, Rd, Gd, Rd, Car, Car, 4 Kar, Hhd, Md, Hhd, Hhd, Gd, Gd^Es
Wwt, Wwt, Ss, Wwt, Wwt, Wwt, Wwt, Gd, Gd, Gd, Gd, Hhd, Md, Hhd, Md, Hhd, Hhd^Fts, Gd^Fts, Gd, Gd, Gd, Rp, Gd, Rp, Rp, Rp, Rp, Gd, Sm, Wwt, Wwt, Gd, Gd, Gd^Es, Gd^Es, Rd, Rd^Es, Gd, Rd, Gd, Rd, Gd, Gd, Gd, Gd, Gd, Hhd, Gd, Gd, Gd, Gd, Rd, Gd^Var, Rd, Car, Hhd, Md, Md, Md, Hhd, Gd^Es, Gd
Sm, Sm, Gd, Sm, Sm, Wwt, Wwt, Gd, Gd^Es, Gd^Es, Gd, Hhd, Md, Md, Md, Md, Hhd^Sor, Gd^Fts, Rd, Gd, Hhd, Gd, Hhd, Gd^Es, Gd, Gd, Gd, Rp, Wwt^Bh\, Wwt, Wwt, Gd, Gd^Es, Gd, Gd, Gd, Hhd, Gd, Gd, Gd, Gd, Gd, Gd, Gd, Hhd, Hhd, Md, Hhd, Hhd, Hhd, Gd, Rd, Rd, Rd, Car, Hhd, Hhd, Md, Hhd, Hhd, Gd, Gd^Es
Gd, Gd^Es, Gd^Es, Gd^Fts, Arr, Wwt, Wwt, Gd, Gd^Es, Gd, Gd, Hhd, Hhd, Md, Md, Md, Hhd, Hhd, Hhd, Hhd, Hhd, Hhd, Hhd, Gd^Es, Rd, Gd, Gd, Gd^Fts, Wwt, Wwt^Bh\, Rp, Gd, Gd, Hhd^Var, Hhd, Hhd, Hhd, Hhd, Hhd, Gd, Gd^Es, Gd^Es, Gd, Hhd, Md, Md, Md, Md, Md, Hhd, Hhd, Gd, Gd, Gd, Gd, Gd, Gd, Hhd, Gd, Hhd, Gd, Gd
Gd, Gd^Es, Gd^Var, Gd, Gd^Fts, Wwt, Wwt, Gd, Gd, Gd^Es, Rd, Rd, Hhd, Md, Hhd, Md, Hhd, Hhd, Hhd, Hhd, Gd, Hhd, Gd, Gd, Rd, Gd, Gd, Gd^Var, Wwt, Wwt, Sm, Rp, Rp, Hhd, Hhd, Hhd, Hhd, Hhd, Hhd, Hhd, Hhd, Gd^Es, Rd, Hhd, Hhd, Md, Md, Md, Md, Md, Md, Hhd, Gd, Rd^Es, Gd, Gd, Hhd^Var, Rd, Hhd, Rd, Hhd, Gd
Gd, Gd, Rd^Es, Gd, Gd, Wwt, Wwt, Sm, Gd, Gd^Es, Gd, Gd, Gd, Hhd, Gd, Hhd, Gd, Rd, Gd, Gd, Gd^Fts, Gd, Gd, Gd^Fts, Gd^Fts, Gd, Wwt, Wwt, Wwt, Wwt, Wwt, Gd, Gd^Es, Rp, Rp, Hhd, Hhd, Hhd, Hhd, Hhd, Hhd, Gd, Gd, Gd^Fts, Hhd, Md, Md, Md, Md, Md, Hhd, Hhd, Gd, Rd^Es, Gd, Hhd, Hhd, Hhd, Hhd, Hhd, Hhd, Hhd
Rd, Gd, Gd, Gd, Gd^Es, Wwt, Wwt, Wwt, Wwt, Gd^Var, Gd^Fts, Gd, Gd, Gd, Gd^Fts, Gd^Fts, Gd^Fts, Gd^Fts, Wwt, Wwt, Wwt, Sm, Wwt, Gd^Fts, Wwt, Wwt, Wwt, Wwt, Sm, Wwt, Wwt, Wwt, Wwt, Gd, Gd, Rp, Rp, Hhd, Hhd, Hhd, Gd, Rd, Gd, Gd, Hhd, Md, Hhd, Md, Hhd, Md, Hhd, Gd, Rp, Gd, Rd, Hhd, Gd, Hhd, Gd, Hhd, Hhd, Hhd
Rd^Es, Gd, Rd, Rd, Gd^Es, Gd^Gor, Gd, Wwt, Wwt, Wwt, Wwt, Arr, Wwt, Sm, Wwt, Wwt, Wwt, Wwt, Wwt, Wwt, Wwt, Wwt, Wwt, Wwt, Wwt, Wwt, Gd, Sm, Gd, Sm, Arr, Wwt, Wwt, Wwt, Arr, Gd, Rp, Gd, Gd^Es, Gd^Es, Rp, Rd, Gd, Gd, Gd, Hhd, Gd, Hhd, Gd, Hhd, Rp, Gd, Arr, Rp, Rp, Gd, Rd, Gd^Es, Gd^Es, Gd, Gd, Hhd
Gd^Es, Rd, Gd, Gd, Rd, Rd, Rd, Gd, Gd, Wwt, Wwt, Wwt, Wwt, Wwt, Wwt, Wwt, Wwt, Wwt, Gd^Fts, Arr, Gd, Wwt, Gd^Fts, Wwt, Gd, Gd, Gd^Var, Gd, Gd^Es, Gd^Fts, Arr, Arr, Wwt, Wwt, Wwt, Gd^Fts, Gd, Rp, Rp, Rp, Gd, Gd, Arr, Rp, Rp, Gd, Rp, Gd, Gd^Fts, Rp, Gd, Arr, Arr, Arr, Gd, Rp, Rp, Rd, Rp, Rd, Rd, Gd
Gd, Gd, Gd, Gd^Fts, Gd^Fts, Gd^Fts, Gd, Gd, Gd^Fts, Gd^Fts, Gd^Fts, Gd^Es, Gd, Wwt, Gd, Sm, Gd, Gd, Gd, Gd, Gd, Gd, Rd, Gd, Rd, Rd, Gd, Rd, Gd, Gd^Es, Gd, Gd, Gd, Wwt, Wwt, Wwt, Wwt, Gd, Rp, Gd, Gd, Gd^Fts, Gd, Gd, Gd, Rp, Rd, Rd, Rd, Gd, Gd, Gd^Fts, Gd, Gd^Var, Gd, Gd, Gd, Gd^Fts, Rd, Rp, Rp, Gd
Hhd, Gd, Hhd, Hhd^Fts, Hhd^Fts, Hhd^Fts, Hhd, Gd^Fts, Arr, Arr, Arr, Gd^Fts, Gd^Fts, Gd, Gd^Fts, Gd, Gd^Fts, Gd^Fts, Gd^Fts, Gd, Rd^Es, Rd^Es, Gd^Edp, Rd, Rd, Gd^Es, Gd^Eba, Gd^Fts, Rd, Rd, Gd, Gd, Gd, Gd^Fts, Arr, Wwt, Wwt, Gd, Rp, Rd, Gd^Var, Gd, Rd^Es, Gd^Es, Gd, Gd, Gd, Gd^Edp, Gd, Gd, Gd^Es, Rd^Es, Gd, Gd, Gd, Rd, Gd^Es, Gd^Eba, Gd, Gd, Rd, Gd
Hhd, Hhd, Mdd, Mdd, Mdd, Mdd, Mdd, Hhd, Hhd, Car, Rd, Gd^Fts, Rd, Gd^Fts, Arr, Gd^Fts, Arr, Arr, Gd^Fts, Gd, Gd, Gd, Gd, Gd, Gd, Gd^Es, Gd^Es, Rd, Gd, Gd, Rd^Es, Gd^Es, Gd, Gd^Fts, Wwt, Wwt, Wwt, Gd, Rp, Gd, Gd^Es, Gd, Hhd, Gd, Hhd, Hhd, Gd, Gd, Gd, Gd, Hhd, Hhd, Hhd, Hhd, Hhd, Hhd, Hhd, Gd^Es, Rd, Gd, Gd, Gd
Mdd, Mdd, Mdd, Mdd, Mdd, Mdd, Mdd, Mdd, Hhd, Gd^Es, Rd^Es, Rd^Es, Gd^Es, Arr, Car, Arr, Hhd, Arr, Hhd, Hhd, Gd, Gd, Gd, Gd, Hhd, Gd, Gd, Gd, Gd, Rd, Gd, Gd^Es, Wwt, Wwt, Wwt, Wwt, Arr, Gd, Rp, Gd, Gd^Ecf, Hhd, Hhd, Hhd, Mdd, Hhd, Hhd, Hhd, Hhd, Hhd^Sor, Mdd, Mdd, Mdd, Mdd, Mdd, Hhd, Hhd, Hhd, Hhd, Hhd, Hhd, Hhd
Mdd, Mdd, Mdd, Mdd, Mdd, Mdd, Mdd, Mdd, Hhd, Rd, Gd^Fts, Gd, Rd^Es, Gd, Rd^Es, Hhd, Mdd, Hhd, Mdd, Hhd, Hhd, Hhd, Hhd, Hhd, Mdd, Hhd, Hhd, Gd, Hhd, Gd, Rd, Gd, Wwt, Wwt, Wwt, Arr, Gd^Fts, Gd^Ecf, Rp, Gd, Hhd, Hhd, Mdd, Mdd, Mdd, Mdd, Mdd, Hhd, Mdd, Mdd, Mdd, Mdd, Mdd, Mdd, Mdd, Mdd, Mdd, Hhd, Mdd, Hhd, Mdd, Mdd
Mdd, Mdd, Mdd, Mdd, Mdd, Mdd, Mdd, Mdd, Hhd, Rd^Edp, Rd^Edp, Gd, Rd^Es, Gd^Fts, Rd^Edp, Hhd, Mdd, Mdd, Mdd, Mdd, Mdd, Mdd, Mdd, Mdd, Mdd, Mdd, Mdd, Hhd, Hhd, Hhd, Rd, Gd, Wwt, Wwt, Wwt, Arr, Gd^Fts, Gd, Rp, Car, Hhd, Hhd, Hhd, Mdd, Mdd, Mdd, Mdd, Mdd, Mdd, Mdd, Mdd, Mdd, Mdd, Mdd, Mdd, Mdd, Mdd, Mdd, Mdd, Mdd, Mdd, Mdd
Mdd, Mdd, Mdd, Mdd, Mdd, Mdd, Mdd, Hhd, Hhd, Rd^Edp, Hhd, Kar, Rd^Es, Rd^Es, Gd^Fts, Hhd, Mdd, Mdd, Mdd, Mdd, Mdd, Mdd, Mdd, Mdd, Mdd, Mdd, Mdd, Mdd, Mdd, Hhd, Hhd, Gd, Arr, Wwt, Wwt, Wwt, Gd, Gd, Car, Car, Car, Car, Gd, Hhd, Hhd, Mdd, Mdd, Mdd, Mdd, Mdd, Mdd, Mdd, Mdd, Mdd, Mdd, Mdd, Mdd, Mdd, Mdd, Mdd, Mdd, Mdd
Mdd, Mdd, Mdd, Mdd, Mdd, Mdd, Mdd, Hhd, Mdd, Hhd, Hhd, Hhd, Hhd, Gd^Fts, Hhd, Hhd, Mdd, Mdd, Mdd, Mdd, Mdd, Mdd, Mdd, Mdd, Mdd, Mdd, Mdd, Mdd, Mdd, Mdd, Hhd, Gd, Gd, Wwt, Wwt, Wwt, Wwt, Gd, Gd, Rb, 3 Kar, Rp, Rp, Gd, Gd^Var, Hhd, Hhd, Mdd, Mdd, Mdd, Mdd, Mdd, Mdd, Mdd, Mdd, Mdd, Mdd, Mdd, Mdd, Mdd, Mdd, Mdd
Mdd, Mdd, Mdd, Mdd, Mdd, Mdd, Mdd, Mdd, Mdd, Mdd, Mdd, Mdd, Mdd, Hhd, Mdd, Mdd, Mdd, Mdd, Mdd, Mdd, Mdd, Mdd, Mdd, Mdd, Mdd, Mdd, Mdd, Mdd, Mdd, Mdd, Hhd, Hhd, Rd, Gd^Var, Gd, Wwt, Wwt, Wwt, Wwt, Gd, Gd, Gd, Rp, Gd, Hhd, Hhd, Mdd, Mdd, Mdd, Mdd, Mdd, Mdd, Mdd, Mdd, Mdd, Mdd, Mdd, Mdd, Mdd, Mdd, Mdd, Mdd
Mdd, Mdd, Mdd, Mdd, Mdd, Mdd, Mdd, Mdd, Mdd, Mdd, Mdd, Mdd, Mdd, Mdd, Gd, Mdd, Mdd, Mdd, Mdd, Mdd, Mdd, Mdd, Mdd, Mdd, Mdd, Mdd, Mdd, Mdd, Mdd, Mdd, Mdd, Hhd, Gd, Gd, Gd, Arr, Arr, Wwt, Wwt, Wwt, Gd, Gd, Rp, Gd, Hhd, Hhd, Mdd, Mdd, Mdd, Mdd, Mdd, Mdd, Mdd, Mdd, Mdd, Mdd, Mdd, Mdd, Mdd, Mdd, Mdd, Mdd
