Wo, Wo, Wo, Wo, Wo, Wo, Wo, Wo, Wo, Wo, Wo, Wo, Wo, Wo, Wo, Wo, Wo, Wo, Wo, Wo, Wo, Wo, Wo, Wo, Wo, Wo, Wo, Wo, Wo, Wo, Wo, Wo, Wo, Wo, Wo, Wo, Wo, Wo, Wo, Wo, Wo, Wo, Wo, Wo, Wo, Wo, Wo, Wo, Wo, Ww, Wo, Wo, Ww, Wo, Wo, Ww, Wo, Wo, Wo, Wo, Ww, Wo, Ww, Wo, Wo, Wo, Wo, Wo, Wo, Wo, Wo, Wo
Wo, Wo, Wo, Wo, Wo, Wo, Wo, Wo, Wo, Wo, Wo, Wo, Wo, Wo, Wo, Wo, Wo, Wo, Wo, Wo, Wo, Wo, Wo, Wo, Wo, Wo, Wo, Wo, Wo, Wo, Wo, Wo, Wo, Wo, Wo, Wo, Wo, Wo, Wo, Wo, Wo, Wo, Wo, Wo, Wo, Wo, Ww, Ww, Ww, Ww, Ww, Ww, Mm, Ww, Ww, Ww, Ww, Wo, Ww, Mm, Mm, Mm, Mm, Ww, Wo, Wo, Wo, Wo, Wo, Wo, Wo, Wo
Wo, Wo, Wo, Wo, Wo, Wo, Wo, Wo, Wo, Wo, Wo, Wo, Wo, Wo, Wo, Wo, Ww, Wo, Ww, Wo, Ww, Wo, Wo, Wo, Wo, Wo, Wo, Wo, Wo, Wo, Wo, Wo, Wo, Wo, Wo, Mm, Mm, Mm, Mm, Wo, Ww, Wo, Ww, Ww, Ww, Ww, Ww, Ww, Mm, Ww, Mm, Mm, Mm, Mm, Mm, Ww, Ww, Ww, Ww, Ww, Mm, Mm, Mm, Ww, Ww, Wo, Wo, Wo, Wo, Wo, Wo, Wo
Wo, Wo, Wo, Wo, Wo, Wo, Wo, Wo, Wo, Wo, Wo, Wo, Ww, Wo, Ww, Ww, Ww, Ww, Ww, Ww, Ww, Ww, Ww, Ww, Ww, Ww, Ww, Wo, Wo, Wo, Ww, Wo, Wo, Wo, Wo, Mm, Mv, Mm, Mm, Ww, Ww, Ww, Uu, Ww, Mm, Mm, Mm, Mm, Mm, Mm, Mm, Mm, Mm, Mm, Mm, Mm, Mm, Ww, Ww, Ww, Ww, Mm, Mm, Mm, Ww, Wo, Wo, Wo, Wo, Wo, Wo, Wo
Wo, Wo, Wo, Wo, Wo, Wo, Wo, Wo, Wo, Wo, Wo, Wo, Ww, Ww, Ww, Ww, Ds, Ww^Bw|r, Ds, Ww, Ww, Ww, Ww, Ww, Ww, Ww, Ww, Ww, Ww, Wo, Ww, Ww, Wo, Wo, Uu, Mm, Mm, Mm, Uu, Wo, Uu, Uu, Qlf, Uu, Qlf, Mm, Qlf, Mm, Mv, Mm, Mm, Mm, Mm, Mm, Mm, Mm, Mm, Ww, Ww, Ww, Ww, Ww, Mm, Mm, Ww, Wo, Wo, Wo, Wo, Wo, Wo, Wo
Wo, Wo, Wo, Wo, Wo, Wo, Wo, Wo, Wo, Ww, Ww, Ww, Ww, Ww, Ds, Ds, Gll^Ftr, Ds, Gll^Ftr, Ds, Ds, Ds, Ds, Ww, Ww, Ww, Ds, Ww, Mm, Ww, Ww, Ww, Ww, Wo, Uu, Qlf, Qlf, Qlf, Uu, Uu, Uu, Qlf, Ur, Qlf, Ur, Qlf, Mm, Mm, Mm, Mm, Mm, Mm, Mm, Mm, Mm, Mv, Mm, Ds, Ww, Ww, Ww, Mm, Mm, Mm, Ww, Wo, Wo, Wo, Wo, Wo, Wo, Wo
Wo, Wo, Wo, Wo, Ww, Wo, Ww, Wo, Ww, Ww, Mm, Ww, Mm, Ds, Hh^Ftr, Gll^Ftr, Gll^Ftr, Gll, Gs, Gll^Ftr, Gll^Ftr, Gll^Ftr, Gll^Ftr, Ds, Ds, Ds, Mm, Mm, Mm, Mm, Mm, Uu, Uu, Uu, Wo, Uu, Uu, Uu, Wo, Uu, Ww, Uu, Ur, Ur, Hh, Mm, Mm, Mm, Mm, Qlf, Uh, Uh, Uh, Mm, Qlf, Mm, Mm, Ds, Ww, Ww, Ww, Ww, Mm, Mm, Wo, Wo, Wo, Wo, Wo, Wo, Wo, Wo
Wo, Wo, Wo, Ww, Ww, Ww, Ww, Ww, Ww, Mm, Mm, Mm, Mm, Mm, Hh^Ftr, Gll^Ftr, Gs, Gg^Efm, Gg, Gs, Gg^Efm, Gll^Efm, Gg^Efm, Gs, Gs, Hh, Hh^Ftr, Mm, Hh^Ftr, Mm, Mm, Mm, Uu, Wo, Uu, Wo, Uu, Wo, Ww, Ww, Ww, Ds, Gd^Vcl, Rd^Es, Hh^Ftr, Mm, Mm, Mm, Mm, Qlf, Ur^Cov, 2 Ur^Kov, Ur^Cov, Qlf, Mm, Mm, Mm, Ds, Ds, Ds, Ds, Ww, Ww, Wo, Ww, Wo, Wo, Wo, Wo, Wo, Wo, Wo
Wo, Wo, Wo, Wo, Ww, Ww, Ds, Ww, Mm, Mm, Mm, Mm, Mm, Mm, Hh, Gs^Efm, Gs^Var, Rb^Efm, Gs^Var, Gg^Efm, Gs, Gs, Gll^Ftr, Gg, Gs, Gll^Ftr, Gll^Vcl, Hh^Ftr, Hh^Ftr, Hh^Ftr, Mm, Mm, Ww, Wo, Wo, Uu, Wo, Wo, Wo, Ww, Ww, Ds, Ds, Gs^Es, Hh^Ftr, Mm, Mm, Mm, Mm, Qlf, Qlf, Ur^Cov, Qlf, Qlf, Mm, Mv, Mm, Mm, Mm, Hh^Ftr, Ds, Ww, Ww, Wo, Ww, Wo, Wo, Wo, Wo, Wo, Wo, Wo
Wo, Wo, Wo, Wo, Ww, Ww, Ds, Ds, Hh^Ftr, Mm, Hh, Mm, Hh^Ftr, Hh^Ftr, Gs, Gs^Efm, Rb^Efm, Rb, Gs, Gs^Efm, Gll^Ftr, Gll^Ftr, Ds, Gll^Ftr, Ds, Gll^Ftr, Gll^Ftr, Hh, Mm, Mm, Mm, Ds, Ww, Wo, Ww, Wo, Wo, Wo, Ww, Wo, Ww, Ww, Ww, Ds, Gd, Hh^Ftr, Mm, Mm, Uh, Uh, Qlf, Ur, Qlf, Uh, Uh, Mm, Mm, Mm, Mm, Hh^Ftr, Gd^Vcl, Ds, Ww, Ww, Wo, Ww, Wo, Wo, Wo, Wo, Wo, Wo
Wo, Wo, Ww, Ww, Ww, Ds, Gll, Gll^Ftr, Gll^Ftr, Hh^Ftr, Gll, Hh, Gll^Ftr, Gll^Ftr, Gg, Ww^Ewf, Rb^Efm, Gg^Efm, Gs^Var, Gs^Efm, Gll^Ftr, Ds, Ww, Ds, Ww, Ds, Gs, Hh^Ftr, Hh^Ftr, Mm, Ds, Ds, Uu, Wo, Ww, Wo, Wo, Wo, Wo, Ww, Wo, Wo, Ww, Ds, Ds, Hh, Hh, Hh, Ur, Ur, Qlf, Ur, Ur, Qlf, Uh, Mm, Mm, Mm, Hh, Hh, Ds, Ds, Ww, Ww, Ww, Ww, Wo, Wo, Wo, Wo, Wo, Wo
Wo, Wo, Wo, Ww, Ww, Ds, Ds, Gll^Ftr, Gs^Efm, Gll^Ftr, Gs^Var, Gll, Gg^Efm, Gg, Rb^Efm, Rb, Ww^Ewf, Gg, Rb, Gg, Ds, Ds, Ww, Ww, Ww, Ds, Ds, Gs, Gs^Vcl, Hh, Ds, Ww, Uu, Uu, Uu, Wo, Wo, Wo, Ww, Wo, Wo, Wo, Ww, Ww, Ds, Gs^Es, Rd, Rd, Ur, Qlf, Ur, Ur^Es, Ur^Es, Qlf, Ur, Uh, Uh, Hh, Ds, Ds, Uu, Ww, Wo, Ww, Wo, Wo, Wo, Wo, Wo, Wo, Wo, Wo
Wo, Wo, Wo, Ww, Ww, Ww, Ds, Gs, Gg^Efm, Gg, Ww^Ewf, Rb^Efm, Rb^Efm, Rb, Gs, Gs^Efm, Gs, Gg^Efm, Rb^Efm, Gs, Ds, Ww, Ww, Ww, Ww, Ww, Ww, Ds, Ds, Ds, Ww, Ww, Ww, Ww, Uu, Uu, Uu, Uu, Uu, Ww, Ww, Ww, Ww, Ds, Gd, Gd^Vcl, Rd^Es, Ur, Qlf, Qlf, Ur, Rd^Es, Ur, Qlf, Qlf, Ur, Qlf, Ds, Qlf, Uu, Wo, Ww, Ww, Ww, Wo, Wo, Wo, Wo, Wo, Wo, Wo, Wo
Wo, Wo, Wo, Ww, Ww, Ww^Bw\r, Ds, Gs, Gg^Efm, Gs^Var, Rb^Efm, Gs^Efm, Ds, Ds, Ds, Ds, Ds, Gs, Gs^Efm, Gs^Var, Gs, Ds, Ww, Ww, Ww, Ww, Ww, Ww, Ww, Ww, Ww, Ww, Uu, Wo, Uu, Qlf, Qlf, Qlf, Qlf, Ur, Ur, Ds, Ds, Ds, Rd, Rd, Ur, Ur^Es, Ur, Ur, Rd^Es, Rd^Es, Rd^Es, Ur, Ur, Qlf, Ur, Qlf, Ur, Uu, Uu, Ww, Wo, Wo, Wo, Wo, Wo, Wo, Wo, Wo, Wo, Wo
Wo, Wo, Ww, Ww, Ds, Ds, Gs, Gg, Gg^Efm, Gg^Efm, Gs^Var, Ds, Ww, Ww, Ww, Ww, Ww, Ds, Gs^Efm, Gs^Efm, Ds^Bw\r, Ds^Bw\r, Ww, Ww, Wo, Wo, Ww, Ww, Ww, Ww, Wo, Wo, Wo, Uu, Wo, Uu, Uu, Ur, Ur, Qlf, Uh, Uh, Uh, Hh, Uh, Ur, Qlf, Ur, Rd^Es, Rd^Es, Gd, Gs^Vcl, Gd, Rd^Es, Ur, Qlf, Ur, Ur, Ds^Es, Uu, Ww, Ww, Ww, Ww, Wo, Wo, Wo, Wo, Wo, Wo, Wo, Wo
Wo, Wo, Ww, Ds, Gll^Ftr, Gs, Gg^Efm, Gg^Efm, Gg^Efm, Gg, Gs, Ds, Ds, Ww, Wo, Ww, Ww, Ds, Ds, Ds^Bw\r, Ds, Ww, Ww, Ww, Wo, Wo, Wo, Ww, Ww, Wo, Wo, Wo, Wo, Ww, Ww, Ww, Ds, Ds, Ur, Qlf, Qlf, Mm, Mv, Mm, Mm, Uh, Qlf, Ur, Ur, Rd, Hh, Hh^Ftr, Hh^Ftr, Rd, Rd^Es, Ur, Rd^Es, Rd, Gd^Vcl, Ww, Ww, Ww, Ww, Ww, Wo, Wo, Wo, Wo, Wo, Wo, Wo, Wo
Ww, Ww, Ww, Ds, Gll^Ftr, Gll, Gg^Efm, Gg^Efm, Gg^Efm, Gg^Efm, Gll^Ftr, Ds, Ds, Ww, Ww, Ww, Ww, Ww, Ww, Ww, Ww, Ww, Ww, Wo, Ww, Ww, Ww, Wo, Wo, Wo, Wo, Wo, Ww, Ww, Ww, Ww, Ds, Rd^Es, Rd, Uh, Mm, Mm, Mm, Mm, Qlf, Qlf, Uh, Qlf, Qlf, Uh, Mm, Mm, Mm, Hh, Hh, Rd, Rd, Gd, Ww, Ww, Ds, Ds, Ds, Ww, Ww, Wo, Wo, Wo, Wo, Wo, Wo, Wo
Ww, Ww, Ds, Ds, Gll^Ftr, Gll^Ftr, Gll^Ftr, Gs, Gs, Gll, Gll, Gll^Ftr, Gll^Ftr, Ds, Ww, Ww, Wo, Wo, Ww, Ww, Ww, Ww, Ww, Wo, Wo, Wo, Ww, Wo, Wo, Wo^Vcl, Wo, Wo, Wo, Ww, Ww, Ds, Rd, Rd, Gs^Es, Hh, Uh, Mm, Qlf, Mm, Mm, Mm, Mm, Uh, Uh, Qlf, Mm, Mv, Mm, Mm, Hh, Ur, Ur, Rd, Ww, Gs, Gll^Ftr, Gll^Ftr, Ds, Ww, Ww, Ww, Wo, Wo, Wo, Wo, Wo, Wo
Ww, Ww, Ww, Ds, Ds, Ds, Ds, Ds, Ds, Gll^Ftr, Gll^Ftr, Gll^Ftr, Gll^Ftr, Ds, Ds, Ww, Ww, Wo, Wo, Ww, Wo, Ww, Wo, Wo, Wo, Wo, Wo, Wo, Wo, Wo, Wo, Wo, Wo, Ww, Ww, Ds, Rd, Gs^Vcl, Rd, Ur, Qlf, Qlf, Mm, Mm, Mm, Mm, Mm, Mm, Mm, Mm, Mm, Mm, Mm, Qlf, Qlf, Qlf, Qlf, Uu, Uu, Rd, Gd^Es, Gll^Ftr, Ds, Ww, Ww, Ww, Wo, Wo, Wo, Wo, Wo, Wo
Wo, Ww, Ww, Ww, Ww, Ww, Ww, Ww^Bw|r, Ww, Ds, Ds, Ds, Ds, Ds, Wwr, Ww, Ww, Ww, Wo, Wo, Wo, Wo, Wo, Wo, Mm, Wo, Wo^Cov, Wo, Wo, Wo, Wo, Wo, Wo, Ww, Ww, Ds, Ds, Rd, Ur, Ur, Qlf, Uh, Hh, Hh, Hh^Ftr, Mm, Mm, Mm, Mm, Mm, Mm, Mm, Mm, Hh, Hh, Ur, Ur, Ur, Ww, Rd, Gd^Es, Gs^Vcl, Ds, Ww, Ww, Wo, Wo, Wo, Wo, Wo, Wo, Wo
Wo, Wo, Wo, Ww, Ww, Ww, Ww, Ww, Ww, Ww, Ww, Ww, Wwr, Ww, Ww, Wwr, Wwr, Wo, Wo, Wo, Wo, Wo, Wo, Mm, Wo, Mm^Cov, 4 Mm^Kov, Wo^Cov, Wo, Wo, Wo, Wo, Wo, Ww, Uu, Ww, Uu, Ur, Qlf, Qlf, Ur, Ur, Rd^Es, Gd^Vcl, Hh^Ftr, Hh^Ftr, Mm, Mm, Mm, Mm, Mm, Mm, Mm, Mm, Mm, Hh, Hh, Rd, Gd, Ww, Ww, Ds, Ww, Ww, Ww, Wo, Wo, Wo, Wo, Wo, Wo, Wo
Wo, Wo, Wo, Wo, Ww, Ww, Ww, Ww, Wo, Ww, Wo, Ww, Wwr, Ww, Wo, Ww, Wwr, Wo, Wo, Wo, Wo, Wo, Wo, Wo, Wo, Mm^Cov, Mm^Cov, Mm^Cov, Wo, Wo, Wo, Wo, Wo, Uu, Uu, Uu, Uu, Qlf, Uu, Ur, Ds, Rd^Es, Hh, Hh, Mm, Mm, Mm, Mm, Mm, Mm, Mm, Mm, Mm, Mm, Mm, Mm, Mm, Hh, Gd, Gs^Es, Ww, Ww, Ww, Ww, Ww, Wo, Wo, Wo, Wo, Wo, Wo, Wo
Wo, Wo, Wo, Wo, Wo, Wo, Wo, Ww, Ww, Ww, Wwr, Wwr, Wo, Ww, Wo, Wo, Wo, Wwr, Wo, Wo, Wo, Wo^Vcl, Wo, Wo, Wo, Wo, Wo, Wo, Wo, Wo, Wo, Wo, Wo, Wo, Wo, Wo, Wo, Uu, Ww, Ww, Ww, Hh, Mm, Mm, Mm, Mm, Mm, Mm, Mm, Mm, Hh^Ftr, Mm, Hh^Ftr, Mm, Mm, Mm, Mm, Hh, Hh, Gd^Es, Gs, Ds, Ww, Ww, Wo, Ww, Wo, Wo, Wo, Wo, Wo, Wo
Wo, Wo, Wo, Wo, Wo, Wo, Ww, Wo, Wo, Wo, Wo, Wwr, Ww, Wo, Ww, Wo, Wo, Wwr, Wo, Wo, Wo, Wo, Wo, Wo, Wo, Wo, Wo, Wo, Wo, Wo, Wo, Wo, Wo, Wo, Wo, Uu, Uu, Uu, Ww, Ww, Mv, Mm, Mm, Mm, Mm, Mm, Mm, Mm, Mm, Mm, Hh^Ftr, Hh, Gd, Hh^Ftr, Hh^Ftr, Hh, Hh^Ftr, Hh^Ftr, Gd^Es, Gs, Gll^Ftr, Ds, Ds, Ww, Wo, Ww, Ww, Wo, Wo, Wo, Wo, Wo
Wo, Wo, Wo, Wo, Wo, Wo, Wo, Wo, Wo, Wo, Ww, Wwr, Wwr, Ww, Wo, Wo, Wo, Wwr, Wo, Wo, Wo, Wo, Wo, Wo, Wo, Wo, Wo, Wo^Vcl, Wo, Wo, Wo, Wo, Wo, Wo, Wo, Wo, Wo, Ww, Ww, Mm, Mm, Mm, Mm, Mm, Mm, Mm, Mm, Mm, Ds, Hh^Ftr, Ds, Gs^Es, Gs^Es, Gll^Ftr, Gd, Gd, Gll^Ftr, Hh, Gs^Es, Gll^Ftr, Gll^Ftr, Gs, Ds, Ww, Ww, Wo, Ww, Wo, Wo, Wo, Wo, Wo
Wo, Wo, Wo, Wo, Wo, Wo, Wo, Wo, Ww, Ww, Ww, Wwr, Ww, Wwr, Wwr, Ww, Ww, Wwr, Ww, Ww, Ww, Wo, Wo, Wo, Ww, Wo, Ww, Wo, Ww, Wo, Ww, Wo, Wo, Wo, Wo, Wo, Wo, Ww, Ww, Ww, Mm, Mm, Mm, Mm, Mm, Mm, Ds, Ds, Ww, Ds, Ww, Ds, Ds, Gs^Es, Gll^Ftr, Gs, Gs^Es, Gs^Es, Gs^Vcl, Gs^Es, Gs, Ds, Ww, Ww, Ww, Ww, Wo, Wo, Wo, Wo, Wo, Wo
Wo, Wo, Wo, Wo, Wo, Wo, Wo, Wo, Wo, Wo, Ww, Ww, Ww, Ww, Ds, Ww, Ds, Wwr, Ds, Ww, Ww, Ww, Ww, Ww, Ww, Ww, Ww, Ww, Ww, Wo, Wo, Ww, Ww, Wo, Ww, Wo, Wo, Wo, Ww, Ww, Ww, Ww, Ww, Mm, Ww, Ww, Wwr, Ww, Ww, Ww, Ww, Ww, Ww, Ds, Ds, Ds, Ds, Ds, Ds, Ds, Ds, Ds, Ww, Ww, Ww, Wo, Wo, Wo, Wo, Wo, Wo, Wo
Wo, Wo, Wo, Wo, Wo, Wo, Mm, Mm, Mm, Wo, Ww, Ww, Ww, Ds, Hh, Ds, Gs, Ds, Gs, Ds, Ds, Ds, Ds, Ww, Ww, Wo, Ww, Ww, Ww, Ww, Ww, Ww, Ww, Ww, Wo, Wo, Wo, Ww, Ww, Wo, Wo, Ww, Ww, Ww, Ww, Ww, Wwr, Ww, Wo, Ww, Wo, Ww, Ww, Wwr, Wwf, Ww, Ww, Ww, Ww, Ww, Ww, Ww, Ww, Wo, Ww, Wo, Wo, Wo, Wo, Wo, Wo, Wo
Wo, Wo, Wo, Wo, Wo, Mm, Mm, Mm, Ww, Wo, Ww, Ww, Mm, Mm, Mm, Hh^Ftr, Hh^Ftr, Gs^Es, Gll, Gll^Ftr, Gll^Ftr, Gs, Hh^Ftr, Ds, Mm, Ww, Mm, Ww, Mm, Mm, Mm, Mm, Mm, Ww, Ww, Ww, Ww, Wo, Ww, Ww, Wo, Wwr, Wo, Ww, Wo, Wo, Wwr, Wo, Wo, Wo, Wo, Wo, Wo, Wwr, Wwr, Ww, Ww, Ww, Wo, Ww, Wo, Ww, Ww, Ww, Wo, Wo, Wo, Wo, Wo, Wo, Wo, Wo
Wo, Wo, Wo, Wo, Wo, Mm, Mm, Ww^Vcl, Ww, Wo, Ww, Ww, Mm, Mm, Mm, Mm, Hh, Gll^Ftr, Gll^Ftr, Gll, Gll^Es, Gll^Ftr, Hh^Ftr, Mm, Mm, Mm, Mm, Mm, Mm, Mm, Mm, Mm, Mm, Mm, Ww, Wo, Ww, Wo, Wo, Ww, Wo, Ww, Ww, Wo, Ww, Wo, Ww, Wwr, Ww, Wo, Ww, Ww, Wwr, Wwf, Wwr, Wo, Wo, Wo, Wo, Wo, Wo, Ww, Wo, Wo, Wo, Wo, Wo, Wo, Wo, Wo, Wo, Wo
Wo, Wo, Wo, Wo, Wo, Wo, Mm, Mm, Ww, Ww, Ww, Mm, Mm, Mm, Mm, Mm, Hh^Ftr, Gll^Vcl, Gll^Ftr, Gll^Ftr, Gll, Gll^Es, Hh, Mm, Hh^Ftr, Mm, Hh, Hh^Ftr, Hh^Ftr, Mm, Mm, Mm, Mm, Mm, Ww, Ww, Wo, Wo, Wo, Wo, Ww, Ww, Ww, Ww, Ww, Ww, Ww, Wwr, Wwr, Ww, Ds, Wwr, Ds, Ww, Wwf, Ww, Wo, Wo, Wo, Ww, Wo, Wo, Wo, Wo, Wo, Wo, Wo, Wo, Wo, Wo, Wo, Wo
Wo, Wo, Wo, Wo, Wo, Wo, Wo, Wo, Wo, Wo, Ww, Mm, Mm, Mm, Mm, Mm, Mm, Hh^Ftr, Gll^Es, Gll, Gll^Ftr, Gll, Gs^Es, Hh^Ftr, Gll, Hh^Ftr, Gll, Hh^Ftr, Mm, Mm, Mm, Mm, Ww, Ww, Wo, Ww, Wo, Wo, Ww, Ww, Ds, Ds, Ds, Ds, Ds, Ds, Mm, Ds, Mm, Ds, Gll^Ftr, Ds, Gs^Vcl, Ds, Ds, Ww, Ww, Wo, Ww, Wo, Wo, Wo, Wo, Wo, Wo, Wo, Wo, Wo, Wo, Wo, Wo, Wo
Wo, Wo, Wo, Wo, Wo, Wo, Wo, Wo, Wo, Ww, Wo, Ww, Ww, Ww, Mm, Mm, Mm, Hh^Ftr, Gs, Gll^Ftr, Gll^Ftr, Gg^Vcl, Gs^Es, Gll, Gll^Ftr, Gll, Gll^Ftr, Hh^Ftr, Mm, Mm, Ds, Ww, Ww, Ww, Wo, Wo, Wo, Wo, Ww, Ww, Ds, Hh, Mm, Mm, Mm, Mm, Mm, Mm, Mm, Mm, Mm, Gll^Ftr, Gll, Gs, Ds, Ww, Ww, Ww, Ww, Wo, Ww, Wo, Wo, Wo, Wo, Wo, Wo, Wo, Wo, Wo, Wo, Wo
Wo, Wo, Wo, Wo, Wo, Wo, Ww, Wo, Wo^Vcl, Ww, Ww, Wo, Ww, Ww, Ww, Mm, Ww, Ds, Ds, Gll^Ftr, Gll, Gll, Gll^Ftr, Gll, Gs, Gll^Ftr, Gll, Hh, Mm, Mv, Mm, Ds, Ds, Ww, Ww, Ww, Wo, Wo, Ww, Ww, Ds, Hh, Hh^Ftr, Mm, Mm, Mm, Mm, Mm, Mm, Mm, Gll, Gll, Gs, Gll^Ftr, Gs, Ds, Ds, Ww, Ww, Wo, Ww, Wo, Wo, Wo, Wo, Wo, Wo, Wo, Wo, Wo, Wo, Wo
Wo, Wo, Wo, Wo, Wo, Wo, Wo, Ww, Ww, Ww, Ww, Ww, Ww, Wo, Ww, Ww, Ww, Ww, Ds, Gll^Ftr, Gll^Ftr, Gll^Ftr, Gll^Es, Gll^Es, Gll^Ftr, Gll, Gll, Hh^Ftr, Hh^Ftr, Mm, Hh^Ftr, Hh^Ftr, Gs, Ds, Ww, Ww, Ww, Wo, Wo, Ww, Ww, Ds, Ds, Mm, Mm, Mm, Mm, Mm, Gll^Ftr, Gll^Ftr, Gg, Gll, Hh^Ftr, Hh, Hh^Ftr, Hh, Ds, Ww, Ww, Wo, Ww, Wo, Wo, Wo, Wo, Wo, Wo, Wo, Wo, Wo, Wo, Wo
Wo, Wo, Wo, Wo, Ww, Wo, Ww, Ww, Ww, Ww, Mm, Ww, Mm, Ww, Ww, Ww, Ds, Ds, Gll^Ftr, Gll, Hh, Hh^Ftr, Hh, Gs, Gll^Ftr, Gs, Gll, Gll^Ftr, Gll, Hh^Ftr, Gll^Vcl, Gll^Ftr, Gll^Ftr, Ds, Ds, Ww, Ww, Wo, Wo, Ww, Ww, Ww, Ds, Mm, Mm, Mm, Mm, Mm, Gll^Ftr, Gll, Gg, Hh^Ftr, Mm, Mm, Mm, Mm, Ww, Ww, Ww, Wo, Ww, Ww, Wo, Wo, Wo, Wo, Wo, Wo, Wo, Wo, Wo, Wo
Wo, Wo, Wo, Wo, Wo, Ww, Ww, Ww, Ww, Mm, Mm, Mm, Mm, Mm, Mm, Ww, Ds, Gll^Ftr, Hh^Ftr, Hh, Mm, Mm, Mm, Hh^Ftr, Hh^Ftr, Gll, Gll, Gll^Ftr, Gll^Ftr, Gll^Ftr, Gg, Gll^Ftr, Gs, Gs, Ds, Ww, Ww, Wo, Wo, Ww, Ww, Ww, Ds, Mm, Hh^Ftr, Hh^Ftr, Hh^Ftr, Gll^Ftr, Gs, Gs, Gs, Hh, Mm, Mm, Mm, Ww, Ww, Ww, Wo, Wo, Ww, Ww, Ww, Wo, Wo, Wo, Wo, Wo, Wo, Wo, Wo, Wo
Wo, Wwr, Wo, Wo, Wo, Wo, Wo, Ww, Mm, Mm, Mm, Mm, Mm, Mm, Hh^Ftr, Ds, Gll, Gll, Hh^Ftr, Mm, Mm, Mm, Mm, Mm, Mm, Hh, Hh^Ftr, Gll, Gll, Gll^Es, Gll, Gll^Ftr, Gs, Ds, Wwr, Ww, Wwr, Wo, Wwr, Ww, Ww, Ds, Gs, Hh, Gll^Ftr, Gll, Gll^Ftr, Gs, Gg, Gg, Gs, Hh^Ftr, Mm, Mm, Mm, Ds, Ww, Ww, Wo, Ww, Wo, Ww, Ww, Wo, Wo, Wo, Wo, Wo, Wo, Wo, Wo, Wo
Wo, Wo, Wwr, Wo, Wo, Wo, Ww, Ww, Mm, Mm, Mm, Mm, 3 Hh^Kov, Hh^Cov, Gll, Gll^Ftr, Gll^Ftr, Hh^Ftr, Mm, Mm, Mm, Mm, Mm, Mm, Mm, Mm, Mm, Hh^Ftr, Gs, Gll^Es, Gll^Ftr, Gll, Ds, Ds, Ww, Wwr, Wwr, Wwr, Wwr, Wwr, Ds, Ds, Gs, Gg, Gs, Gll^Ftr, Gll^Ftr, Gs, Gg, Gg, Gs, Hh^Ftr, Hh, Hh^Ftr, Hh, Ds, Ww, Ww, Wo, Ww, Ww, Ww, Wo, Wo, Wo, Wo, Wo, Wo, Wo, Wo, Wo, Wo
Wo, Wo, Wwr, Wo, Wo, Ww, Ww, Mm, Mm, Mm, Mm, Mm, Hh^Cov, Gll^Cov, Gll^Ftr, Gll^Ftr, Gll, Hh, Hh^Ftr, Mm, Hh, Mm, Mm, Mm, Mm, Mm, Mm, Hh^Ftr, Hh, Gll, Gll, Gll^Ftr, Ds, Ww, Ww, Ww, Wo, Wwr, Ww, Wwr, Ds, Gs, Gs, Gg, Gg, Gs, Gs, Gg, Gll, Gg, Gg, Gg, Gg, Re^Vct, Gs, Ds, Ds, Ww, Wo, Ww, Ww, Wo, Wo, Wo, Wo, Wo, Wo, Wo, Wo, Wo, Wo, Wo
Wo, Wo, Wo, Wwr, Wo, Wo, Ww, Mm, Mm, Mm, Mm, Mm, Mm, Hh^Ftr, Gll^Ftr, Gll^Ftr, Gll^Ftr, Gll^Ftr, Gll^Es, Hh^Ftr, Gll^Vcl, Hh^Ftr, Hh^Ftr, Mm, Mm, Mm, Mm, Mm, Hh^Ftr, Gs, Gg, Gll^Ftr, Ds, Ww, Ww, Wo, Wo, Wo, Wo, Ww, Ww, Ds, Ds, Gll^Ftr, Gll^Ftr, Gg, Gg, Gg, Gll^Ftr, Gll^Ftr, Re^Vct, Gg, Gs, Gg, Gg, Gs, Ds, Ww, Ww, Ww, Wo, Wo, Wo, Wo, Wo, Wo, Wo, Wo, Wo, Wo, Wo, Wo
Wo, Wo, Wwr, Wo, Wo, Ww, Ww, Ww, Mm, Mm, Mm, Mv, Mm, Hh^Ftr, Gs, Gs, Ds, Gs^Es, Ds, Gll^Ftr, Ds, Gll^Ftr, Gll, Hh^Ftr, Mm, Mm, Mm, Mm, Hh^Ftr, Gll^Ftr, Gll^Ftr, Gs, Ds, Ds, Ww, Wo, Ww, Ww, Wo, Ww, Ww, Ww, Ds, Gs, Gll^Ftr, Gll^Ftr, Gs, Gs, Gll, Gll^Ftr, Gll^Ftr, Gll^Ftr, Gg, Gg, Ce, Gs, Ds, Ww, Wo, Ww, Wo, Wo, Wo, Wo, Wo, Wo, Wo, Wo, Wo, Wo, Wo, Wo
Wo, Wo, Wwr, Wo, Wo, Wo, Ww, Ww, Ww, Mm, Ww, Mm, Mm, Ds, Ds, Ds, Ww, Ds, Ww, Ds, Ww, Ds, Gll^Ftr, Hh^Ftr, Hh, Mm, Hh^Ftr, Hh, Gs^Es, Gll^Vcl, Gll, Gs, Ds, Ww, Wo, Wo, Ww, Wo, Wo, Wo, Ww, Ww, Ww, Ds, Gs, Gg, Gg, Gg, Gll^Ftr, Gll^Ftr, Gll^Ftr, Gll^Ftr, Gg, Ce, 1 Ke, Ce, Ds, Ww, Ww, Ww, Ww, Wo, Wo, Wo, Wo, Wo, Wo, Wo, Wo, Wo, Wo, Wo
Wo, Wo, Wo, Wo, Wo, Wo, Wo, Ww, Ww, Ww, Wo, Ww, Ww, Ww, Ww, Ww, Ww, Ww, Ww, Ww, Ds, Ds, Gs, Gll^Es, Gll^Es, Hh^Ftr, Gll, Gs, Gll, Gll, Gll^Ftr, Ds, Ww, Ww, Wo, Ww, Wo, Wo, Ww, Wo, Ww, Ww, Ww, Ds, Ds, Gs, Gg, Gg, Gs, Gll^Ftr, Re^Vct, Gll, Gs, Ce, Ce, Ce, Gs, Ds, Ww, Ww, Wo, Wo, Wo, Wo, Wo, Wo, Wo, Wo, Wo, Wo, Wo, Wo
Wo, Wo, Wo, Wo, Wo, Wo, Wo, Wo, Wo, Ww, Ww, Ww, Ww, Ww, Wo, Ww, Wo, Ww, Ww, Ww, Ds, Gll^Ftr, Gll^Ftr, Gll^Ftr, Gll^Ftr, Gs, Gll^Vcl, Gll^Ftr, Gll, Gll^Ftr, Mm, Mm, Ds, Ww, Ww, Wo, Wo, Ww, Wo, Wo, Ww, Ww, Ds, Ww, Ds, Gs, Gg, Gg, Gll^Ftr, Gg, Gs, Gs, Ds, Ds, Ds, Ds, Ds, Ds, Ww, Wo, Ww, Wo, Wo, Wo, Wo, Wo, Wo, Wo, Wo, Wo, Wo, Wo
Wo, Wwr, Wwr, Wwr, Wwr, Wo, Wo, Wo, Wo, Wo, Wo, Wo, Wo, Wo, Wo, Wo, Wo, Wo, Wo, Ww, Ww, Mm, Mm, Mm, Mm, Gll^Ftr, Gll^Ftr, Gll^Ftr, Gll^Ftr, Gll^Ftr, Mm, Mm, Ds, Ww, Ww, Ww, Wo, Wo, Ww, Ww, Ds, Ds, Gs, Ds, Gg, Gg, Gll, Gll^Ftr, Gll^Ftr, Gll, Gll^Ftr, Ds, Ww, Ww, Ww, Ww, Ww, Ww, Wo, Wo, Wo, Wo, Wo, Wo, Wo, Wo, Wo, Wo, Wo, Wo, Wo, Wo
Wo, Wo, Wo, Wo, Wo, Wwr, Wo, Wo, Wo, Wo, Wo, Wo, Wo, Wo, Wwr, Wo, Wo, Wo, Wo, Ww, Ww, Mm, Mm, Mm, Mm, Mm, Mm, Mm, Mm, Mm, Mm, Mm, Wwr, Ww, Wo, Wo, Wo, Ww, Ww, Ds, Hh^Ftr, Gs, Gll, Gll^Ftr, Gll^Ftr, Gg, Gg, Gll^Ftr, Gll, Gll^Ftr, Gs, Ds, Ds, Ww, Ww, Ww, Wo, Ww, Wo, Wo, Wo, Wo, Wo, Wo, Wo, Wo, Wo, Wo, Wo, Wo, Wo, Wo
Wo, Wo, Wo, Wo, Wo, Wo, Wwr, Wo, Wo, Wo, Wo, Wo, Wo, Wo, Wwr, Wo, Wwr, Wo, Wo, Wo, Ww, Ww, Ww, Mm, Mm, Mm, Mm, Mm, Mm, Mm, Mm, Mm, Wwr, Wwr, Wwr, Wo, Ww, Ww, Hh, Hh^Ftr, Mm, Hh^Ftr, Gll, Gll^Ftr, Gll, Gs, Gg, Gll, Gg, Gg, Gs, Ds, Ww, Ww, Ww, Wo, Wo, Wo, Wo, Wo, Wo, Wo, Wo, Wo, Wo, Wo, Wo, Wo, Wo, Wo, Wo, Wo
Wo, Wo, Wo, Wo, Wo, Wo, Wo, Wwr, Wo, Wo, Wo, Wo, Wo, Wo, Wo, Wo, Wo, Wo, Wo, Wo, Wo, Ww, Ww, Ww, Ww, Mm, Mm, Mm, Mm, Mm, Ww, Ww, Wo, Wwr, Wwr, Wwr, Mm, Mm, Mm, Mm, Hh^Ftr, Hh, Gll^Ftr, Gll^Vcl, Gg, Gll, Gll^Ftr, Gll^Ftr, Gll^Ftr, Gg, Gs, Ds, Ds, Ww, Ww, Wo, Ww, Wo, Wo, Wo, Wo, Wo, Wo, Wo, Wo, Wo, Wo, Wo, Wo, Wo, Wo, Wo
Wo, Wo, Wo, Wo, Wo, Wo, Wo, Wo, Wo, Wwr, Wo, Wo, Wo, Wo^Vcl, Wo, Wo, Wo, Wwr, Wo, Wo, Wo, Wo, Wo, Ww, Wo, Ww, Ww, Ww, Ww, Ww, Wo, Wo, Ww, Ww, Mm, Mm, Mm, Mm, Mm, Mm, Hh^Ftr, Gll, Gll, Gll^Ftr, Gll, Gll, Gll, Gll, Gll, Gll, Hh^Ftr, Gs, Ds, Ww, Ww, Ww, Wo, Wo, Wo, Wo, Wo, Wo, Wo, Wo, Wo, Wo, Wo, Wo, Wo, Wo, Wo, Wo
Wo, Wo, Wwr, Wo, Wo, Wo, Wo, Wo, Wo, Wo, Wwr, Wo, Wo, Wo, Wo, Wo, Wo^Cov, Wo, Wo, Wwr, Wwr, Wo, Wo, Wo, Wo, Wo, Wo, Wo, Wo, Wo, Wo, Wo, Ww, Ww, Mm, Mm, Mm, Mm, Mm, Mm, Mm, Hh^Ftr, Gll^Ftr, Gll^Ftr, Gs, Gs, Hh^Ftr, Hh^Ftr, Hh, Hh^Ftr, Mm, Hh^Ftr, Ds, Ww, Wo, Ww, Wo, Wo, Wo, Wo, Wo, Wo, Wo, Wo, Wo, Wo, Wo, Wo, Wo, Wo, Wo, Wo
Wo, Wo, Wo, Wwr, Wwr, Wo, Wo, Wo, Wo, Wo, Wwr, Wo, Wo, Wo, Wo, Wo^Cov, 5 Wo^Kov, Wo^Cov, Wo, Wo, Wo, Wwr, Wwr, Wo, Wo, Wo, Wo, Wo, Wo, Wo, Wo, Ww, Ww, Ww, Ds, Mm, Mm, Mm, Mm, Mm, Hh^Ftr, Hh^Ftr, Gs, Gg, Gg, Gg, Hh^Ftr, Mm, Mm, Hh, Mm, Mm, Ww, Ww, Wo, Ww, Wo, Wo, Wo, Wo, Wo, Wo, Wo, Wo, Wo, Wo, Wo, Wo, Wo, Wo, Wo, Wo
Wo, Wo, Wo, Wo, Wo, Wo, Wo, Wo, Wo, Wo, Wwr, Wo, Wo, Wo, Wo, Wo^Cov, Wo^Cov, Wo^Cov, Wo, Wo, Wo, Wo, Wo^Vcl, Wwr, Wo, Wo, Wo, Wo, Wwr, Wo, Wo, Wo, Ww, Ww, Ww, Ds, Ww, Ds, Ww, Hh, Ds, Ds, Ds, Gs, Gs, Hh, Mm, Mm, Mm, Mm, Mm, Mm, Ww, Ww, Wo, Wo, Wo, Wo, Wo, Wo, Wo, Wo, Wo, Wo, Wo, Wo, Wo, Wo, Wo, Wo, Wo, Wo
Wo, Wo, Wo, Wo, Wwr, Wwr, Wo, Wo, Wo, Wo, Wo, Wwr, Wo, Wo, Wo, Wo, Wo, Wo, Wo, Wo, Wwr, Wo, Wo, Wo, Wo, Wwr, Wo, Wo, Wo, Wwr, Wo, Wo, Wo, Ww, Ww, Ww, Ww, Ww, Ww, Ww, Ww, Ww, Ww, Ds, Ds, Ds, Ds, Mm, Ww, Mm, Ww, Ww, Wo, Ww, Ww, Wo, Wo, Wo, Wo, Wo, Wo, Wo, Wo, Wo, Wo, Wo, Wo, Wo, Wo, Wo, Wo, Wo
Wo, Wo, Wo, Wo, Wo, Wo, Wwr, Wwr, Wo, Wo, Wo, Wwr, Wo, Wo, Wo, Wo, Wo^Vcl, Wo, Wo, Wo, Wo, Wwr, Wwr, Wo, Wo, Wo, Wo, Wo, Wo, Wo, Wo, Wwr, Wo, Wo, Wo, Wo, Wo, Ww, Wo, Ww, Wo, Ww, Ww, Ww, Ww, Ww, Ww, Ww, Ww, Ww, Ww, Wo, Ww, Ww, Ww, Wo, Wo, Wo, Wo, Wo, Wo, Wo, Wo, Wo, Wo, Wo, Wo, Wo, Wo, Wo, Wo, Wo
Wo, Wo, Wo, Wo, Wo, Wwr, Wo, Wo, Wo, Wo, Wo, Wo, Wo, Wwr, Wo, Wo, Wo, Wo, Wo, Wo, Wo, Wo, Wo, Wo, Wo, Wo, Wo, Wo, Wo, Wo, Wo, Wwr, Wo, Wo, Wo, Wo, Wo, Ww, Ww, Ww, Ww, Ww, Wo, Ww, Ww, Ww, Ww, Ww, Ww, Wo, Ww, Ww, Ww, Ww, Wo, Wo, Wo, Wo, Wo, Wo, Wo, Wo, Wo, Wo, Wo, Wo, Wo, Wo, Wo, Wo, Wo, Wo
Wo, Wo, Wo, Wo, Wo, Wo, Wwr, Wo, Wo, Wwr, Wo, Wo, Wo, Wo, Wo, Wo, Wo, Wwr, Wwr, Wo, Wo, Wo, Wwr, Wo, Wo, Wo, Wo, Wo, Wo, Wo, Wo, Wwr, Wo, Wo, Wo, Wo, Wo, Wo, Wo, Ww, Wo, Wo, Wo, Ww, Wo, Wo, Ww, Wo, Ww, Wo, Wo, Wo, Wo, Wo, Wo, Wo, Wo, Wo, Wo, Wo, Wo, Wo, Wo, Wo, Wo, Wo, Wo, Wo, Wo, Wo, Wo, Wo
Wo, Wo, Wo, Wo, Wo, Wo, Wo, Wo, Wwr, Wwr, Wo, Wwr, Wwr, Wo, Wo, Wo, Wo, Wo, Wo, Wo, Wo, Wwr, Wo, Wwr, Wwr, Wo, Wo, Wo, Wo, Wo, Wo, Wo, Wo, Wwr, Wo, Wwr, Wo, Wo, Wo, Wo, Wo, Wo, Wo, Wo, Wo, Wo, Wo, Ww, Wo, Wo, Wo, Wo, Wo, Wo, Wo, Wo, Wo, Wo, Wo, Wo, Wo, Wo, Wo, Wo, Wo, Wo, Wo, Wo, Wo, Wo, Wo, Wo
Wo, Wo, Wo, Wo, Wo, Wo, Wo, Wo, Wo, Wo, Wo, Wwr, Wo, Wo, Wo, Wo, Wo, Wo, Wo, Wo, Wo, Wo, Wo, Wo, Wo, Wwr, Wwr, Wo, Wo, Wo, Wo, Wo, Wo, Wo, Wo, Wo, Wo, Wo, Wo, Wo, Wo, Wo, Wo, Wo, Wo, Wo, Wo, Wo, Wo, Wo, Wo, Wo, Wo, Wo, Wo, Wo, Wo, Wo, Wo, Wo, Wo, Wo, Wo, Wo, Wo, Wo, Wo, Wo, Wo, Wo, Wo, Wo
