Wo, Wo, Wo, Wo, Wo, Wo, Wo, Wo, Wo, Wo, Wo, Wo, Wo, Wo, Wo, Wo, Wo, Wo, Wo, Wo, Wo, Wo, Wo, Wo, Wo, Wo, Wo, Wo, Wo, Wo, Wo, Wo, Wo, Wo, Wo, Wo, Wo, Wo, Wo, Wo
Wo, Wo, Wo, Wo, Wo, Wo, Wo, Wo, Wo, Wo, Wo, Wo, Wo, Wo, Wo, Wo, Wo, Wo, Wo, Wo, Wo, Wo, Wo, Wo, Wo, Wo, Wo, Wo, Wo, Wo, Wo, Wo, Wo, Wo, Wo, Wo, Wo, Wo, Wo, Wo
Wo, Wo, Wo, Wo, Wo, Wo, Wo, Wo, Wo, Wo, Wo, Wo, Wo, Wo, Wo, Wo, Ww, Wo, Ww, Wo, Ww, Wo, Wo, Wo, Wo, Wo, Wo, Wo, Wo, Wo, Wo, Wo, Wo, Wo, Wo, Mm, Mm, Mm, Mm, Wo
Wo, Wo, Wo, Wo, Wo, Wo, Wo, Wo, Wo, Wo, Wo, Wo, Ww, Wo, Ww, Ww, Ww, Ww, Ww, Ww, Ww, Ww, Ww, Ww, Ww, Ww, Ww, Wo, Wo, Wo, Ww, Wo, Wo, Wo, Wo, Mm, Mv, Mm, Mm, Ww
Wo, Wo, Wo, Wo, Wo, Wo, Wo, Wo, Wo, Wo, Wo, Wo, Ww, Ww, Ww, Ww, Ds, Ww^Bw|r, Ds, Ww, Ww, Ww, Ww, Ww, Ww, Ww, Ww, Ww, Ww, Wo, Ww, Ww, Wo, Wo, Uu, Mm, Mm, Mm, Uu, Wo
Wo, Wo, Wo, Wo, Wo, Wo, Wo, Wo, Wo, Ww, Ww, Ww, Ww, Ww, Ds, Ds, Gd^Xff, Ds, Gd^Xff, Ds, Ds, Ds, Ds, Ww, Ww, Ww, Ds, Ww, Mm, Ww, Ww, Ww, Ww, Wo, Uu, Qlf, Qlf, Qlf, Uu, Uu
Wo, Wo, Wo, Wo, Ww, Wo, Ww, Wo, Ww, Ww, Mm, Ww, Mm, Ds, Gd^Xff, Gd^Xff, Gd^Xff, Gll, Gd, Gd^Xff, Gd^Xff, Gd^Xff, Gd^Xff, Ds, Ds, Ds, Mm, Mm, Mm, Mm, Mm, Uu, Uu, Uu, Wo, Uu, Uu, Uu, Wo, Uu
Wo, Wo, Wo, Ww, Ww, Ww, Ww, Ww, Ww, Mm, Mm, Mm, Mm, Mm, Gd^Xff, Gd^Xff, Gd, Gd, Gd, Gd, Gd, Gll^Efm, Gd, Gd, Gd, Hhd, Hh^Xff, Mm, Hh^Xff, Mm, Mm, Mm, Uu, Wo, Uu, Wo, Uu, Wo, Ww, Ww
Wo, Wo, Wo, Wo, Ww, Ww, Ds, Ww, Mm, Mm, Mm, Mm, Mm, Mm, Hhd, Gd, Rrc^Xfv, Ur, Rrc^Xfv, Gd, Gd, Gd, Gd^Xff, Gd, Gd, Gd^Xff, Gll^Vcl, Hh^Xff, Hh^Xff, Hh^Xff, Mm, Mm, Ww, Wo, Wo, Uu, Wo, Wo, Wo, Ww
Wo, Wo, Wo, Wo, Ww, Ww, Ds, Ds, Hh^Xff, Mm, Hhd, Mm, Hh^Xff, Hh^Xff, Gd, Gd, Ur, Ur, Gd, Gd, Gd^Xff, Gd^Xff, Ds, Gd^Xff, Ds, Gd^Xff, Gd^Xff, Hhd, Mm, Mm, Mm, Ds, Ww, Wo, Ww, Wo, Wo, Wo, Ww, Wo
Wo, Wo, Ww, Ww, Ww, Ds, Gll, Gd^Xff, Gd^Xff, Hh^Xff, Gll, Hhd, Gd^Xff, Gd^Xff, Gd, Gd^Xfw, Gd^Xfw, Gd, Rrc^Xfv, Gd, Gd^Xff, Ds, Ww, Ds, Ww, Ds, Gd, Hh^Xff, Hh^Xff, Mm, Ds, Ds, Uu, Wo, Ww, Wo, Wo, Wo, Wo, Ww
Wo, Wo, Wo, Ww, Ww, Ds, Ds, Gd^Xff, Gd, Gd^Xff, Rrc^Xfv, Gd^Xfw, Gd, Gd^Xfw, Gd^Xfw, Ur, Gd^Xfw, Gd, Gd^Xfw, Gd, Ds, Ds, Ww, Ww, Ww, Ds, Ds, Gd, Gs^Vcl, Hhd, Ds, Ww, Uu, Uu, Uu, Wo, Wo, Wo, Ww, Wo
Wo, Wo, Wo, Ww, Ww, Ww, Ds, Gd, Gd^Xff, Gd, Rd, Ur, Ur, Ur, Gd^Xfw, Gd, Gd^Xfw, Gd^Xfw, Ur, Gd^Xfw, Ds, Ww, Ww, Ww, Ww, Ww, Ww, Ds, Ds, Ds, Ww, Ww, Ww, Ww, Uu, Uu, Uu, Uu, Uu, Ww
Wo, Wo, Wo, Ww, Ww, Ww^Bw\r, Ds, Gd, Gd^Xff, Rrc^Xfv, Rb^Efm, Gd^Xfw, Ds, Ds, Ds, Ds, Ds, Gd, Gd, Rrc^Xfv, Gd, Ds, Ww, Ww, Ww, Ww, Ww, Ww, Ww, Ww, Ww, Ww, Uu, Wo, Uu, Qlf, Qlf, Qlf, Qlf, Ur
Wo, Wo, Ww, Ww, Ds, Ds, Gd, Gd, Gd, Gd^Xff, Rrc^Xfv, Ds, Ww, Ww, Ww, Ww, Ww, Ds, Gd, Gd, Ds^Bw\r, Ds^Bw\r, Ww, Ww, Wo, Wo, Ww, Ww, Ww, Ww, Wo, Wo, Wo, Uu, Wo, Uu, Uu, Ur, Ur, Qlf
Wo, Wo, Ww, Ds, Gd^Xff, Gd, Gd, Gd, Gd, Gd, Gd, Ds, Ds, Ww, Wo, Ww, Ww, Ds, Ds, Ds^Bw\r, Ds, Ww, Ww, Ww, Wo, Wo, Wo, Ww, Ww, Wo, Wo, Wo, Wo, Ww, Ww, Ww, Ds, Ds, Ur, Qlf
Ww, Ww, Ww, Ds, Gd^Xff, Gd, Gd, Gd, Gd, Gd, Gd^Xff, Ds, Ds, Ww, Ww, Ww, Ww, Ww, Ww, Ww, Ww, Ww, Ww, Wo, Ww, Ww, Ww, Wo, Wo, Wo, Wo, Wo, Ww, Ww, Ww, Ww, Ds, Rd^Es, Rd, Uh
Ww, Ww, Ds, Ds, Gd^Xff, Gd^Xff, Gd^Xff, Gd, Gd, Gd, Gd, Gd^Xff, Gd^Xff, Ds, Ww, Ww, Wo, Wo, Ww, Ww, Ww, Ww, Ww, Wo, Wo, Wo, Ww, Wo, Wo, Wo^Vcl, Wo, Wo, Wo, Ww, Ww, Ds, Rd, Rd, Gs^Es, Hh
Ww, Ww, Ww, Ds, Ds, Ds, Ds, Ds, Ds, Gd^Xff, Gd^Xff, Gd^Xff, Gd^Xff, Ds, Ds, Ww, Ww, Wo, Wo, Ww, Wo, Ww, Wo, Wo, Wo, Wo, Wo, Wo, Wo, Wo, Wo, Wo, Wo, Ww, Ww, Ds, Rd, Gs^Vcl, Rd, Ur
Wo, Ww, Ww, Ww, Ww, Ww, Ww, Ww^Bw|r, Ww, Ds, Ds, Ds, Ds, Ds, Wwr, Ww, Ww, Ww, Wo, Wo, Wo, Wo, Wo, Wo, Mm, Wo, Wo^Cov, Wo, Wo, Wo, Wo, Wo, Wo, Ww, Ww, Ds, Ds, Rd, Ur, Ur
Wo, Wo, Wo, Ww, Ww, Ww, Ww, Ww, Ww, Ww, Ww, Ww, Wwr, Ww, Ww, Wwr, Wwr, Wo, Wo, Wo, Wo, Wo, Wo, Mm, Wo, Mm^Cov, Mm^Kov, Wo^Cov, Wo, Wo, Wo, Wo, Wo, Ww, Uu, Ww, Uu, Ur, Qlf, Qlf
Wo, Wo, Wo, 1 Wo, Ww, Ww, Ww, Ww, Wo, Ww, Wo, Ww, Wwr, Ww, Wo, Ww, Wwr, Wo, Wo, Wo, Wo, Wo, Wo, Wo, Wo, Mm^Cov, Mm^Cov, Mm^Cov, Wo, Wo, Wo, Wo, Wo, Uu, Uu, Uu, Uu, Qlf, Uu, Ur
Wo, Wo, Wo, Wo, Wo, Wo, Wo, Ww, Ww, Ww, Wwr, Wwr, Wo, Ww, Wo, Wo, Wo, Wwr, Wo, Wo, Wo, Wo^Vcl, Wo, Wo, Wo, Wo, Wo, Wo, Wo, Wo, Wo, Wo, Wo, Wo, Wo, Wo, Wo, Uu, Ww, Ww
Wo, Wo, Wo, Wo, Wo, Wo, Ww, Wo, Wo, Wo, Wo, Wwr, Ww, Wo, Ww, Wo, Wo, Wwr, Wo, Wo, Wo, Wo, Wo, Wo, Wo, Wo, Wo, Wo, Wo, Wo, Wo, Wo, Wo, Wo, Wo, Uu, Uu, Uu, Ww, Ww
Wo, Wo, Wo, Wo, Wo, Wo, Wo, Wo, Wo, Wo, Ww, Wwr, Wwr, Ww, Wo, Wo, Wo, Wwr, Wo, Wo, Wo, Wo, Wo, Wo, Wo, Wo, Wo, Wo^Vcl, Wo, Wo, Wo, Wo, Wo, Wo, Wo, Wo, Wo, Ww, Ww, Mm
Wo, Wo, Wo, Wo, Wo, Wo, Wo, Wo, Ww, Ww, Ww, Wwr, Ww, Wwr, Wwr, Ww, Ww, Wwr, Ww, Ww, Ww, Wo, Wo, Wo, Ww, Wo, Ww, Wo, Ww, Wo, Ww, Wo, Wo, Wo, Wo, Wo, Wo, Ww, Ww, Ww
Wo, Wo, Wo, Wo, Wo, Wo, Wo, Wo, Wo, Wo, Ww, Ww, Ww, Ww, Ds, Ww, Ds, Wwr, Ds, Ww, Ww, Ww, Ww, Ww, Ww, Ww, Ww, Ww, Ww, Wo, Wo, Ww, Ww, Wo, Ww, Wo, Wo, Wo, Ww, Ww
Wo, Wo, Wo, Wo, Wo, Wo, Mm, Mm, Mm, Wo, Ww, Ww, Ww, Ds, Hh, Ds, Gs, Ds, Gs, Ds, Ds, Ds, Ds, Ww, Ww, Wo, Ww, Ww, Ww, Ww, Ww, Ww, Ww, Ww, Wo, Wo, Wo, Ww, Ww, Wo
Wo, Wo, Wo, Wo, Wo, Mm, Mm, Mm, Ww, Wo, Ww, Ww, Mm, Mm, Mm, Hh^Ftr, Hh^Ftr, Gs^Es, Gll, Gll^Ftr, Gll^Ftr, Gs, Hh^Ftr, Ds, Mm, Ww, Mm, Ww, Mm, Mm, Mm, Mm, Mm, Ww, Ww, Ww, Ww, Wo, Ww, Ww
Wo, Wo, Wo, Wo, Wo, Mm, Mm, Ww^Vcl, Ww, Wo, Ww, Ww, Mm, Mm, Mm, Mm, Hh, Gll^Ftr, Gll^Ftr, Gll, Gll^Es, Gll^Ftr, Hh^Ftr, Mm, Mm, Mm, Mm, Mm, Mm, Mm, Mm, Mm, Mm, Mm, Ww, Wo, Ww, Wo, Wo, Ww
Wo, Wo, Wo, Wo, Wo, Wo, Mm, Mm, Ww, Ww, Ww, Mm, Mm, Mm, Mm, Mm, Hh^Ftr, Gll^Vcl, Gll^Ftr, Gll^Ftr, Gll, Gll^Es, Hh, Mm, Hh^Ftr, Mm, Hh, Hh^Ftr, Hh^Ftr, Mm, Mm, Mm, Mm, Mm, Ww, Ww, Wo, Wo, Wo, Wo
Wo, Wo, Wo, Wo, Wo, Wo, Wo, Wo, Wo, Wo, Ww, Mm, Mm, Mm, Mm, Mm, Mm, Hh^Ftr, Gll^Es, Gll, Gll^Ftr, Gll, Gs^Es, Hh^Ftr, Gll, Hh^Ftr, Gll, Hh^Ftr, Mm, Mm, Mm, Mm, Ww, Ww, Wo, Ww, Wo, Wo, Ww, Ww
