Skl, Skl, Skl, Skl, Skl, Skl, Skl, Skl, Skl, Skl, Skl, Skl, Mka, Mka, Hka, Hka, Mka, Skl, Skl, Skl, Skl, Skl, Skl, Skl, Skl, Mka, Hka, Mka, Mka, Skl, Skl, Skl, Skl, Skl, Skl, Skl, Skl, Skl, Skl, Skl, Skl, Skl, Skl
Skl, Skl, Skl, Skl, Skl, Skl, Skl, Skl, Skl, Skl, Mka, Mka, Hka, Hka, Mka, Mka, Skl, Skl, Skl, Skl, Mka, Mka, Mka, Skl, Skl, Mka, Mka, Hka, Hka, Mka, Mka, Skl, Skl, Skl, Skl, Skl, Skl, Skl, Skl, Skl, Skl, Skl, Skl
Skl, Skl, Skl, Skl, Skl, Skl, Skl, Skl, Mka, Mka, Hka, Hka, Mka, Mka, Skl, Skl, Skl, Skl, Mka, Mka, Qxua, Qxua, Qxua, Mka, Mka, Skl, Skl, Mka, Mka, Hka, Hka, Mka, Mka, Skl, Skl, Skl, Skl, Skl, Skl, Skl, Skl, Skl, Skl
Skl, Skl, Skl, Skl, Skl, Skl, Mka, Mka, Hka, Hka, Mka, Mka, Skl, Skl, Skl, Skl, Skl, Mka, Qxua, Qxua, Qxdp, Qxdp, Qxdp, Qxua, Qxua, Mka, Skl, Skl, Skl, Mka, Mka, Hka, Hka, Mka, Mka, Skl, Skl, Skl, Skl, Skl, Skl, Skl, Skl
Skl, Skl, Skl, Skl, Mka, Mka, Hka, Hka, Mka, Mka, Skl, Skl, Skl, Skl, Skl, Skl, Skl, Mka, Qxua, Qxdp, Qxdp, Qxdp, Qxdp, Qxdp, Qxua, Mka, Skl, Skl, Skl, Skl, Skl, Mka, Mka, Hka, Hka, Mka, Mka, Skl, Skl, Skl, Skl, Skl, Skl
Skl, Skl, Skl, Skl, Mka, Hka, Mka, Mka, Skl, Skl, Skl, Skl, Skl, Skl, Skl, Skl, Skl, Mka, Qxua, Qxdp, Qxdp, Qxdp, Qxdp, Qxdp, Qxua, Mka, Skl, Skl, Skl, Skl, Skl, Skl, Skl, Mka, Mka, Hka, Hka, Mka, Mka, Skl, Skl, Skl, Skl
Skl, Skl, Mka, Skl, Skl, Mka, Skl, Skl, Skl, Skl, Skl, Skl, Skl, Skl, Skl, Skl, Skl, Mka, Qxua, Qxdp, Qxdp, Qxdp, Qxdp, Qxdp, Qxua, Mka, Skl, Skl, Skl, Skl, Skl, Skl, Skl, Skl, Skl, Mka, Mka, Hka, Hka, Mka, Mka, Skl, Skl
Skl, Skl, Mka, Skl, Skl, Skl, Skl, Skl, Skl, Skl, Skl, Skl, Skl, Skl, Skl, Skl, Skl, Mka, Mka, Qxua, Qxua, Qxdp, Qxua, Qxua, Mka, Mka, Skl, Skl, Skl, Skl, Skl, Skl, Skl, Skl, Skl, Skl, Skl, Mka, Mka, Hka, Hka, Mka, Mka
Skl, Skl, Skl, Mka, Skl, Skl, Skl, Skl, Skl, Skl, Skl, Skl, Skl, Skl, Skl, Skl, Skl, Skl, Skl, Mka, Mka, Skl, Skl, Mka, Skl, Skl, Skl, Skl, Skl, Skl, Skl, Skl, Skl, Skl, Skl, Skl, Skl, Skl, Skl, Mka, Mka, Hka, Hka
Skl, Skl, Skl, Mka, Skl, Skl, Skl, Skl, Mka, Mka, Mka, Mka, Mka, Skl, Mka, Skl, Mka^Ii, Skl, Skl, Skl, Skl, Skl, Mka, Skl, Skl, Skl, Skl, Skl, Skl, Skl, Skl, Skl, Skl, Skl, Skl, Skl, Skl, Skl, Skl, Skl, Skl, Mka, Mka
Skl, Skl, Mka, Mka, Skl, Skl, Skl, Skl, Mka, Skl, Skl, Skl, Skl, Mka, Skl, Mka^Ii, Mka^Ii, Mka^Ii, Mka, Mka, Mka, Mka, Skl, Mka, Mka, Mka, Mka, Skl, Skl, Skl, Skl, Skl, Skl, Skl, Skl, Skl, Skl, Skl, Skl, Skl, Skl, Skl, Skl
Skl, Skl, Mka, Mka, Skl, Skl, Skl, Mka, Skl, Skl, Hka, Skl, Skl, Skl, Skl, Skl, Skl, Skl, Skl, Skl, Skl, Skl, Hka, Skl, Skl, Skl, Skl, Mka, Mka, Skl, Skl, Skl, Skl, Skl, Skl, Skl, Skl, Skl, Skl, Skl, Skl, Skl, Skl
Skl, Skl, Mka, Mka, Skl, Skl, Skl, Mka, Skl, Skl, Skl, Hka, Skl, Skl, Skl, Hka, Skl, Hka, Skl, Skl, Skl, Skl, Hka, Skl, Hka, Hka, Hka, Skl, Skl, Mka, Mka, Skl, Skl, Skl, Skl, Skl, Skl, Skl, Skl, Skl, Skl, Skl, Skl
Skl, Skl, Mka, Skl, Skl, Skl, Mka, Mka, Skl, Skl, Skl, Hka, Hka, Skl, Hka, Hka, Skl, Hka, Skl, Skl, Hka, Hka, Skl, Hka, Skl, Skl, Skl, Skl, Mka, Mka, Mka, Mka, Mka, Skl, Skl, Skl, Skl, Skl, Skl, Skl, Skl, Skl, Skl
Skl, Mka, Skl, Skl, Skl, Mka, Mka, Skl, Skl, Skl, Skl, Skl, Hka, Skl, Hka, Skl, Hka, Hka, Hka, Hka, Skl, Skl, Mka, Skl, Mka, Mka, Mka, Mka, Skl, Mka, Skl, Mka, Mka^Ii, Mka^Ii, Mka^Ii, Skl, Skl, Skl, Skl, Skl, Skl, Skl, Skl
Skl, Skl, Skl, Skl, Mka, Mka, Skl, Skl, Skl, Skl, Skl, Skl, Hka, Hka, Skl, Hka, Skl, Skl, Skl, Skl, Mka, Mka, Skl, Mka, Skl, Skl, Skl, Skl, Hka, Skl, Hka, Skl, Skl, Mka^Ii, Mka, Skl, Skl, Skl, Skl, Skl, Skl, Skl, Skl
Mka, Skl, Mka, Skl, Mka, Mka, Mka, Skl, Skl, Skl, Hka, Hka, Skl, Skl, Skl, Skl, Skl, Skl, Mka, Mka, Mka, Skl, Hka, Skl, Hka, Hka, Hka, Hka, Skl, Hka, Skl, Skl, Skl, Skl, Skl, Mka, Skl, Skl, Skl, Skl, Skl, Skl, Skl
Hka, Mka, Hka, Mka, Hka, Hka, Hka, Mka, Mka, Skl, Hka, Skl, Skl, Skl, Skl, Skl, Skl, Skl, Mka, Mka, Skl, Skl, Hka, Skl, Hka, Skl, Skl, Skl, Skl, Skl, Skl, Skl, Skl, Skl, Skl, Mka, Skl, Skl, Skl, Skl, Skl, Skl, Skl
Mka, Hka, Mka, Hka, Mka, Mka, Mka, Hka, Hka, Mka, Hka, Mka, Mka, Skl, Mka, Skl, Mka, Mka, Skl, Skl, Skl, Skl, Hka, Skl, Skl, Hka, Skl, Skl, Hka, Skl, Hka, Skl, Hka, Skl, Skl, Mka, Mka, Skl, Skl, Skl, Skl, Skl, Skl
Skl, Mka, Skl, Mka, Mka, Skl, Skl, Mka, Mka, Hka, Hka, Hka, Hka, Mka, Hka, Mka, Hka, Mka, Mka, Skl, Skl, Skl, Skl, Hka, Hka, Hka, Hka, Hka, Skl, Hka, Skl, Hka, Skl, Skl, Skl, Skl, Mka, Skl, Skl, Skl, Skl, Skl, Skl
Skl, Skl, Skl, Skl, Mka, Skl, Skl, Skl, Skl, Mka, Mka, Mka, Mka, Hka, Mka, Hka, Mka, Hka, Hka, Mka, Mka, Skl, Hka, Hka, Skl, Skl, Skl, Skl, Skl, Skl, Skl, Skl, Skl, Skl, Skl, Skl, Skl, Mka, Skl, Skl, Skl, Skl, Skl
Mka, Skl, Skl, Skl, Mka, Skl, Mka, Mka, Mka, Mka, Skl, Skl, Skl, Mka, Skl, Mka, Hka, Hka, Mka, Hka, Hka, Hka, Mka, Skl, Skl, Skl, Mka, Mka, Mka, Mka, Mka, Mka, Mka, Mka, Mka, Mka, Mka, Mka, Skl, Skl, Skl, Skl, Skl
Mka, Mka, Skl, Skl, Mka, Mka, Skl, Skl, Skl, Skl, Hka, Hka, Hka, Hka, Hka, Hka, Skl, Skl, Skl, Mka, Mka, Hka, Hka, Mka^Ii, Mka^Ii, Mka^Ii, Skl, Skl, Skl, Skl, Skl, Skl, Skl, Skl, Skl, Mka, Mka, Mka, Skl, Skl, Skl, Skl, Skl
Mka, Skl, Hka^Xfy, Hka^Xfy, Hka^Xfy, Mka, Skl, Skl, Hka, Hka, Skl, Skl, Skl, Skl, Skl, Skl, Mka, Mka, Mka, Mka, Skl, Mka, Mka, Hka, Hka, Mka^Ii, Mka, Skl, Skl, Skl, Skl, Hka, Skl, Skl, Skl, Skl, Skl, Mka, Mka, Skl, Skl, Skl, Skl
Mka, Skl, Hka^Xfy, Hka, Hka^Xfy, Mka, Skl, Hka, Skl, Skl, Mka, Skl, Mka, Mka, Mka, Mka, Skl, Skl, Skl, Skl, Skl, Skl, Skl, Mka, Hka, Hka, Mka, Skl, Skl, Skl, Hka, Hka, Skl, Skl, Skl, Skl, Skl, Skl, Mka, Skl, Skl, Skl, Skl
Mka, Skl, Skl, Hka, Skl, Mka, Skl, Hka, Skl, Mka, Mka, Mka, Skl, Skl, Skl, Skl, Hka, Hka, Hka, Hka, Hka, Hka, Hka, Hka, Mka, Hka, Hka, Hka, Hka, Hka, Skl, Skl, Hka, Hka^Xfy, Hka^Xfy, Skl, Skl, Skl, Mka, Mka, Skl, Skl, Skl
Skl, Skl, Skl, Skl, Mka, Mka, Mka, Skl, Mka, Mka, Skl, Skl, Skl, Skl, Hka, Hka, Skl, Skl, Skl, Skl, Skl, Skl, Skl, Skl, Mka, Hka, Hka, Mka, Mka, Skl, Skl, Skl, Hka, Hka, Hka^Xfy, Skl, Skl, Skl, Skl, Mka, Skl, Skl, Skl
Skl, Skl, Skl, Skl, Skl, Mka, Mka, Mka, Mka, Skl, Skl, Skl, Hka, Hka, Skl, Skl, Mka, Skl, Mka, Mka, Mka, Mka, Mka, Mka, Mka, Mka, Mka, Hka, Mka, Skl, Mka, Skl, Mka, Hka^Xfy, Mka, Skl, Skl, Skl, Skl, Mka, Mka, Skl, Skl
Skl, Skl, Skl, Skl, Skl, Skl, Skl, Mka, Mka, Mka, Skl, Skl, Skl, Skl, Mka, Mka, Skl, Mka, Skl, Skl, Hka, Skl, Hka, Skl, Skl, Skl, Mka, Hka, Mka, Mka, Skl, Mka, Skl, Mka, Mka, Mka, Mka, Mka, Mka, Mka, Mka, Skl, Skl
Mka, Skl, Skl, Skl, Skl, Skl, Skl, Skl, Skl, Mka, Mka, Skl, Mka, Mka, Skl, Skl, Skl, Skl, Hka, Hka, Skl, Hka, Skl, Hka, Hka, Hka, Hka, Hka, Hka, Mka, Hka, Skl, Hka, Skl, Hka, Hka, Hka, Mka, Skl, Mka, Mka, Skl, Skl
Hka, Mka, Mka, Skl, Skl, Skl, Skl, Skl, Skl, Skl, Skl, Mka, Mka, Mka, Skl, Skl, Hka, Hka, Skl, Skl, Mka, Skl, Mka, Skl, Mka, Skl, Skl, Mka, Mka, Hka, Mka, Hka, Skl, Hka, Skl, Skl, Skl, Skl, Skl, Skl, Skl, Mka, Skl
Mka, Hka, Hka, Mka, Mka, Skl, Skl, Skl, Skl, Skl, Skl, Skl, Skl, Mka, Skl, Skl, Hka, Skl, Mka, Mka, Mka, Mka, Skl, Mka, Skl, Mka, Mka, Skl, Mka, Hka, Mka, Skl, Mka, Skl, Mka, Mka, Mka, Mka, Mka, Skl, Skl, Mka, Skl
Skl, Mka, Mka, Hka, Hka, Mka, Mka, Skl, Skl, Skl, Skl, Skl, Skl, Mka, Mka, Skl, Skl, Skl, Mka^Ii, Mka, Skl, Skl, Skl, Skl, Skl, Skl, Skl, Mka, Mka, Hka, Hka, Mka, Mka, Mka, Skl, Skl, Skl, Mka, Skl, Mka, Mka, Mka, Skl
Skl, Skl, Skl, Mka, Mka, Hka, Hka, Mka, Mka, Skl, Skl, Skl, Skl, Skl, Skl, Mka, Mka^Ii, Skl, Mka^Ii, Skl, Skl, Skl, Skl, Skl, Skl, Skl, Skl, Skl, Skl, Mka, Mka, Hka, Mka, Skl, Skl, Skl, Skl, Skl, Skl, Mka, Mka, Mka, Skl
Skl, Skl, Skl, Skl, Skl, Mka, Mka, Hka, Hka, Mka, Mka, Skl, Skl, Skl, Skl, Skl, Skl, Mka^Ii, Mka^Ii, Skl, Skl, Skl, Hka, Hka, Hka, Hka, Hka, Skl, Skl, Skl, Mka, Hka, Mka, Skl, Skl, Skl, Skl, Skl, Skl, Skl, Mka, Skl, Skl
Skl, Skl, Skl, Skl, Skl, Skl, Skl, Mka, Mka, Hka, Hka, Mka, Mka, Skl, Skl, Skl, Skl, Skl, Skl, Skl, Hka, Hka, Mka, Mka, Mka, Mka, Mka, Hka, Hka, Hka, Hka, Hka, Mka, Skl, Hka, Hka, Hka, Hka, Hka, Skl, Skl, Skl, Skl
Mka, Skl, Skl, Skl, Hka^Xfy, Hka^Xfy, Hka^Xfy, Skl, Skl, Mka, Mka, Mka, Skl, Mka, Skl, Skl, Skl, Skl, Skl, Skl, Hka, Mka, Skl, Skl, Skl, Mka, Skl, Mka, Mka, Mka, Mka, Hka, Hka, Hka, Mka, Mka, Mka, Mka, Mka, Hka, Hka, Skl, Skl
Mka, Skl, Skl, Skl, Hka^Xfy, Hka, Hka^Xfy, Skl, Skl, Mka, Skl, Skl, Mka, Skl, Skl, Skl, Skl, Skl, Skl, Skl, Hka, Mka, Skl, Skl, Skl, Skl, Skl, Skl, Skl, Mka, Mka, Hka, Mka, Mka, Skl, Skl, Skl, Skl, Skl, Mka, Mka, Hka, Skl
Mka, Mka, Skl, Skl, Skl, Hka, Skl, Skl, Skl, Skl, Skl, Mka, Mka, Skl, Skl, Skl, Skl, Skl, Skl, Skl, Skl, Hka, Skl, Skl, Skl, Skl, Skl, Skl, Skl, Skl, Mka, Hka, Mka, Skl, Skl, Skl, Skl, Skl, Skl, Mka, Hka, Hka, Skl
Mka, Mka, Mka, Skl, Skl, Skl, Skl, Skl, Skl, Skl, Mka, Mka, Mka, Skl, Skl, Skl, Skl, Skl, Skl, Skl, Skl, Skl, Hka, Hka, Hka, Hka, Hka, Hka, Hka, Mka, Hka, Hka, Mka, Skl, Skl, Skl, Skl, Skl, Skl, Mka, Skl, Skl, Skl
Mka, Mka, Mka, Skl, Skl, Skl, Skl, Skl, Skl, Skl, Mka, Hka, Mka, Mka, Skl, Skl, Skl, Skl, Skl, Skl, Hka, Hka, Mka, Mka, Mka, Mka, Mka, Mka, Mka, Hka, Hka, Mka, Hka, Skl, Hka, Skl, Skl, Skl, Skl, Skl, Skl, Skl, Skl
Mka, Mka, Skl, Skl, Skl, Skl, Skl, Skl, Skl, Skl, Mka, Hka, Mka, Skl, Skl, Skl, Skl, Skl, Skl, Skl, Hka, Mka, Skl, Skl, Skl, Skl, Skl, Skl, Skl, Mka, Hka, Hka, Mka, Hka, Mka, Hka, Hka, Hka, Hka, Skl, Skl, Skl, Skl
Mka, Mka, Skl, Skl, Skl, Skl, Skl, Skl, Skl, Skl, Mka, Hka, Mka, Skl, Skl, Skl, Skl, Skl, Skl, Skl, Skl, Skl, Skl, Skl, Skl, Skl, Skl, Skl, Mka, Mka, Hka, Mka, Skl, Mka, Skl, Mka, Mka, Mka, Mka, Hka, Skl, Skl, Skl
Skl, Skl, Skl, Skl, Skl, Skl, Skl, Skl, Mka, Mka, Hka, Hka, Mka, Skl, Skl, Skl, Skl, Skl, Skl, Skl, Skl, Skl, Hka, Hka, Hka, Hka, Hka, Hka, Hka, Hka, Mka, Mka, Skl, Skl, Skl, Skl, Skl, Mka, Mka, Hka, Skl, Skl, Skl
Skl, Skl, Skl, Skl, Mka, Mka, Mka, Mka, Mka, Hka, Mka, Mka, Skl, Skl, Skl, Skl, Skl, Skl, Skl, Skl, Hka, Hka, Mka, Mka, Mka, Mka, Mka, Mka, Mka, Hka, Mka, Skl, Hka, Skl, Skl, Skl, Skl, Skl, Mka, Hka, Skl, Skl, Skl
Skl, Skl, Skl, Skl, Mka, Mka, Qxua, Qxdp, Qxua, Mka, Mka, Skl, Skl, Skl, Skl, Skl, Skl, Skl, Skl, Hka, Mka, Mka, Skl, Skl, Skl, Skl, Skl, Skl, Mka, Hka, Hka, Hka, Mka, Hka, Hka, Hka, Hka, Skl, Skl, Skl, Skl, Skl, Skl
Skl, Skl, Skl, Skl, Mka, Qxua, Qxdp, Qxdp, Qxua, Mka, Skl, Skl, Skl, Skl, Skl, Skl, Skl, Skl, Hka, Hka, Mka, Skl, Skl, Skl, Skl, Skl, Skl, Mka, Hka, Hka, Mka, Mka, Skl, Mka, Mka, Mka, Mka, Hka, Skl, Skl, Skl, Skl, Skl
Skl, Skl, Skl, Mka, Mka, Qxua, Qxdp, Qxdp, Qxdp, Mka, Skl, Skl, Skl, Skl, Skl, Skl, Skl, Skl, Hka, Mka, Skl, Skl, Skl, Skl, Skl, Skl, Skl, Mka, Hka, Mka, Skl, Skl, Skl, Skl, Skl, Mka, Mka, Hka, Skl^Cov, Skl^Cov, Skl^Cov, Skl, Skl
Skl, Skl, Mka, Mka, Mka, Qxua, Qxua, Qxua, Mka, Mka, Skl, Skl, Skl, Skl, Skl, Skl, Skl, Skl, Hka, Mka, Mka, Skl, Skl, Skl, Skl, Skl, Skl, Mka, Hka, Mka, Skl, Skl, Skl, Skl, Skl, Skl, Mka, Hka, Skl^Cov, Skl^Kov, Skl^Cov, Skl, Skl
Skl, Skl, Mka, Mka, Mka, Mka, Mka, Mka, Skl, Skl, Skl, Skl, Skl, Skl, Skl, Skl, Skl, Skl, Skl, Hka, Skl, Skl, Skl, Skl, Skl, Skl, Skl, Mka, Hka, Mka, Skl, Skl, Skl, Skl, Mka, Mka, Hka, Hka, Skl, Skl^Cov, Skl, Skl, Skl
Skl, Mka, Mka, Mka, Mka, Mka, Mka, Mka, Skl, Skl, Skl, Skl, Skl, Skl, Skl, Skl, Skl, Skl, Skl, Skl, Skl, Skl, Skl, Skl, Skl, Skl, Skl, Mka, Hka, Mka, Skl, Skl, Skl, Skl, Skl, Hka, Skl, Skl, Skl, Skl, Skl, Skl, Skl
Skl, Mka, Skl, Mka, Mka, Mka, Mka, Skl, Skl, Skl, Skl, Skl, Skl, Skl, Skl, Skl, Skl, Skl, Skl, Skl, Skl, Skl, Skl, Skl, Skl, Skl, Skl, Mka, Hka, Mka, Skl, Skl, Skl, Skl, Skl, Skl, Skl, Skl, Skl, Skl, Skl, Skl, Skl
