Qraw, Qraw, Qraw, Qraw, Qraw, Qraw, Qraw, Qraw, Qraw, Qraw, Qraw, Qraw, Qraw, Qraw, Qraw, Qraw, Qraw, Qraw, Qraw, Qraw, Qraw, Qraw, Qraw, Qraw, Qraw, Qraw, Qraw, Qraw, Qraw, Qraw, Qraw, Qraw, Qraw, Qraw, Qraw, Qraw, Qraw, Qraw, Qraw, Qraw, Qraw, Qraw, Qraw
Qraw, Qraw, Qraw, Qraw, Qraw, Qraw, Qraw, Qraw, Qraw, Qraw, Qraw, Qraw, Qraw, Qraw, Qraw, Qraw, Qraw, Qraw, Qraw, Qraw, Qraw, Qraw, Qraw, Qraw, Qraw, Qraw, Qraw, Qraw, Qraw, Qraw, Qraw, Qraw, Qraw, Qraw, Qraw, Qraw, Qraw, Qraw, Qraw, Qraw, Qraw, Qraw, Qraw
Qraw, Qraw, Qraw, Qraw, Qraw, Qraw, Qraw, Qraw, Qraw, Qraw, Qraw, Qraw, Qraw, Qraw, Qraw, Qraw, Qraw, Qraw, Qraw, Qraw, Qraw, Qraw, Qraw, Qraw, Qraw, Qraw, Qraw, Qraw, Qraw, Qraw, Qraw, Qraw, Qraw, Qraw, Qraw, Qraw, Qraw, Qraw, Qraw, Qraw, Qraw, Qraw, Qraw
Qraw, Qraw, Qraw, Qraw, Qraw, Qraw, Qraw, Qraw, Qraw, Qraw, Qraw, Qraw, Qraw, Qraw, Qraw, Qraw, Qraw, Qraw, Qraw, Qraw, Qraw, Qraw, Qraw, Qraw, Qraw, Qraw, Qraw, Qraw, Qraw, Qraw, Qraw, Qraw, Qraw, Qraw, Qraw, Qraw, Qraw, Qraw, Qraw, Qraw, Qraw, Qraw, Qraw
Qraw, Qraw, Qraw, Qraw, Qraw, Qraw, Qraw, Qraw, Qraw, Qraw, Qraw, Qraw, Qraw, Qraw, Qraw, Qraw, Qraw, Qraw, Qraw, Qraw, Qraw, Qraw, Qraw, Qraw, Qraw, Qraw, Qraw, Qraw, Qraw, Qraw, Qraw, Qraw, Qraw, Qraw, Qraw, Qraw, Qraw, Qraw, Qraw, Qraw, Qraw, Qraw, Qraw
Qraw, Qraw, Qraw, Qraw, Qraw, Qraw, Qraw, Qraw, Qraw, Qraw, Qraw, Qraw, Qraw, Qraw, Qraw, Qraw, Qraw, Qraw, Qraw, Qraw, Qraw, Qraw, Qraw, Qraw, Qraw, Qraw, Qraw, Qraw, Qraw, Qraw, Qraw, Qraw, Qraw, Qraw, Qraw, Qraw, Qraw, Qraw, Qraw, Qraw, Qraw, Qraw, Qraw
Qraw, Qraw, Qraw, Qraw, Qraw, Qraw, Qraw, Qraw, Qraw, Qraw, Qraw, Qraw, Qraw, Qraw, Qraw, Qraw, Qraw, Qraw, Qraw, Qraw, Qraw, Qraw, Qraw, Qraw, Qraw, Qraw, Qraw, Qraw, Qraw, Qraw, Qraw, Qraw, Qraw, Qraw, Qraw, Qraw, Qraw, Qraw, Qraw, Qraw, Qraw, Qraw, Qraw
Qraw, Qraw, Qraw, Qraw, Qraw, Qraw, Qraw, Qraw, Qraw, Qraw, Qraw, Qraw, Qraw, Qraw, Qraw, Qraw, Qraw, Qraw, Qraw, Qraw, Qraw, Qraw, Qraw, Qraw, Qraw, Qraw, Qraw, Qraw, Qraw, Qraw, Qraw, Qraw, Qraw, Qraw, Qraw, Qraw, Qraw, Qraw, Qraw, Qraw, Qraw, Qraw, Qraw
Qraw, Qraw, Qraw, Qraw, Qraw, Qraw, Qraw, Qraw, Qraw, Qraw, Qraw, Qraw, Qraw, Qraw, Qraw, Qraw, Qraw, Qraw, Qraw, Qraw, Qraw, Qraw, Qraw, Qraw, Qraw, Qraw, Qraw, Qraw, Qraw, Qraw, Qraw, Qraw, Qraw, Qraw, Qraw, Qraw, Qraw, Qraw, Qraw, Qraw, Qraw, Qraw, Qraw
Qraw, Qraw, Qraw, Qraw, Qraw, Qraw, Qraw, Qraw, Qraw, Qraw, Qraw, Qraw, Qraw, Qraw, Qraw, Qraw, Qraw, Qraw, Qraw, Qraw, Qraw, Qraw, Qraw, Qraw, Qraw, Qraw, Qraw, Qraw, Qraw, Qraw, Qraw, Qraw, Qraw, Qraw, Qraw, Qraw, Qraw, Qraw, Qraw, Qraw, Qraw, Qraw, Qraw
Qraw, Qraw, Qraw, Qraw, Qraw, Qraw, Qraw, Qraw, Qraw, Qraw, Qraw, Qraw, Qraw, Qraw, Qraw, Qraw, Qraw, Qraw, Qraw, Qraw, Qraw, Qraw, Qraw, Qraw, Qraw, Qraw, Qraw, Qraw, Qraw, Qraw, Qraw, Qraw, Qraw, Qraw, Qraw, Qraw, Qraw, Qraw, Qraw, Qraw, Qraw, Qraw, Qraw
Qraw, Qraw, Qraw, Qraw, Qraw, Qraw, Qraw, Qraw, Qraw, Qraw, Qraw, Qraw, Qraw, Qraw, Qraw, Qraw, Qraw, Qraw, Qraw, Qraw, Qraw, Qraw, Qraw, Qraw, Qraw, Qraw, Qraw, Qraw, Qraw, Qraw, Qraw, Qraw, Qraw, Qraw, Qraw, Qraw, Qraw, Qraw, Qraw, Qraw, Qraw, Qraw, Qraw
Qraw, Qraw, Qraw, Qraw, Qraw, Qraw, Qraw, Qraw, Qraw, Qraw, Qraw, Qraw, Qraw, Qraw, Qraw, Qraw, Qraw, Qraw, Qraw, Qraw, Qraw, Qraw, Qraw, Qraw, Qraw, Qraw, Qraw, Qraw, Qraw, Qraw, Qraw, Qraw, Qraw, Qraw, Qraw, Qraw, Qraw, Qraw, Qraw, Qraw, Qraw, Qraw, Qraw
Qraw, Qraw, Qraw, Qraw, Qraw, Qraw, Qraw, Qraw, Qraw, Qraw, Qraw, Qraw, Qraw, Qraw, Qraw, Qraw, Qraw, Qraw, Qraw, Qraw, Qraw, Qraw, Qraw, Qraw, Qraw, Qraw, Qraw, Qraw, Qraw, Qraw, Qraw, Qraw, Qraw, Qraw, Qraw, Qraw, Qraw, Qraw, Qraw, Qraw, Qraw, Qraw, Qraw
Qraw, Qraw, Qraw, Qraw, Qraw, Qraw, Qraw, Qraw, Qraw, Qraw, Qraw, Qraw, Qraw, Qraw, Qraw, Qraw, Qraw, Qraw, Qraw, Qraw, Qraw, Qraw, Qraw, Qraw, Qraw, Qraw, Qraw, Qraw, Qraw, Qraw, Qraw, Qraw, Qraw, Qraw, Qraw, Qraw, Qraw, Qraw, Qraw, Qraw, Qraw, Qraw, Qraw
Qraw, Qraw, Qraw, Qraw, Qraw, Qraw, Qraw, Qraw, Qraw, Qraw, Qraw, Qraw, Qraw, Qraw, Qraw, Qraw, Qraw, Qraw, Qraw, Qraw, Qraw, Qraw, Qraw, Qraw, Qraw, Qraw, Qraw, Qraw, Qraw, Qraw, Qraw, Qraw, Qraw, Qraw, Qraw, Qraw, Qraw, Qraw, Qraw, Qraw, Qraw, Qraw, Qraw
Qraw, Qraw, Qraw, Qraw, Qraw, Qraw, Qraw, Qraw, Qraw, Qraw, Qraw, Qraw, Qraw, Qraw, Qraw, Qraw, Qraw, Qraw, Qraw, Qraw, Qraw, Qraw, Qraw, Qraw, Qraw, Qraw, Qraw, Qraw, Qraw, Qraw, Qraw, Qraw, Qraw, Qraw, Qraw, Qraw, Qraw, Qraw, Qraw, Qraw, Qraw, Qraw, Qraw
Qraw, Qraw, Qraw, Qraw, Qraw, Qraw, Qraw, Qraw, Qraw, Qraw, Qraw, Qraw, Qraw, Qraw, Qraw, Qraw, Qraw, Qraw, Qraw, Qraw, Qraw, Qraw, Qraw, Qraw, Qraw, Qraw, Qraw, Qraw, Qraw, Qraw, Qraw, Qraw, Qraw, Qraw, Qraw, Qraw, Qraw, Qraw, Qraw, Qraw, Qraw, Qraw, Qraw
Qraw, Qraw, Qraw, Qraw, Qraw, Qraw, Qraw, Qraw, Qraw, Qraw, Qraw, Qraw, Qraw, Qraw, Qraw, Qraw, Qraw, Qraw, Qraw, Qraw, Qraw, Qraw, Qraw, Qraw, Qraw, Qraw, Qraw, Qraw, Qraw, Qraw, Qraw, Qraw, Qraw, Qraw, Qraw, Qraw, Qraw, Qraw, Qraw, Qraw, Qraw, Qraw, Qraw
Qraw, Qraw, Qraw, Qraw, Qraw, Qraw, Qraw, Qraw, Qraw, Qraw, Qraw, Qraw, Qraw, Qraw, Qraw, Qraw, Qraw, Qraw, Qraw, Qraw, Qraw, Qraw, Qraw, Qraw, Qraw, Qraw, Qraw, Qraw, Qraw, Qraw, Qraw, Qraw, Qraw, Qraw, Qraw, Qraw, Qraw, Qraw, Qraw, Qraw, Qraw, Qraw, Qraw
Qraw, Qraw, Qraw, Qraw, Qraw, Qraw, Qraw, Qraw, Qraw, Qraw, Qraw, Qraw, Qraw, Qraw, Qraw, Qraw, Qraw, Qraw, Qraw, Qraw, Qraw, Qraw, Qraw, Qraw, Qraw, Qraw, Qraw, Qraw, Qraw, Qraw, Qraw, Qraw, Qraw, Qraw, Qraw, Qraw, Qraw, Qraw, Qraw, Qraw, Qraw, Qraw, Qraw
Qraw, Qraw, Qraw, Qraw, Qraw, Qraw, Qraw, Qraw, Qraw, Qraw, Qraw, Qraw, Qraw, Qraw, Qraw, Qraw, Qraw, Qraw, Qraw, Qraw, Qraw, Qraw, Qraw, Qraw, Qraw, Qraw, Qraw, Qraw, Qraw, Qraw, Qraw, Qraw, Qraw, Qraw, Qraw, Qraw, Qraw, Qraw, Qraw, Qraw, Qraw, Qraw, Qraw
Qraw, Qraw, Qraw, Qraw, Qraw, Qraw, Qraw, Qraw, Qraw, Qraw, Qraw, Qraw, Qraw, Qraw, Qraw, Qraw, Qraw, Qraw, Qraw, Qraw, Qraw, Qraw, Qraw, Qraw, Qraw, Qraw, Qraw, Qraw, Qraw, Qraw, Qraw, Qraw, Qraw, Qraw, Qraw, Qraw, Qraw, Qraw, Qraw, Qraw, Qraw, Qraw, Qraw
Qraw, Qraw, Qraw, Qraw, Qraw, Qraw, Qraw, Qraw, Qraw, Qraw, Qraw, Qraw, Qraw, Qraw, Qraw, Qraw, Qraw, Qraw, Qraw, Qraw, Qraw, Qraw, Qraw, Qraw, Qraw, Qraw, Qraw, Qraw, Qraw, Qraw, Qraw, Qraw, Qraw, Qraw, Qraw, Qraw, Qraw, Qraw, Qraw, Qraw, Qraw, Qraw, Qraw
Qraw, Qraw, Qraw, Qraw, Qraw, Qraw, Qraw, Qraw, Qraw, Qraw, Qraw, Qraw, Qraw, Qraw, Qraw, Qraw, Qraw, Qraw, Qraw, Qraw, Qraw, Qraw, Qraw, Qraw, Qraw, Qraw, Qraw, Qraw, Qraw, Qraw, Qraw, Qraw, Qraw, Qraw, Qraw, Qraw, Qraw, Qraw, Qraw, Qraw, Qraw, Qraw, Qraw
Qraw, Qraw, Qraw, Qraw, Qraw, Qraw, Qraw, Qraw, Qraw, Qraw, Qraw, Qraw, Qraw, Qraw, Qraw, Qraw, Qraw, Qraw, Qraw, Qraw, Qraw, Qraw, Qraw, Qraw, Qraw, Qraw, Qraw, Qraw, Qraw, Qraw, Qraw, Qraw, Qraw, Qraw, Qraw, Qraw, Qraw, Qraw, Qraw, Qraw, Qraw, Qraw, Qraw
Qraw, Qraw, Qraw, Qraw, Qraw, Qraw, Qraw, Qraw, Qraw, Qraw, Qraw, Qraw, Qraw, Qraw, Qraw, Qraw, Qraw, Qraw, Qraw, Qraw, Qraw, Qraw, Qraw, Qraw, Qraw, Qraw, Qraw, Qraw, Qraw, Qraw, Qraw, Qraw, Qraw, Qraw, Qraw, Qraw, Qraw, Qraw, Qraw, Qraw, Qraw, Qraw, Qraw
Qraw, Qraw, Qraw, Qraw, Qraw, Qraw, Qraw, Qraw, Qraw, Qraw, Qraw, Qraw, Qraw, Qraw, Qraw, Qraw, Qraw, Qraw, Qraw, Qraw, Qraw, Qraw, Qraw, Qraw, Qraw, Qraw, Qraw, Qraw, Qraw, Qraw, Qraw, Qraw, Qraw, Qraw, Qraw, Qraw, Qraw, Qraw, Qraw, Qraw, Qraw, Qraw, Qraw
Qraw, Qraw, Qraw, Qraw, Qraw, Qraw, Qraw, Qraw, Qraw, Qraw, Qraw, Qraw, Qraw, Qraw, Qraw, Qraw, Qraw, Qraw, Qraw, Qraw, Qraw, Qraw, Qraw, Qraw, Qraw, Qraw, Qraw, Qraw, Qraw, Qraw, Qraw, Qraw, Qraw, Qraw, Qraw, Qraw, Qraw, Qraw, Qraw, Qraw, Qraw, Qraw, Qraw
Qraw, Qraw, Qraw, Qraw, Qraw, Qraw, Qraw, Qraw, Qraw, Qraw, Qraw, Qraw, Qraw, Qraw, Qraw, Qraw, Qraw, Qraw, Qraw, Qraw, Qraw, Qraw, Qraw, Qraw, Qraw, Qraw, Qraw, Qraw, Qraw, Qraw, Qraw, Qraw, Qraw, Qraw, Qraw, Qraw, Qraw, Qraw, Qraw, Qraw, Qraw, Qraw, Qraw
Qraw, Qraw, Qraw, Qraw, Qraw, Qraw, Qraw, Qraw, Qraw, Qraw, Qraw, Qraw, Qraw, Qraw, Qraw, Qraw, Qraw, Qraw, Qraw, Qraw, Qraw, Qraw, Qraw, Qraw, Qraw, Qraw, Qraw, Qraw, Qraw, Qraw, Qraw, Qraw, Qraw, Qraw, Qraw, Qraw, Qraw, Qraw, Qraw, Qraw, Qraw, Qraw, Qraw
Qraw, Qraw, Qraw, Qraw, Qraw, Qraw, Qraw, Qraw, Qraw, Qraw, Qraw, Qraw, Qraw, Qraw, Qraw, Qraw, Qraw, Qraw, Qraw, Qraw, Qraw, Qraw, Qraw, Qraw, Qraw, Qraw, Qraw, Qraw, Qraw, Qraw, Qraw, Qraw, Qraw, Qraw, Qraw, Qraw, Qraw, Qraw, Qraw, Qraw, Qraw, Qraw, Qraw
Qraw, Qraw, Qraw, Qraw, Qraw, Qraw, Qraw, Qraw, Qraw, Qraw, Qraw, Qraw, Qraw, Qraw, Qraw, Qraw, Qraw, Qraw, Qraw, Qraw, Qraw, Qraw, Qraw, Qraw, Qraw, Qraw, Qraw, Qraw, Qraw, Qraw, Qraw, Qraw, Qraw, Qraw, Qraw, Qraw, Qraw, Qraw, Qraw, Qraw, Qraw, Qraw, Qraw
Qraw, Qraw, Qraw, Qraw, Qraw, Qraw, Qraw, Qraw, Qraw, Qraw, Qraw, Qraw, Qraw, Qraw, Qraw, Qraw, Qraw, Qraw, Qraw, Qraw, Qraw, Qraw, Qraw, Qraw, Qraw, Qraw, Qraw, Qraw, Qraw, Qraw, Qraw, Qraw, Qraw, Qraw, Qraw, Qraw, Qraw, Qraw, Qraw, Qraw, Qraw, Qraw, Qraw
Qraw, Qraw, Qraw, Qraw, Qraw, Qraw, Qraw, Qraw, Qraw, Qraw, Qraw, Qraw, Qraw, Qraw, Qraw, Qraw, Qraw, Qraw, Qraw, Qraw, Qraw, Qraw, Qraw, Qraw, Qraw, Qraw, Qraw, Qraw, Qraw, Qraw, Qraw, Qraw, Qraw, Qraw, Qraw, Qraw, Qraw, Qraw, Qraw, Qraw, Qraw, Qraw, Qraw
Qraw, Qraw, Qraw, Qraw, Qraw, Qraw, Qraw, Qraw, Qraw, Qraw, Qraw, Qraw, Qraw, Qraw, Qraw, Qraw, Qraw, Qraw, Qraw, Qraw, Qraw, Qraw, Qraw, Qraw, Qraw, Qraw, Qraw, Qraw, Qraw, Qraw, Qraw, Qraw, Qraw, Qraw, Qraw, Qraw, Qraw, Qraw, Qraw, Qraw, Qraw, Qraw, Qraw
Qraw, Qraw, Qraw, Qraw, Qraw, Qraw, Qraw, Qraw, Qraw, Qraw, Qraw, Qraw, Qraw, Qraw, Qraw, Qraw, Qraw, Qraw, Qraw, Qraw, Qraw, Qraw, Qraw, Qraw, Qraw, Qraw, Qraw, Qraw, Qraw, Qraw, Qraw, Qraw, Qraw, Qraw, Qraw, Qraw, Qraw, Qraw, Qraw, Qraw, Qraw, Qraw, Qraw
Qraw, Qraw, Qraw, Qraw, Qraw, Qraw, Qraw, Qraw, Qraw, Qraw, Qraw, Qraw, Qraw, Qraw, Qraw, Qraw, Qraw, Qraw, Qraw, Qraw, Qraw, Qraw, Qraw, Qraw, Qraw, Qraw, Qraw, Qraw, Qraw, Qraw, Qraw, Qraw, Qraw, Qraw, Qraw, Qraw, Qraw, Qraw, Qraw, Qraw, Qraw, Qraw, Qraw
Qraw, Qraw, Qraw, Qraw, Qraw, Qraw, Qraw, Qraw, Qraw, Qraw, Qraw, Qraw, Qraw, Qraw, Qraw, Qraw, Qraw, Qraw, Qraw, Qraw, Qraw, Qraw, Qraw, Qraw, Qraw, Qraw, Qraw, Qraw, Qraw, Qraw, Qraw, Qraw, Qraw, Qraw, Qraw, Qraw, Qraw, Qraw, Qraw, Qraw, Qraw, Qraw, Qraw
Qraw, Qraw, Qraw, Qraw, Qraw, Qraw, Qraw, Qraw, Qraw, Qraw, Qraw, Qraw, Qraw, Qraw, Qraw, Qraw, Qraw, Qraw, Qraw, Qraw, Qraw, Qraw, Qraw, Qraw, Qraw, Qraw, Qraw, Qraw, Qraw, Qraw, Qraw, Qraw, Qraw, Qraw, Qraw, Qraw, Qraw, Qraw, Qraw, Qraw, Qraw, Qraw, Qraw
Qraw, Qraw, Qraw, Qraw, Qraw, Qraw, Qraw, Qraw, Qraw, Qraw, Qraw, Qraw, Qraw, Qraw, Qraw, Qraw, Qraw, Qraw, Qraw, Qraw, Qraw, Qraw, Qraw, Qraw, Qraw, Qraw, Qraw, Qraw, Qraw, Qraw, Qraw, Qraw, Qraw, Qraw, Qraw, Qraw, Qraw, Qraw, Qraw, Qraw, Qraw, Qraw, Qraw
Qraw, Qraw, Qraw, Qraw, Qraw, Qraw, Qraw, Qraw, Qraw, Qraw, Qraw, Qraw, Qraw, Qraw, Qraw, Qraw, Qraw, Qraw, Qraw, Qraw, Qraw, Qraw, Qraw, Qraw, Qraw, Qraw, Qraw, Qraw, Qraw, Qraw, Qraw, Qraw, Qraw, Qraw, Qraw, Qraw, Qraw, Qraw, Qraw, Qraw, Qraw, Qraw, Qraw
Qraw, Qraw, Qraw, Qraw, Qraw, Qraw, Qraw, Qraw, Qraw, Qraw, Qraw, Qraw, Qraw, Qraw, Qraw, Qraw, Qraw, Qraw, Qraw, Qraw, Qraw, Qraw, Qraw, Qraw, Qraw, Qraw, Qraw, Qraw, Qraw, Qraw, Qraw, Qraw, Qraw, Qraw, Qraw, Qraw, Qraw, Qraw, Qraw, Qraw, Qraw, Qraw, Qraw
Qraw, Qraw, Qraw, Qraw, Qraw, Qraw, Qraw, Qraw, Qraw, Qraw, Qraw, Qraw, Qraw, Qraw, Qraw, Qraw, Qraw, Qraw, Qraw, Qraw, Qraw, Qraw, Qraw, Qraw, Qraw, Qraw, Qraw, Qraw, Qraw, Qraw, Qraw, Qraw, Qraw, Qraw, Qraw, Qraw, Qraw, Qraw, Qraw, Qraw, Qraw, Qraw, Qraw
Qraw, Qraw, Qraw, Qraw, Qraw, Qraw, Qraw, Qraw, Qraw, Qraw, Qraw, Qraw, Qraw, Qraw, Qraw, Qraw, Qraw, Qraw, Qraw, Qraw, Qraw, Qraw, Qraw, Qraw, Qraw, Qraw, Qraw, Qraw, Qraw, Qraw, Qraw, Qraw, Qraw, Qraw, Qraw, Qraw, Qraw, Qraw, Qraw, Qraw, Qraw, Qraw, Qraw
Qraw, Qraw, Qraw, Qraw, Qraw, Qraw, Qraw, Qraw, Qraw, Qraw, Qraw, Qraw, Qraw, Qraw, Qraw, Qraw, Qraw, Qraw, Qraw, Qraw, Qraw, Qraw, Qraw, Qraw, Qraw, Qraw, Qraw, Qraw, Qraw, Qraw, Qraw, Qraw, Qraw, Qraw, Qraw, Qraw, Qraw, Qraw, Qraw, Qraw, Qraw, Qraw, Qraw
Qraw, Qraw, Qraw, Qraw, Qraw, Qraw, Qraw, Qraw, Qraw, Qraw, Qraw, Qraw, Qraw, Qraw, Qraw, Qraw, Qraw, Qraw, Qraw, Qraw, Qraw, Qraw, Qraw, Qraw, Qraw, Qraw, Qraw, Qraw, Qraw, Qraw, Qraw, Qraw, Qraw, Qraw, Qraw, Qraw, Qraw, Qraw, Qraw, Qraw, Qraw, Qraw, Qraw
Qraw, Qraw, Qraw, Qraw, Qraw, Qraw, Qraw, Qraw, Qraw, Qraw, Qraw, Qraw, Qraw, Qraw, Qraw, Qraw, Qraw, Qraw, Qraw, Qraw, Qraw, Qraw, Qraw, Qraw, Qraw, Qraw, Qraw, Qraw, Qraw, Qraw, Qraw, Qraw, Qraw, Qraw, Qraw, Qraw, Qraw, Qraw, Qraw, Qraw, Qraw, Qraw, Qraw
Qraw, Qraw, Qraw, Qraw, Qraw, Qraw, Qraw, Qraw, Qraw, Qraw, Qraw, Qraw, Qraw, Qraw, Qraw, Qraw, Qraw, Qraw, Qraw, Qraw, Qraw, Qraw, Qraw, Qraw, Qraw, Qraw, Qraw, Qraw, Qraw, Qraw, Qraw, Qraw, Qraw, Qraw, Qraw, Qraw, Qraw, Qraw, Qraw, Qraw, Qraw, Qraw, Qraw
Qraw, Qraw, Qraw, Qraw, Qraw, Qraw, Qraw, Qraw, Qraw, Qraw, Qraw, Qraw, Qraw, Qraw, Qraw, Qraw, Qraw, Qraw, Qraw, Qraw, Qraw, Qraw, Qraw, 1 Qraw, Qraw, Qraw, Qraw, Qraw, Qraw, Qraw, Qraw, Qraw, Qraw, Qraw, Qraw, Qraw, Qraw, Qraw, Qraw, Qraw, Qraw, Qraw, Qraw
Qraw, Qraw, Qraw, Qraw, Qraw, Qraw, Qraw, Qraw, Qraw, Qraw, Qraw, Qraw, Qraw, Qraw, Qraw, Qraw, Qraw, Qraw, Qraw, Qraw, Qraw, Qraw, Qraw, Qraw, Qraw, Qraw, Qraw, Qraw, Qraw, Qraw, Qraw, Qraw, Qraw, Qraw, Qraw, Qraw, Qraw, Qraw, Qraw, Qraw, Qraw, Qraw, Qraw
Qraw, Qraw, Qraw, Qraw, Qraw, Qraw, Qraw, Qraw, Qraw, Qraw, Qraw, Qraw, Qraw, Qraw, Qraw, Qraw, Qraw, Qraw, Qraw, Qraw, Qraw, Qraw, Qraw, Qraw, Qraw, Qraw, Qraw, Qraw, Qraw, Qraw, Qraw, Qraw, Qraw, Qraw, Qraw, Qraw, Qraw, Qraw, Qraw, Qraw, Qraw, Qraw, Qraw
