Qxua, Qxua, Qxua, Qxua, Qxua, Qxua, Qxua, Qxua, Qxua, Qxua, Qxua, Qxua, Qxua, Qxua, Qxua, Qxua, Mka, Mka, Mka, Mka, Mka, Qxua, Qxua, Qxua, Qxua, Qxua, Qxua, Qxua, Qxua, Qxua, Qxua, Qxua, Qxua, Qxua, Qxua, Qxua, Qxua
Qxua, Qxua, Qxua, Qxua, Qxua, Qxua, Qxua, Qxua, Qxua, Qxua, Qxua, Qxua, Qxua, Qxua, Mka, Mka, Hka, Hka, 1 Hka, Hka, Hka, Mka, Mka, Qxua, Qxua, Qxua, Qxua, Qxua, Qxua, Qxua, Qxua, Qxua, Qxua, Qxua, Qxua, Qxua, Qxua
Qxua, Qxua, Qxua, Qxua, Qxua, Qxua, Qxua, Qxua, Qxua, Qxua, Qxua, Qxua, Mka, Mka, Skl, Skl, Hka, Hka, Hka, Hka, Hka, Skl, Skl, Mka, Mka, Qxua, Qxua, Qxua, Qxua, Qxua, Qxua, Qxua, Qxua, Qxua, Qxua, Qxua, Qxua
Qxua, Qxua, Qxua, Qxua, Qxua, Qxua, Qxua, Qxua, Qxua, Qxua, Qxua, Qxua, Mka, Skl, Skl, Skl, Skl, Hka, Hka, Hka, Skl, Skl, Skl, Skl, Mka, Qxua, Qxua, Qxua, Qxua, Qxua, Qxua, Qxua, Qxua, Qxua, Qxua, Qxua, Qxua
Qxua, Qxua, Qxua, Qxua, Qxua, Qxua, Qxua, Qxua, Qxua, Qxua, Qxua, Qxua, Mka, Skl, Skl, Skl, Skl, Skl, Hka, Skl, Skl, Skl, Skl, Skl, Mka, Qxua, Qxua, Qxua, Qxua, Qxua, Qxua, Qxua, Qxua, Qxua, Qxua, Qxua, Qxua
Qxua, Qxua, Qxua, Qxua, Qxua, Qxua, Qxua, Qxua, Qxua, Qxua, Qxua, Qxua, Mka, Skl, Skl, Skl, Skl, Skl, Hka, Skl, Skl, Skl, Skl, Skl, Mka, Qxua, Qxua, Qxua, Qxua, Qxua, Qxua, Qxua, Qxua, Qxua, Qxua, Qxua, Qxua
Qxua, Qxua, Qxua, Qxua, Qxua, Qxua, Qxua, Qxua, Qxua, Qxua, Qxua, Qxua, Qxua, Mka, Mka, Skl, Skl, Skl, Hka, Skl, Skl, Skl, Mka, Mka, Qxua, Qxua, Qxua, Qxua, Qxua, Qxua, Qxua, Qxua, Qxua, Qxua, Qxua, Qxua, Qxua
Qxua, Qxua, Qxua, Qxua, Qxua, Qxua, Qxua, Qxua, Qxua, Qxua, Qxua, Qxua, Qxua, Qxua, Qxua, Mka, Skl, Skl, Hka, Skl, Skl, Mka, Qxua, Qxua, Qxua, Qxua, Qxua, Qxua, Qxua, Qxua, Qxua, Qxua, Qxua, Qxua, Qxua, Qxua, Qxua
Qxua, Qxua, Qxua, Qxua, Qxua, Qxua, Qxua, Qxua, Qxua, Qxua, Qxua, Qxua, Qxua, Qxua, Qxua, Mka, Skl, Skl, Hka, Skl, Skl, Mka, Qxua, Qxua, Qxua, Qxua, Qxua, Qxua, Qxua, Qxua, Qxua, Qxua, Qxua, Qxua, Qxua, Qxua, Qxua
Qxua, Qxua, Qxua, Qxua, Qxua, Qxua, Qxua, Qxua, Qxua, Qxua, Qxua, Qxua, Qxua, Qxua, Qxua, Mka, Skl, Skl, Hka, Skl, Skl, Mka, Qxua, Qxua, Qxua, Qxua, Qxua, Qxua, Qxua, Qxua, Qxua, Qxua, Qxua, Qxua, Qxua, Qxua, Qxua
Qxua, Qxua, Qxua, Qxua, Qxua, Qxua, Qxua, Qxua, Qxua, Qxua, Qxua, Qxua, Qxua, Qxua, Mka, Mka, Skl, Skl, Hka, Skl, Skl, Mka, Mka, Qxua, Qxua, Qxua, Qxua, Qxua, Qxua, Qxua, Qxua, Qxua, Qxua, Qxua, Qxua, Qxua, Qxua
Qxua, Qxua, Qxua, Qxua, Qxua, Qxua, Qxua, Qxua, Qxua, Qxua, Qxua, Qxua, Mka, Mka, Skl, Skl, Skl, Skl, Hka, Skl, Skl, Skl, Skl, Mka, Mka, Qxua, Qxua, Qxua, Qxua, Qxua, Qxua, Qxua, Qxua, Qxua, Qxua, Qxua, Qxua
Qxua, Qxua, Qxua, Qxua, Qxua, Qxua, Qxua, Qxua, Qxua, Qxua, Qxua, Mka, Skl, Skl, Skl, Skl, Mka, Mka, Hka, Mka, Mka, Skl, Skl, Skl, Skl, Mka, Qxua, Qxua, Qxua, Qxua, Qxua, Qxua, Qxua, Qxua, Qxua, Qxua, Qxua
Qxua, Qxua, Qxua, Qxua, Qxua, Qxua, Qxua, Qxua, Qxua, Qxua, Qxua, Mka, Skl, Skl, Mka, Mka, Qxua, Qxua, Hka, Qxua, Qxua, Mka, Mka, Skl, Skl, Mka, Qxua, Qxua, Qxua, Qxua, Qxua, Qxua, Qxua, Qxua, Qxua, Qxua, Qxua
Qxua, Qxua, Qxua, Qxua, Qxua, Qxua, Qxua, Qxua, Qxua, Qxua, Qxua, Mka, Skl, Skl, Mka, Qxua, Qxua, Qxua, Hka, Qxua, Qxua, Qxua, Mka, Skl, Skl, Mka, Qxua, Qxua, Qxua, Qxua, Qxua, Qxua, Qxua, Qxua, Qxua, Qxua, Qxua
Qxua, Qxua, Qxua, Qxua, Qxua, Qxua, Qxua, Qxua, Qxua, Qxua, Qxua, Mka, Skl, Skl, Skl, Mka, Mka, Qxua, Hka, Qxua, Mka, Mka, Skl, Skl, Skl, Mka, Qxua, Qxua, Qxua, Qxua, Qxua, Qxua, Qxua, Qxua, Qxua, Qxua, Qxua
Qxua, Qxua, Qxua, Qxua, Qxua, Qxua, Qxua, Qxua, Qxua, Qxua, Qxua, Mka, Mka, Skl, Skl, Skl, Skl, Mka, Hka, Mka, Skl, Skl, Skl, Skl, Mka, Mka, Qxua, Qxua, Qxua, Qxua, Mka, Qxua, Qxua, Qxua, Qxua, Qxua, Qxua
Qxua, Qxua, Qxua, Qxua, Qxua, Qxua, Qxua, Qxua, Qxua, Qxua, Qxua, Qxua, Qxua, Mka, Mka, Skl, Skl, Skl, Hka, Skl, Skl, Skl, Mka, Mka, Qxua, Qxua, Qxua, Qxua, Mka, Mka, Hka, Mka, Mka, Qxua, Qxua, Qxua, Qxua
Qxua, Qxua, Qxua, Qxua, Qxua, Qxua, Qxua, Qxua, Qxua, Qxua, Qxua, Qxua, Qxua, Qxua, Qxua, Mka, Skl, Skl, Hka, Skl, Skl, Mka, Qxua, Qxua, Qxua, Qxua, Mka, Mka, Hka, Hka, Skl, Hka, Hka, Mka, Mka, Qxua, Qxua
Qxua, Qxua, Qxua, Qxua, Qxua, Qxua, Qxua, Qxua, Qxua, Qxua, Qxua, Qxua, Qxua, Qxua, Mka, Mka, Skl, Skl, Hka, Skl, Skl, Mka, Qxua, Qxua, Qxua, Qxua, Mka, Skl, Hka, Skl, Mka, Skl, Skl, Hka, Hka, Mka, Qxua
Qxua, Qxua, Qxua, Qxua, Qxua, Qxua, Qxua, Qxua, Qxua, Qxua, Qxua, Qxua, Mka, Mka, Skl, Skl, Mka, Skl, Hka, Skl, Skl, Mka, Mka, Qxua, Qxua, Qxua, Mka, Skl, Hka, Mka, Qxua, Mka, Skl, Skl, Hka, Mka, Qxua
Qxua, Qxua, Qxua, Qxua, Qxua, Qxua, Mka, Mka, Mka, Qxua, Mka, Mka, Skl, Skl, Mka, Mka, Mka, Skl, Skl, Hka, Hka, Skl, Skl, Mka, Mka, Mka, Skl, Skl, Hka, Mka, Qxua, Mka, Skl, Skl, Hka, Mka, Qxua
Qxua, Qxua, Qxua, Qxua, Qxua, Mka, Skl, Skl, Skl, Mka, Skl, Skl, Mka, Mka, Qxua, Qxua, Qxua, Mka, Mka, Skl, Skl, Hka, Hka, Skl, Skl, Skl, Hka, Hka, Skl, Mka, Qxua, Mka, Skl, Skl, Hka, Mka, Qxua
Qxua, Qxua, Qxua, Qxua, Qxua, Mka, Mka, Skl, Skl, Skl, Mka, Mka, Qxua, Qxua, Mka, Mka, Mka, Qxua, Qxua, Mka, Mka, Skl, Skl, Hka, Hka, Hka, Skl, Skl, Mka, Mka, Qxua, Mka, Skl, Skl, Hka, Mka, Qxua
Qxua, Qxua, Qxua, Qxua, Qxua, Qxua, Mka, Skl, Mka, Skl, Mka, Qxua, Mka, Mka, Hka, Hka, Hka, Mka, Mka, Qxua, Qxua, Mka, Mka, Skl, Skl, Skl, Mka, Mka, Qxua, Qxua, Mka, Mka, Skl, Skl, Hka, Mka, Qxua
Qxua, Qxua, Qxua, Qxua, Qxua, Qxua, Qxua, Mka, Qxua, Mka, Qxua, Qxua, Mka, Hka, Skl, Skl, Skl, Hka, Mka, Qxua, Qxua, Qxua, Qxua, Mka, Mka, Mka, Qxua, Qxua, Qxua, Mka, Mka, Mka, Skl, Skl, Hka, Mka, Qxua
Qxua, Qxua, Qxua, Qxua, Qxua, Qxua, Qxua, Qxua, Qxua, Qxua, Mka, Mka, Skl, Hka, Skl, Skl, Skl, Hka, Skl, Mka, Mka, Qxua, Qxua, Qxua, Qxua, Qxua, Mka, Mka, Mka, Mka, Skl, Skl, Hka, Hka, Skl, Mka, Qxua
Qxua, Qxua, Qxua, Qxua, Qxua, Qxua, Qxua, Qxua, Mka, Mka, Skl, Skl, Skl, Hka, Hka, Skl, Hka, Hka, Skl, Skl, Skl, Mka, Qxua, Qxua, Mka, Mka, Skl, Skl, Skl, Skl, Hka, Hka, Skl, Skl, Mka, Mka, Qxua
Qxua, Qxua, Qxua, Qxua, Qxua, Qxua, Qxua, Qxua, Mka, Skl, Skl, Skl, Skl, Skl, Skl, Hka, Skl, Skl, Skl, Skl, Skl, Mka, Qxua, Qxua, Mka, Skl, Skl, Skl, Skl, Skl, Hka, Skl, Mka, Mka, Qxua, Qxua, Qxua
Qxua, Qxua, Qxua, Qxua, Qxua, Qxua, Qxua, Qxua, Mka, Skl, Skl, Skl, Skl, Skl, Skl, Hka, Skl, Skl, Skl, Skl, Mka, Mka, Qxua, Qxua, Mka, Skl, Skl, Skl, Hka, Hka, Skl, Skl, Skl, Mka, Qxua, Qxua, Qxua
Qxua, Qxua, Qxua, Qxua, Qxua, Qxua, Qxua, Qxua, Mka, Skl, Skl, Skl, Skl, Skl, Skl, Hka, Skl, Skl, Mka, Mka, Qxua, Qxua, Mka, Mka, Skl, Skl, Hka, Hka, Skl, Skl, Skl, Skl, Skl, Mka, Qxua, Qxua, Qxua
Qxua, Qxua, Qxua, Qxua, Qxua, Qxua, Qxua, Qxua, Mka, Skl, Skl, Skl, Skl, Skl, Skl, Hka, Skl, Mka, Qxua, Qxua, Mka, Mka, Skl, Skl, Hka, Hka, Skl, Skl, Mka, Skl, Skl, Skl, Mka, Mka, Qxua, Qxua, Qxua
Qxua, Qxua, Qxua, Qxua, Qxua, Qxua, Qxua, Qxua, Mka, Skl, Skl, Skl, Skl, Skl, Skl, Hka, Skl, Mka, Qxua, Mka, Skl, Skl, Hka, Hka, Mka, Skl, Skl, Skl, Mka, Mka, Mka, Mka, Qxua, Qxua, Qxua, Qxua, Qxua
Qxua, Qxua, Qxua, Qxua, Qxua, Qxua, Qxua, Qxua, Qxua, Mka, Mka, Skl, Skl, Skl, Skl, Hka, Skl, Mka, Qxua, Mka, Skl, Hka, Mka, Mka, Mka, Skl, Mka, Mka, Mka, Qxua, Qxua, Qxua, Qxua, Qxua, Qxua, Qxua, Qxua
Qxua, Qxua, Qxua, Qxua, Qxua, Qxua, Qxua, Qxua, Qxua, Qxua, Qxua, Mka, Mka, Skl, Skl, Hka, Skl, Mka, Qxua, Mka, Skl, Hka, Mka, Qxua, Mka, Skl, Mka, Mka, Mka, Qxua, Qxua, Qxua, Qxua, Qxua, Qxua, Qxua, Qxua
Qxua, Qxua, Qxua, Qxua, Qxua, Qxua, Qxua, Qxua, Qxua, Qxua, Qxua, Qxua, Qxua, Mka, Skl, Hka, Skl, Mka, Qxua, Mka, Skl, Hka, Mka, Qxua, Mka, Skl, Skl, Mka, Mka, Qxua, Qxua, Qxua, Qxua, Qxua, Qxua, Qxua, Qxua
Qxua, Qxua, Qxua, Qxua, Qxua, Qxua, Qxua, Qxua, Qxua, Qxua, Qxua, Qxua, Qxua, Mka, Skl, Hka, Skl, Mka, Mka, Mka, Skl, Hka, Mka, Qxua, Mka, Mka, Skl, Skl, Skl, Mka, Qxua, Qxua, Qxua, Qxua, Qxua, Qxua, Qxua
Qxua, Qxua, Qxua, Qxua, Qxua, Qxua, Qxua, Qxua, Qxua, Qxua, Qxua, Qxua, Qxua, Mka, Skl, Hka, Skl, Mka, Skl, Skl, Hka, Hka, Mka, Qxua, Mka, Skl, Mka, Skl, Mka, Mka, Qxua, Qxua, Qxua, Qxua, Qxua, Qxua, Qxua
Qxua, Qxua, Qxua, Qxua, Qxua, Qxua, Qxua, Qxua, Qxua, Qxua, Qxua, Qxua, Mka, Mka, Skl, Hka, Skl, Skl, Hka, Hka, Skl, Skl, Mka, Qxua, Qxua, Mka, Qxua, Mka, Qxua, Qxua, Qxua, Qxua, Qxua, Qxua, Qxua, Qxua, Qxua
Qxua, Qxua, Qxua, Qxua, Qxua, Qxua, Qxua, Qxua, Qxua, Qxua, Qxua, Mka, Skl, Skl, Skl, Hka, Hka, Hka, Skl, Skl, Mka, Mka, Qxua, Qxua, Qxua, Qxua, Qxua, Qxua, Qxua, Qxua, Qxua, Qxua, Qxua, Qxua, Qxua, Qxua, Qxua
Qxua, Qxua, Qxua, Qxua, Qxua, Qxua, Qxua, Qxua, Qxua, Qxua, Qxua, Mka, Skl, Skl, Skl, Hka, Skl, Skl, Mka, Mka, Qxua, Qxua, Qxua, Qxua, Qxua, Qxua, Qxua, Qxua, Qxua, Qxua, Qxua, Qxua, Qxua, Qxua, Qxua, Qxua, Qxua
Qxua, Qxua, Qxua, Qxua, Qxua, Qxua, Qxua, Qxua, Qxua, Qxua, Qxua, Mka, Skl, Skl, Skl, Skl, Skl, Skl, Mka, Qxua, Qxua, Qxua, Qxua, Qxua, Qxua, Qxua, Qxua, Qxua, Qxua, Qxua, Qxua, Qxua, Qxua, Qxua, Qxua, Qxua, Qxua
Qxua, Qxua, Qxua, Qxua, Qxua, Qxua, Qxua, Qxua, Qxua, Qxua, Qxua, Mka, Mka, Skl, Skl, Skl, Skl, Skl, Mka, Qxua, Qxua, Qxua, Qxua, Qxua, Qxua, Qxua, Qxua, Qxua, Qxua, Qxua, Qxua, Qxua, Qxua, Qxua, Qxua, Qxua, Qxua
Qxua, Qxua, Qxua, Qxua, Qxua, Qxua, Qxua, Qxua, Qxua, Qxua, Qxua, Qxua, Qxua, Mka, Mka, Mka, Mka, Mka, Qxua, Qxua, Qxua, Qxua, Qxua, Qxua, Qxua, Qxua, Qxua, Qxua, Qxua, Qxua, Qxua, Qxua, Qxua, Qxua, Qxua, Qxua, Qxua
Qxua, Qxua, Qxua, Qxua, Qxua, Qxua, Qxua, Qxua, Qxua, Qxua, Qxua, Qxua, Qxua, Qxua, Qxua, Qxua, Qxua, Qxua, Qxua, Qxua, Qxua, Qxua, Qxua, Qxua, Qxua, Qxua, Qxua, Qxua, Qxua, Qxua, Qxua, Qxua, Qxua, Qxua, Qxua, Qxua, Qxua
Qxua, Qxua, Qxua, Qxua, Qxua, Qxua, Qxua, Qxua, Qxua, Qxua, Qxua, Qxua, Qxua, Qxua, Qxua, Qxua, Qxua, Qxua, Qxua, Qxua, Qxua, Qxua, Qxua, Qxua, Qxua, Qxua, Qxua, Qxua, Qxua, Qxua, Qxua, Qxua, Qxua, Qxua, Qxua, Qxua, Qxua
