Gs^Fms, Gg, Gg, Rp, Gg, Gg, Gs^Fms, Gs^Fms, Gll, Hh, Hh, Hh, Hh, Hh, Hh^Fms, Hh, Hh, Hh, Hh^Fms, Hh, Hh, Hh, Gll, Gg, Hh, Gg, Gs, Gg, Gg, Gg, Gg, Gg, Gg, Gg, Rp, Rp, Rp, Gg, Gg, Gg, Gg, Gg, Gg, Gg, Gg, Gg, Rp, Gg, Gg, Gg, Gg, Gg, Gll, Gg
Gs^Fms, Gg^Fet, Gg, Rp, Gg, Gs, Gg, Gg^Fet, Gs^Fms, Hh^Fms, Gs^Fms, Hh, Hh^Fms, Hh^Fms, Hh, Hh^Fms, Hh, Hh^Fms, Hh, Hh^Fms, Hh^Fms, Hh^Fms, Hh, Hh, Gll, Gs^Fms, Gs, Gg, Gg, Gg, Gg, Gg, Gs, Gg, Rp, Rp, Rp, Gg, Re^Vct, Gg, Gg, Gg, Gg, Gg, Gg, Gg, Rp, Gg, Gg, Gg, Gg, Gs^Fms, Hh^Fms, Gll
Hh^Fms, Gs^Fms, Gs, Rp, Rp, Rp, Rp, Gg, Gg, Gs^Fms, Gg^Fet, Gs^Fms, Gll, Hh, Hh, Hh^Fms, Hh^Fms, Hh^Fms, Hh^Fms, Hh, Hh^Fms, Hh^Fms, Hh, Hh, Gs^Fms, Gs^Fms, Gg, Gg, Gg^Es, Gg, Gg, Gs, Gs^Fms, Gs^Fms, Rp, Rp, Rp, Gs^Fms, Gll, Gg, Ce, Ce, Ce, Gg, Rp, Rp, Gg, Gg, Gg, Gg, Hh, Hh^Fms, Mm, Hh
Hh, Hh, Hh, Gg, Gs, Gg, Gg, Rp, Rp, Gs, 1 Gs, Gs^Fms, Gs^Fms, Hh, Hh, Hh^Fms, Hh, Hh, Hh, Hh^Fms, Hh, Hh^Fms, Hh, Hh, Gs^Fms, Gll, Gg, Gg, Gg, Gg, Gg, Gs, Gll, Gs^Fms, Rp, Rp, Rp, Gs^Fms, Gs^Fms, Gg, Ce, 4 Ke, Ce, Gg, Rp, Gg, Gg, Re^Vct, Gs^Fms, Hh, Mm, Mm, Mm, Mm
Hh^Fms, Hh^Fms, Hh^Fms, Gs^Fms, Gs^Fms, Gs^Fms, Gs, Gg^Es, Rp, Gg, Gg, Gg, Gs^Fms, Hh, Gg^Fet, Gs^Fms, Gs^Fms, Hh, Gs^Fms, Gs^Fms, Gs^Fms, Gll^Em, Gs^Fms, Gll, Gs^Fms, Gg, Gg, Gg, Gg, Gg, Gg, Gs, Gs^Fms, Gs^Fms, Rp, Rp, Rp, Gll, Gs^Fms, Gs^Fms, Gg, Ce, Gg, Gg, Rp, Gg, Gs^Fms, Gll, Gs^Fms, Hh^Fms, Mm, Mm, Mm, Mm
Hh^Fms, Hh, Hh^Fms, Hh, Gll, Gs^Fms, Gg, Gg, Gg, Rp, Rp, Gg, Ce, Gs, Ce, Gs, Gg, Gll, Gll, Gs^Fms, Gs, Gs^Fms, Gll, Gs^Fms, Gs, Gs, Gg, Gg, Gg, Gg, Gg, Gg, Rp, Rp, Rp, Rp, Rp, Gs^Fms, Gs^Fms, Gll, Gg, Gg, Gs, Gg, Rp, Gs, Gs^Fms, Gll, Hh, Hh^Fms, Hh, Mm, Hh^Fms, Mm
Hh, Hh, Hh, Hh^Fms, Hh^Fms, Gg^Fet, Gg, Gg, Gg, Gg, Rp, Gg, Ke, Ce, Gg^Ecf, Ce, Gg, Gg, Re^Vct, Gg, Gg, Gg, Gg, Gg, Gg, Gg, Gs, Gg, Gg, Gg, Rp, Rp, Rp, Rp, Rp, Rp, Gg, Gg, Gg, Gg, Re^Vct, Gg, Gs, Gg, Rp, Gg, Gg, Gs^Fms, Gg, Hh, Gll, Hh, Hh, Hh
Hh, Hh^Fms, Hh^Fms, Hh, Hh, Gll, Gll, Gs^Fms, Gg^Fet, Gs, Gg, Rp, Rp, Ce, Ce, Ce, Gg, Gg, Gg, Gg, Gg, Gg, Gg, Gg, Gs, Gs, Gs^Fms, Gs^Fms, Rp, Rp, Rp, Rp, Rp, Rp, Gs^Fms, Gs, Gs, Gg^Es, Gs, Gg, Gg, Gg, Gs, Gg, Rp, Gg, Gs, Gs, Gs, Gg, Gg, Gs^Fms, Gs^Fms, Gg
Hh, Hh, Hh^Fms, Hh^Fms, Hh^Fms, Hh, Hh, Gs^Fms, Gs^Fms, Gs, Re^Vct, Gg, Gg, Rp, Gs, Gg, Gg, Gg, Gg, Gg, Gs, Gs, Gg, Gg, Gll, Gs^Fms, Gll, Rp, Rp, Rp, Rp, Rp, Gs^Vh, Gs^Fms, Gs^Fms, Gs, Gg, Gg, Gs, Gs, Gg, Gg, Gg, Gg, Rp, Gs, Gg, Gg, Gg, Gs, Gg, Gg, Gg, Gg
Hh^Fms, Hh^Fms, Hh, Hh, Hh, Hh^Fms, Hh, Hh^Fms, Gll, Gg, Gg, Gg, Gg, Rp, Gs, Gs, Gg, Gs, Gg, Gg, Gg, Gg, Gg, Gg, Gs^Fms, Gs^Fms, Gs^Fms, Rp, Rp, Rp, Gs^Fms, Gll, Gs^Fms, Gs^Fms, Gs, Gs, Gg, Gg, Gg, Gg, Gg, Gg, Rp, Rp, Gg, Gs, Gg, Gg, Gs, Gg, Gg, Gg, Ww, Ww
Hh, Hh^Fms, Hh, Hh, Hh^Fms, Hh^Fms, Hh, Hh, Gs, Gg, Gg, Gg, Gg, Rp, Gs, Gg, Gg, Gg, Gg, Gg, Gg, Gg, Gg, Gs, Gs, Gs^Fms, Gs^Fms, Rp, Rp, Rp, Gs^Fms, Gs^Fms, Gs, Gs, Gg, Gg, Rp, Rp, Rp, Rp, Rp, Rp, Gg, Gg, Gg, Gg, Gs, Gs, Gg, Gg, Ww, Ww, Ww, Ww
Hh^Fms, Hh, Hh^Fms, Hh, Hh^Fms, Hh^Fms, Hh^Fms, Hh, Gs, Gs, Gg, Gs, Gg, Rp, Gg, Gs, Gg^Es, Gs, Gs, Gs, Gg, Gg, Gg, Gg, Gg, Gs, Gs^Fms, Rp, Rp, Rp, Gs^Fms, Gs, Gg, Gg, Rp, Rp, Gg, Gg, Gs, Gs, Gs, Gg^Es, Gg, Gg, Gd^Vhr, Gs, Gg, Gg, Gg, Ww, Ww, Ww, Gg, Gg
Hh, Hh^Fms, Hh, Hh^Fms, Hh, Hh, Hh, Gs^Fms, Gs^Fms, Gg, Gg, Gs, Gg, Rp, Gg, Gg, Gg, Gg, Gs, Gs, Gs, Gs, Gs, Gg, Gg, Gg, Cv, Cv, Kv, Cv, Cv, Gg, Rp, Rp, Gg, Gg, Gs, Gs, Gg, Gg, Gg, Gg, Gg, Gg, Rb^Gvs, Gg, Gg, Gg, Ww, Ww, Ww, Gg, Gg, Gg
Hh, Hh, Gs^Fms, Gll, Gll, Gll, Gll, Gs^Fms, Gll, Gg, Gs, Gs, Gg, Rp, Gg, Gg, Gg, Gg, Gs, Gs, Gs^Fms, Gs^Fms, Gs^Fms, Gg, Gg, Gg, Rrc, Rrc, Rrc, Rrc, Rrc, Rp, Rp, Gg, Gg, Gg, Gs, Gg, Gg, Gg, Gd^Vhr, Gg, Rb^Gvs, Rb^Gvs, Rb^Gvs, Rb^Gvs, Rb^Gvs, Gg, Ww, Ww, Gg, Gg, Gs, Gs
Gll, Gs^Fms, Gll, Gs^Fms, Gs^Fms, Gs^Fms, Gs^Fms, Gs^Fms, Gg, Gs, Gg^Es, Gs, Gg, Rp, Gg, Gg, Gs, Gg, Gs^Fms, Gs^Fms, Gll, Gll, Cv, Cv, Rrc, Rrc, Rrc, Gg^Ve, Rrc, Gg^Ve, Rrc, Rrc, Rrc, Cv, Cv, Gs^Fms, Gs^Fms, Gs, Gg, Gg, Rb^Gvs, Re, Re, Rb^Gvs, Rb^Gvs, Rb^Gvs, Gg, Gg^Wm, Ww, Ww, Gs, Gs, Gg, Gg
Gs^Fms, Gs^Fms, Gs^Fms, Gs, Gg, Gll, Gg, Gs, Gg, Gg, Gg, Gs, Gg, Rp, Gg, Gg, Gg, Gs, Gll, Gs^Fms, Gs^Fms, Gll, Kv, Rrc, Gg^Ve, Rrc, Rrc, Gg, Rrc, Gg, Rrc, Rrc, Gg^Ve, Rrc, Kv, Gll, Gs^Fms, Gg, Rb^Gvs, Rb^Gvs, Rb^Gvs, Rb^Gvs, Rb^Gvs, Re, Re, Gg, Gg, Gg, Ww, Ww, Gs, Gg, Gs, Gg
Gg, Gll, Gg, Gs, Gg, Gg, Gs, Gg, Gs, Gs, Gs, Gs, Gg, Rp, Rp, Gg, Gg, Gg, Gg, Gs^Fms, Gs^Fms, Cv, Rrc, Rrc, Rrc, Gg, Cv, Cv, Kv, Cv, Cv, Gg, Rrc, Rrc, Rrc, Cv, Gg, Gs, Gg, Rb^Gvs, Rb^Gvs, Rb^Gvs, Re, Re, Rb^Gvs, Gd^Vhr, Gg, Ww, Ww, Ww, Gg, Gs, Gs, Gg
Gg, Gg, Gg, Gg, Gs, Gg, Gg, Gg, Gs, Gg, Gg, Gg, Gg, Gg, Gg, Rp, Rp, Gg, Gg, Gs, Gg, Cv, Rrc, Gg^Ve, Gg, Rrc, Rrc, Gg^Efm, Cv, Gg^Efm, Rrc, Rrc, Gg, Gg^Ve, Rrc, Cv, Gg, Gg, Gg, Gg, Re, Re, Rb^Gvs, Rb^Gvs, Rb^Gvs, Rb^Gvs, Rb^Wm, Ww, Ww, Gg, Gs, Gs, Gg, Gg
Gs, Gs, Gg, Gg, Gs^Es, Gs, Gg, Gg, Gg, Gg, Gg, Gg, Hh^Vh, Gg, Gs, Gg, Gg, Rp, Rp, Gg, Rp, Rp, Rrc, Rrc, Rrc, Cv, Gg^Efm, Rrc, Kv, Rrc, Gg^Efm, Cv, Rrc, Rrc, Rrc, Re, Re, Gs, Re, Re, Rb^Gvs, Gg, Gg, Rb^Gvs, Rb^Gvs, Rb^Gvs, Ww, Ww, Ww, Gg, Gs, Gg, Gg, Gg
Gg, Gg^Es, Gg^Es, Gs, Gg, Gs, Gg, Gs, Gs, Gg, Hh, Hh, Hh^Fms, Gs^Fms, Gs^Fms, Gs, Gg, Gg, Gg, Rp, Gg, Rp, Rrc, Rrc, Gg, Cv, Kv, Cv, Rrc, Cv, 3 Kv, Cv, Gg, Rrc, Rrc, Re, Gg, Re, Rb^Gvs, Rb^Gvs, Rb^Gvs, Rb^Gvs, Rb^Gvs, Gg, Ww, Ww, Ww, Ww, Gg, Gg, Gs, Gg, Gs, Gg
Gg, Gg, Gg, Gs, Gg, Gg, Gs, Gs, Gs^Fms, Hh, Hh^Fms, Hh^Fms, Hh, Gs^Fms, Gs^Fms, Gs, Gs, Gg, Gs, Gg, Gll, Cv, Rrc, Gg^Ve, Rrc, Rrc, Cv, Gg^Efm, Rrc, Gg^Efm, Cv, Rrc, Rrc, Gg^Ve, Rrc, Cv, Gg, Gg, Gg, Rb^Gvs, Rb^Gvs, Rb^Gvs, Gg, Gg, Ww, Ww, Gg, Gg, Gg, Gs, Gs^Fms, Gll, Gs^Fms, Gg
Gg, Gg, Gs, Gg^Es, Gg, Gs, Gs^Fms, Gs^Fms, Gll, Hh^Fms, Hh^Fms, Hh, Hh, Gll^Em, Gs^Fms, Gs^Fms, Gs, Gg, Gs, Gs^Fms, Gll, Cv, Kv, Rrc, Gg^Ve, Gg, Rrc, Cv, Rrc, Cv, Rrc, Gg, Gg^Ve, Rrc, Kv, Cv, Gs^Fms, Gs, Gs, Gg, Gs, Gg, Gs, Gg, Ww, Ww, Gg, Gg^Es, Gg, Gll, Gs^Fms, Gs^Fms, Gll, Gs^Fms
Gg, Gs, Gs, Gg, Gg, Gs, Gs^Fms, Gll, Gll^Em, Hh, Hh^Fms, Hh^Fms, Hh, Gll, Gs^Fms, Gs, Gg, Gg, Gs, Gs^Fms, Gs^Fms, Gs^Fms, Cv, Rrc, Rrc, Rrc, Rrc, Gg, Rrc, Gg, Rrc, Rrc, Rrc, Rrc, Cv, Gs^Fms, Gs^Fms, Gg, Gg, Gs, Gg, Gs, Gs, Gg, Ww, Ww, Gg, Gg, Gs, Gs^Fms, Gll, Gll, Gll, Gg
Rp, Gg, Gg, Gs, Gg, Gs, Gs^Fms, Gll, Gs^Fms, Gs^Fms, Gs^Fms, Hh^Fms, Hh^Fms, Hh, Gll, Gg, Gg, Gg, Gg, Gs, Gs, Gs^Fms, Gs^Fms, Cv, Rp, Rrc, Cv, Gg^Ve, Kv, Gg^Ve, Cv, Rrc, Rp, Cv, Gll, Gs^Fms, Gs^Fms, Gs, Gg, Gg, Gs, Gs, Gg, Gg, Ww, Ww, Gg, Gg, Gs, Gs^Fms, Gs^Fms, Gll, Gs^Fms, Gs^Fms
Gg, Rp, Rp, Gg, Gg, Gg, Gg, Gs^Fms, Gg, Gll, Hh, Hh, Hh, Hh^Fms, Hh, Gg, Gs, Gs^Es, Gg, Gg, Gg, Gs, Gg, Gg, Rp, Rp, Gg, Cv, Rp, Cv, Gg, Rp, Rp, Gg, Gg, Gll, Gg, Gg, Gs, Gg, Gg, Gg, Ww, Ww, Ww, Ww, Gg, Gg, Gll, Gs^Fms, Gs^Fms, Gs^Fms, Gll, Gg
Gg, Gg, Gg, Rp, Rp, Rp, Rp, Gg, Rp, Gs, Gg, Gg, Gg, Hh^Vh, Gg, Gg, Gs, Gg, Gg, Gg, Rp, Gg, Rp, Rp, Rp, Gg, Gg, Rp, Rp, Rp, Gs, Gg, Rp, Gg, Gs, Gg, Gg, Gg, Gs, Gg, Ww, Ww, Ww, Ww, Gg, Gg, Gs, Gs, Gs^Fms, Gs^Fms, Gll^Em, Gs^Fms, Gll, Gg
Gg, Gs, Gs, Gs, Gs, Gg, Gg, Rp, Gg, Rp, Rp, Gg, Gg, Gg, Rp, Gg, Gg, Gg, Rp, Rp, Gg, Rp, Gs, Gs, Gll, Rp, Rp, Rp, Rp, Rp, Rp, Rp, Gs^Fms, Gg, Gs^Fms, Gll, Gs^Fms, Gs, Gg, Ww, Ww, Ww, Gg, Gg, Gg, Gg, Gs, Gs^Fms, Gs^Fms, Gll, Gs, Gs^Fms, Gs, Gg
Gg, Gs^Fms, Gll, Gg, Gg, Gs, Gs^Fms, Gll, Gs^Fms, Gg, Gg, Rp, Rp, Rp, Gg, Rp, Rp, Rp, Gg, Gg, Gg, Gg, Gs, Gs^Fms, Gs^Fms, Gs^Fms, Gs^Fms, Rp, Rp, Rp, Cv, Gll, Gs^Fms, Gs^Fms, Gll, Gll, Gs^Fms, Gs, Ww, Ww, Ww, Gs^Vh, Gg, Gg, Gg, Gg, Gg, Gll, Gll, Gs^Fms, Gs, Gg, Gg, Gg
Gg, Gs^Fms, Gs^Fms, Gll, Gs^Fms, Gs^Fms, Gll, Gs^Fms, Gs^Fms, Gll, Gs, Gg, Gg, Gg, Gg^Es, Gg, Gg, Gg, Gs, Gs, Gs, Gg, Gg, Gs^Fms, Gg^Ve, Gs^Fms, Gs^Fms, Rp, Rp, Rp, Cv, Kv, Gs^Fms, Gs^Fms, Gs^Fms, Gll, Gs^Fms, Gs^Fms, Ww, Ww, Gg, Gg, Gs, Gg, Gs, Gg, Gs, Gg, Gs, Gs^Fms, Gll, Gll, Gs^Fms, Gs^Fms
Gll, Gll, Gll^Em, Gs^Fms, Gll, Gs, Rp, Gll, Gs^Fms, Gs^Fms, Gs, Gs, Gg, Gs, Gs, Gs, Gg, Gs, Rp, Gg, Gg, Gg, Gg, Gs, Gs^Fms, Gll, Rp, Rp, Rp, Rp, Rp, Gg, Gg, Gll, Gs^Fms, Gs^Fms, Gs^Fms, Ww, Ww, Ww, Gg, Gs, Gs^Fms, Gs^Fms, Gs^Fms, Gs^Fms, Gs^Fms, Gs, Gs, Gs^Fms, Gs^Fms, Gs^Fms, Gll, Gg
Gs^Fms, Gll, Gs^Fms, Gs^Fms, Rp, Rp, Rp, Rp, Rp, Gg, Gg, Gs, Rp, Gg, Gg, Gg, Rp, Rp, Rp, Rp, Rp, Gg, Gg, Gs, Rp, Rp, Rp, Rp, Rp, Rp, Rp, Rp, Rp, Gg, Cv, Gs^Fms, Ww, Ww, Ww, Gg, Gll, Gs^Fms, Gs^Fms, Gll, Gll^Em, Gll, Gs^Fms, Gs^Fms, Gg, Gs, Gll, Gll, Gs, Gg
Gll, Gs^Fms, Rp, Rp, Rp, Rp, Rp, Rp, Rp, Rp, Rp, Rp, Rp, Rp, Rp, Rp, Rp, Rp, Rp, Rp, Rp, Rp, Rp, Rp, Rp, Rp, Rp, Rp, Gs^Fms, Rp, Rp, Rp, Rp, Rp, Ww^Bsb\, Ww, Ww, Ww, Gs^Fms, Gs^Fms, Rp, Rp, Rp, Gs, Gg, Gs^Fms, Gs^Fms, Gll, Gg^Es, Gg, Gs, Gs^Fms, Gs^Fms, Gg
Rp, Rp, Rp, Rp, Rp, Rp, Gg, Rp, Rp, Rp, Rp, Rp, Rp, Rp, Rp, Rp, Rp, Rp, Gg, Rp, Rp, Rp, Rp, Rp, Rp, Rp, Gll, Gll, Gs^Fms, Gll, Cv, Rp, Ww^Bsb\, Ww, Ww, Ww^Bsb\, Rp, Gs^Fms, Rp, Rp, Rp, Rp, Rp, Rp, Rp, Gs^Fms, Gs^Fms, Gg, Gll, Gg, Gs^Fms, Gs^Fms, Gll, Gs^Fms
Rp, Rp, Rp, Rp, Gg, Gg, Ce, Gg, Gs, Rp, Rp, Rp, Gg, Rp, Rp, Rp, Gs^Fms, Gs^Fms, Gs^Fms, Gs, Gg, Rp, Rp, Rp, Gs^Fms, Gs^Fms, Hh, Gs^Fms, Gs^Fms, Gs^Fms, Hh, Ww, Ww, Ww^Bsb\, Rp, Rp, Rp, Rp, Rp, Rp, Rp, Rp, Rp, Rp, Rp, Rp, Rp, Gs^Fms, Gg, Gs^Fms, Gs, Gll, Gs^Fms, Gs^Fms
Rp, Rp, Gs, Gg, Gs, Ce, Ke, Ce, Gg, Gs, Gg, Gg, Gs^Fms, Gs, Gs^Fms, Gs^Fms, Gs^Fms, Gll, Gg, Gs, Gg, Gg, Gs, Gs^Fms, Gs^Fms, Gll, Hh, Hh, Hh, Hh^Fms, Hh, Ww, Ww, Gll, Gs^Fms, Rp, Rp, Rp, Rp, Rp, Gg, Gs, Gg, Rp, Rp, Rp, Rp, Rp, Rp, Gs, Gg, Gll, Gs^Fms, Gg
Gg, Gs, Gs^Fms, Gs^Fms, Gs^Fms, Ce, Ce, Ce, Gg, Gg, Gg, Re^Vct, Gg, Gll, Gs^Fms, Gs^Fms, Gll, Gg, Gll, Gs, Gs, Gg, Gs, Gs^Fms, Gs^Fms, Gll, Gs^Fms, Hh^Fms, Hh^Fms, Hh^Fms, Gs^Fms, Ww, Ww, Gs^Fms, Gs^Fms, Gs^Fms, Gs^Fms, Rp, Gs, Gg, Re^Vct, Gs, Gs, Gg, Gll, Rp, Rp, Rp, Rp, Rp, Rp, Gs^Fms, Gs^Fms, Gg
Hh, Gs^Fms, Hh, Gll, Hh, Gll, Hh, Gs^Fms, Gs, Gg, Gg, Gg, Gg, Gs, Gs, Gll, Gs^Fms, Gg, Gs^Fms, Gs^Fms, Gs^Fms, Gg, Gll, Gg, Ww, Ww, Ww, Hh, Hh^Vh, Hh, Ww, Ww, Ww, Gll, Gg, Gs^Fms, Gs^Fms, Gs^Fms, Gs, Gg, Gg, Gg, Gg^Es, Gs^Fms, Gs^Fms, Gs^Fms, Gs^Fms, Rp, Rp, Rp, Rp, Rp, Rp, Gg
Hh^Fms, Hh, Hh, Hh, Hh^Fms, Hh^Fms, Hh, Hh, Gll, Gg, Re^Vct, Gg, Gg^Es, Gg, Gs, Gs^Fms, Gs^Fms, Gll, Gs^Fms, Gll^Em, Gll, Gs^Fms, Ww, Ww, Ww, Ww, Ww, Ww, Ww, Ww, Ww, Ww, Gg, Gg, Gs^Fms, Gll, Gll, Gs^Fms, Gg, Gg, Ket, Gg, Gg, Gll, Gs^Fms, Gll, Gll, Gs^Fms, Gg, Rp, Rp, Rp, Rp, Rp
Hh, Hh^Fms, Hh^Fms, Hh^Fms, Hh^Fms, Hh^Fms, Hh, Hh, Gll, Gs^Fms, Gg, Gg, Gs, Gg, Gs, Gs^Fms, Gll, Gs^Fms, Gll, Gs^Fms, Gs^Fms, Gs^Fms, Ww, Ww, Gs^Vh, Gg, Gg, Ww, Ww, Ww, Gs^Fms, Gll, Gll, Gs^Fms, Gs^Fms, Gs^Fms, Gs, Gs, Ket, Gg, Ce, Gg, Ket, Gg, Gg, Gg, Gg, Gg^Es, Gs, Gs, Gs^Fms, Rp, Rp, Rp
Hh^Fms, Hh, Hh^Fms, Hh, Hh^Fms, Hh^Fms, Gs^Fms, Gll, Gs^Fms, Gs^Fms, Gg, Gs, Gg, Gg, Ww, Gg, Gg, Gs, Gg, Gs^Fms, Gll, Gs, Ww, Ww, Gg, Gg, Gs, Gg, Gg, Gll, Gs^Fms, Gs^Fms, Gs^Fms, Gll^Em, Gs^Fms, Gs^Fms, Gg, Gg, Gg, Ce, 2 Ket, Ce, Gg, Gg, Gs, Gg, Gs^Fms, Gs^Fms, Gs^Fms, Gs^Fms, Gs, Gg, Gg, Rp
Hh, Hh^Fms, Hh, Hh^Fms, Hh, Hh, Gll, Gs^Fms, Gs, Gs^Fms, Ww, Gg, Ww, Ww, Ww, Ww, Ww, Ww, Ww, Gs^Fms, Ww, Ww, Ww, Ww, Gs, Gg, Gs, Gg, Gg, Gg, Gg, Gs, Gs, Gs^Fms, Gs, Gs, Gg, Gg, Ket, Ce, Ce, Ce, Ket, Gg, Gs, Gg, Gg, Gll, Gg, Gs, Gg, Gg, Gg, Gs
Hh, Hh, Hh^Fms, Hh^Fms, Gs^Fms, Gll, Gg, Gs, Ww, Ww, Ww, Ww, Ww, Ww, Gg, Ww, Ww, Ww, Ww, Ww, Ww, Ww, Gg, Gg, Gs, Gg, Gs, Gg, Gg^Es, Gg, Gg, Gg, Gg, Gs, Gg, Re^Vct, Gg, Gs, Gg, Gg, Ket, Gg, Gg, Gs, Gg, Re^Vct, Gs, Gs, Hh^Fms, Gg, Hh, Gll, Hh^Fms, Hh
Hh, Gll, Gs^Fms, Gs^Fms, Gll, Gs^Fms, Ww, Ww, Ww, Ww, Gg, Ww, Gs, Gs, Gs, Gg, Gg, Gg, Gg, Ww, Gg, Gg, Gs^Es, Gg, Gs, Gs, Gg, Gs, Gs, Gs, Gs, Gs, Gs, Gg, Gg, Gg, Gg, Gs, Gs, Gg, Gg, Gs, Gs, Gs, Gg, Gg, Hh, Hh, Hh^Fms, Hh, Hh, Hh, Hh^Fms, Hh^Fms
Gg, Gll, Gg, Gs, Gg, Ww, Gg, Ww, Gg, Gg, Gg, Gg, Gg, Gg, Gg, Gg, Gg, Gg, Gg, Gs, Gs, Gs, Gg, Gg, Gg, Gg, Gg, Gg, Gg, Gg, Gg, Gg, Gg, Gs, Gg, Gg, Gg, Gs, Gg, Gg, Gg, Gg, Gg, Gg, Gg, Gs, Hh, Hh, Hh, Hh^Fms, Hh, Hh, Hh, Hh
