Hhd, Hhd, Hhd, Hhd, Hhd, Hh, Hh^Fetd, Hh^Fms, Hh, Hh^Fms, Hh^Fms, Hh^Fms, Hh^Fms, Hh, Hh, Hh, Gll, Gll, Gs^Fms, Gg, Gll, Gg, Gll, Gg, Gll, Gg, Gs, Gg, Gs, Gg, Gg, Gg, Gg, Gg, Gs^Fms, Gg, Gll, Gg, Gs, Gg, Gg, Gs, Gg, Gg, Gs, Gg, Gll, Gg, Hh^Fms, Gg, Hh^Fms, Hh, Hh^Fms, Hh, Hh^Fms, Hh, Hh, Hh, Hh
Hh^Fetd, Hhd, Hhd^Fetd, Hhd^Fetd, Hhd^Fetd, Hhd, Hhd, Hhd^Fetd, Hhd, Hh^Fms, Hh^Fms, Hh^Fms, Hh, Hh^Fms, Hh, Hh, Gs^Fms, Gll, Gs^Fms, Gs^Fms, Gll^Em, Gs^Fms, Gll, Gs^Fms, Gs^Fms, Gs^Fms, Gs, Gg, Gg, Gs, Gs^Es, Gg, Gg, Gs, Gs, Gs^Fms, Gs, Gs^Fms, Gs, Gg, Gg, Gs, Gg, Gg, Gs, Gs^Fms, Gs^Fms, Hh^Fms, Gs^Fms, Hh^Fms, Gll, Hh^Fms, Hh, Hh^Fms, Hh^Fms, Hh, Hh, Hh^Fms, Hh
Hh^Fms, Hh, Hhd^Fetd, Hhd, Hhd, Hhd^Fetd, Hhd^Fetd, Hhd^Fetd, Hhd^Fetd, Hhd, Gd, Gd^Fetd, Gd, Gs^Fms, Gd, Gs^Fms, Gs^Fms, Gs^Fms, Gs^Fms, Gs^Fms, Gll, Gll, Gll, Gs^Fms, Gs^Fms, Gs, Gg, Gs, Gg, Gg, Gg, Gs, Gg, Gg, Gg, Gs, Gg, Gg, Gg, Gg, Gg, Gs, Gg, Gg, Gg, Gs, Gs, Gs^Fms, Gll, Gs^Fms, Gll, Gs^Fms, Gs^Fms, Gll, Hh, Hh^Fms, Hh^Fms, Hh^Fms, Hh
Hh, Hh^Fetd, Hh^Fetd, Hhd, Hh^Fetd, Hhd, Hhd, Hhd^Fetd, Hhd, Gd^Fetd, Gd^Fetd, Gd, Gd, Gd^Fetd, Gd^Fetd, Gll, Gs^Fms, Gs^Fms, Gll, Gs^Fms, Gll^Em, Gs^Fms, Gs^Fms, Gs^Fms, Gs, Gs, Gg, Gs, Gs, Gg, Gg, Gg, Gg, Gs, Gs, Gg, Gs, Gg, Gg, Gs, Gs, Gs, Gs, Gg, Gg, Gg, Gg, Gs, Gg^Es, Gg, Gg, Gs^Fms, Gll, Gs^Fms, Gs^Fms, Hh^Fms, Hh, Hh^Fms, Gll
Hh^Fms, Hh, Hh^Fms, Hh, Hh^Fetd, Hh^Fetd, Hh^Fetd, Hhd, Hhd, Gd, Gd, Gd^Fetd, Gd^Fetd, Gd^Fetd, Gd^Xfw, Gd^Fetd, Gd^Fetd, Gs^Fms, Gll, Gs^Fms, Gs^Fms, Gs^Fms, Gs, Gs, Gg, Gg^Es, Gg, Gg, Gs, Gs, Gs, Gg, Gs, Gg, Gs, Gs^Vh, Rb^Gvs, Gs, Gg, Gs, Gg, Gg^Em, Gs, Gs, Gg, Gs, Gs, Gg, Gs, Gg, Gg, Gs, Gs, Gll, Gs^Fms, Gs^Fms, Gs^Fms, Gll, Gs^Fms
Hh^Fms, Hh^Fms, Hh, Hh^Fms, Hh, Hh^Fetd, Hh^Fms, Hh^Fetd, Hh, Gd^Fetd, Gd^Fetd, Gd^Xfw, Ce, Gd, Gd, Gd^Fetd, Gll, Gll, Gd^Fetd, Gs^Fms, Gs, Gs, Gg, Gg, Gs, Gg, Gs, Gg^Es, Gg, Gs, Gg, Gg^Es, Gg, Gg, Gg, Rb^Gvs, Gg, Gs, Gg, Gg, Gs, Gs, Gs, Gs, Gg, Gg, Gg, Gg, Gg, Gs, Gs, Gg^Es, Gs, Gs, Gg, Gs^Fms, Gs, Gs^Fms, Gs
Hh, Hh, Gll, Gll, Gs^Fms, Hh, Gd, Hh, Gd, Gd^Xfw, Gd^Fetd, Ce, 3 Ke, Ce, Gd, Ce, Gd, Gd^Fetd, Gd^Xfw, Gs, Gg, Re^Vct, Gs, Gg, Gs, Gs, Gg, Gg, Gg, Gg, Gg, Gg, Gs, Gs, Gg, Gg, Gg, Gs, Gs^Es, Gg, Gg, Gg, Rp, Gg, Rp, Rp, Rp, Rp, Rp, Gg, Gg, Gs^Es, Gg, Gs, Gg, Gg, Gg, Gs, Gg
Hh, Hh, Hh, Gs^Fms, Gs^Fms, Gs^Fms, Gs^Fms, Gd, Gd^Fetd, Gd, Gd^Fetd, Ce, Ce, Ce, Ce, Ce, Gd, Gd, Gd^Xfw, Gd, Gg, Gg, Gs, Gg, Gs, Gg, Gs, Gs, Gs, Gs, Gg, Gs, Gs^Fms, Gs^Fms, Gll, Gs, Gs, Gg, Gg, Gs, Gg, Rp, Gg, Rp, Gs, Gg, Gs, Gg, Gg, Rp, Rp, Gg, Gg, Gs, Gg, Gg, Gs, Gg, Gg
Gs^Fms, Hh, Gs^Fms, Gs^Fms, Gll, Gll, Gs^Fms, Gd^Fetd, Gd^Fetd, Gd^Xfw, Gd, Gd, Gd^Fetd, Gd, Ce, Gd, Gd, Gd^Xfw, Gd, Gd, Gg, Gg, Gg, Gs, Gg, Gs, Gs^Fms, Gs^Fms, Hh, Gs^Fms, Hh, Gll, Hh^Fms, Hh, Hh, Gs^Fms, Gs^Fms, Gs, Gg, Gs, Gg, Rp, Gg, Gs, Hh, Hh, Hh, Gs, Gs, Gg, Gg, Rp, Rp, Gs, Gs, Gg^Es, Gg, Gs, Gg
Gs^Fms, Gll^Em, Gs^Fms, Gs^Fms, Gs^Fms, Gs^Fms, Gs, Gs, Gg, Gd, Gd^Fetd, Gd, Gd, Ce, Gd, Gd, Gg, Gd, Gg, Gg, Gg, Gs, Gs, Gg, Gg, Gs, Gll, Hh^Fms, Hh^Fms, Hh^Fms, Hh^Fms, Hh, Hh, Hh^Fms, Hh^Fms, Hh^Fms, Gs, Gg, Gs, Gg, Rp, Rp, Gg, Gs^Fms, Hh^Fms, Hh^Fms, Hh, Hh, Hh, Gs, Gg, Gg, Rp, Gg, Gg, Gg, Gg, Gg, Gg
Gll, Gs^Fms, Gll, Gll, Gs, Gs, Re^Vct, Gs, Gs^Fms, Gd, Gd, Gd, Gd^Xfw, Gd, Gd^Xfw, Gd, Gs, Gs, Re^Vct, Gs, Gg, Gg, Gs^Es, Gg, Gg, Gg, Gll, Hh, Hh^Fms, Hh, Hh^Fms, Hh, Hh, Hh, Hh^Fms, Hh, Gg, Gg, Rb^Gvs, Gg, Rp, Gg, Gs, Hh, Hh^Fms, Hh, Hh^Fms, Hh^Fms, Hh^Fms, Gs^Fms, Gs, Gg, Rp, Gg, Gg, Gs, Gg, Gs, Gs
Gs^Fms, Gs^Fms, Gs, Gs^Fms, Gs, Gg, Gg, Gs, Gs, Gg, Gg, Gd, Gd, Gd^Xfw, Gd, Gd, Gg, Gs, Gg, Gg, Gs, Gg, Gg, Gs^Es, Gg, Gg, Gs^Fms, Hh^Vh, Hh^Fms, Hh, Hh, Hh^Fms, Hh^Fms, Hh^Fms, Gs, Gg, Gg, Gs, Gs^Vh, Rp, Gg, Gg, Gs, Gs^Fms, Hh^Fms, Hh^Fms, Hh^Fms, Hh, Hh^Fms, Hh, Gs, Gg, Gg, Rp, Rp, Gg, Gg, Gg, Gg
Gs, Gs, Gg, Gs, Gg, Gg, Gg, Gg, Gg, Gg, Gg, Re^Vct, Gg, Gd, Gg, Gd, Gg, Gg, Gs, Gs^Fms, Gs^Fms, Gs, Gg, Gg^Es, Gs, Gs, Gs, Gll, Gll, Hh, Gll, Hh^Fms, Gs^Fms, Gll, Rp, Rp, Rp, Rp, Rp, Rp, Gs, Gg, Gs^Fms, Gs^Fms, Hh^Fms, Hh^Fms, Hh, Hh^Fms, Hh^Fms, Hh^Fms, Hh, Gs, Gg, Gg, Gg, Rp, Rp, Gg, Gg
Gg, Gg, Gg, Gg, Gg, Gs, Gs, Gs, Gg, Gg, Gg, Gg, Gg, Gg, Gs, Gg, Gg, Gg, Gs, Gs^Fms, Gs, Gs, Gg, Gg, Gg, Gs, Gg, Gg, Gg, Gs^Fms, Gs^Fms, Gs^Fms, Rp, Rp, Gs^Fms, Gs^Fms, Gs^Fms, Gs, Gg, Gg, Gg, Gg, Gs, Hh, Hh^Fms, Hh^Fms, Hh^Fms, Hh^Fms, Hh^Fms, Hh, Gs, Gs, Gs, Gs^Em, Gg, Gg, Gg, Rp, Rp
Gs, Gg, Gs, Gg, Gs^Em, Gg, Gs, Gg, Gs, Gg, Gg, Gg, Gs^Es, Gg, Gg, Gs, Gg, Gg, Gs, Gg, Gs, Gg, Gs, Gg, Gs, Gg, Gs, Gg, Gg, Gs, Rp, Rp, Gs^Fms, Rp, Rp, Gs^Fms, Gs^Fms, Gs, Gg, Gg, Gs, Gs, Gg, Gs, Gs, Hh, Gs^Fms, Hh, Gs^Fms, Hh, Gg, Gs, Gs, Gs, Gg, Gs, Gs, Gg, Gg
Gs, Gg, Gs, Gg, Gg, Gg, Gs, Gs^Fms, Gs^Fms, Gs, Gg, Gg, Gg, Gg, Gg, Gs^Es, Gs, Gg, Gg, Gg, Gg, Gs, Gs^Fms, Gs^Fms, Rp, Gg, Gg, Gg, Rp, Rp, Gs, Gs^Fms, Gs^Fms, Gs^Fms, Rp, Gll, Gs, Gs, Gg, Gs, Gg, Gg, Gs^Vh, Gg, Gg, Gg, Gg, Gs, Gs, Gg, Gg, Gg, Gg, Gs, Gs, Gg, Gg^Es, Gs, Gg
Gs, Gs, Gs, Gg, Gg, Gg, Gg, Gs^Fms, Gs, Gs, Gg, Gg, Gg, Gg, Gg, Gg, Gg, Gg, Gg, Gs, Gs^Fms, Gs^Fms, Rp, Rp, Gs^Fms, Rp, Rp, Rp, Gg, Gg, Rb^Gvs, Gs, Gg, Gs^Fms, Gs, Rp, Rp, Gg, Gg, Gs, Rb^Gvs, Rb^Gvs, Rb^Gvs, Rb^Gvs, Rb^Gvs, Gg, Gg, Gg, Gg, Gg, Rb^Gvs, Gg^Ve, Rb^Gvs, Gg, Gg, Gs, Gg, Gs, Gs
Gs, Gg, Gg, Gs, Gs, Gs, Gg, Gs, Gg, Gs, Gg, Gs, Gs, Gs, Gg, Gg, Gg, Gg, Gg, Gs, Rp, Rp, Gs^Fms, Gs^Fms, Gs, Gg, Gg, Gs, Gs^Vh, Rb^Gvs, Rb^Gvs, Rb^Gvs, Rb^Gvs, Gg, Gs, Gg, Rp, Gg, Gg, Rb^Gvs, Rb^Gvs, Rb^Gvs, Rb^Gvs, Rb^Gvs, Rb^Gvs, Rb^Gvs, Gg, Gg, Rb^Gvs, Rb^Gvs, Rb^Gvs, Rb^Gvs, Rb^Gvs, Rb^Gvs, Rb^Gvs, Gg, Gg, Gg, Gg
Gs, Gs, Gg^Es, Gs, Gg, Gg, Gg, Gg, Gs, Gs, Gs^Fms, Gs^Fms, Gs^Fms, Gll, Gs^Fms, Gs, Gs, Gg, Gg, Rp, Gs, Gs^Fms, Gg, Gs, Rb^Gvs, Gs^Vh, Rb^Gvs, Gg, Gg, Rb^Gvs, Rb^Gvs, Rb^Gvs, Gg, Gg, Gs, Gg, Rp, Gg, Gs, Gg, Gg, Rb^Gvs, Rb^Gvs, Rb^Gvs, Gg, Gg, Rb^Wm, Rb^Gvs, Rb^Gvs, Rb^Gvs, Rb^Gvs, Rb^Gvs, Rb^Gvs, Rb^Gvs, Rb^Gvs, Rb^Gvs, Rb^Gvs, Gg, Gg
Gg, Gg, Gg, Gg, Gs^Es, Gs, Gg, Gs, Gs^Fms, Gs^Fms, Gll^Em, Gll^Em, Gs^Fms, Gs^Fms, Gll, Gs^Fms, Gs, Gg, Gg, Rp, Gg, Gs, Gg, Rb^Gvs, Rb^Gvs, Rb^Gvs, Rb^Gvs, Rb^Gvs, Gs, Gg, Gg, Gs, Gg, Gg, Gs, Gs, Rp, Gg, Gs, Gg, Gs, Gg, Gg, Gg, Gg, Gg, Gg, Rb^Gvs, Rb^Gvs, Rb^Gvs, Rb^Gvs, Rb^Gvs, Rb^Gvs, Rb^Gvs, Rb^Gvs, Rb^Gvs, Gg, Gg, Gg
Gg, Gs, Gs, Gg^Es, Gg, Gg, Gg, Gs, Gs^Fms, Gll, Gs^Fms, Gs^Fms, Gs^Fms, Gll, Gs^Fms, Gs, Gg, Gg, Rp, Rp, Gg, Gs, Gs^Vh, Gg, Gg, Rb^Gvs, Gg, Gs, Gs^Fms, Gg, Gg, Gg, Gs, Gg, Gg, Gg, Rp, Gg, Gs, Gg, Gg, Gs, Gs, Gs, Gg, Gs, Gg, Gg, Gg, Rb^Gvs, Rb^Gvs, Rb^Gvs, Rb^Gvs, Rb^Gvs, Gg, Gs, Gg, Gg, Gs
Gg, Gg, Gg, Gs^Es, Gs, Gs, Gg, Gs, Gs^Fms, Gs^Fms, Gs^Fms, Gs^Fms, Gll, Gs^Fms, Gs, Gg, Rp, Rp, Gg, Gg, Rb^Gvs, Rb^Gvs, Rb^Gvs, Rb^Gvs, Rb^Gvs, Gg, Gll, Gs^Fms, Hh^Fms, Gs, Gs^Fms, Gs^Fms, Gs^Fms, Gs, Kv, Cv, Rrc, Kv, Gg, Gs, Gs, Gg, Gg^Ve, Gg, Gg, Gg, Gg, Gs, Gs, Gs, Gg, Rb^Gvs, Gs, Gg, Gg, Gs, Gs^Es, Gs, Gg
Gg, Gg, Rp, Gg, Gg, Gs, Rp, Gs, Gg, Gll, Gg, Gs^Fms, Gs, Gs, Gg, Rp, Gg, Gg, Gs, Gg, Gg, Rb^Gvs, Rb^Gvs, Rb^Gvs, Gs^Fms, Gll, Hh^Fms, Hh, Hh^Fms, Hh, Hh, Hh, Hh, Gs^Fms, Cv, Rrc, Rrc, Cv, Cv, Gg, Gg, Gg, Gs, Gg, Gs, Gs, Gs^Fms, Gs, Gs, Gg, Gg^Es, Gs, Gg, Gg, Gs, Gs, Gg, Gs, Gg
Rp, Rp, Gg, Rp, Rp, Rp, Gg, Rp, Rp, Gg, Gg, Gs, Rp, Gg, Rp, Rp, Gg, Gs, Gg^Es, Gg, Gg, Gg, Gg^Wm, Gs^Fms, Ww^Ewf, Hh^Fms, Hh^Fms, Hh, Hh, Hh^Fms, Hh^Fms, Hh^Fms, Hh^Fms, Gs^Fms, Cv, Gg^Ve, Gg^Ve, Rrc, Kv, Gg, Gg, Gg, Gg, Gg, Gg, Gs^Fms, Gs^Fms, Gs^Fms, Gs, Gg, Gg, Gg, Gs, Gg, Gll, Gg, Gs, Gs, Gs
Gg, Gg, Gg, Gg, Gs, Gg, Gs, Gg, Gg, Rp, Rp, Rp, Gg, Rp, Gg, Gg, Gs, Gg, Gg, Gg, Ww^Ewl, Gs, Ww, Gs^Fms, Ww, Hh^Fms, Ww, Hh^Ve, Ww, Hh, Hh^Fms, Hh, Kv, Hh^Fms, Cv, Hh^Fms, Cv, Cv, Rrc, Cv, Rp, Gg, Rp, Gg, Rp, Gll, Rp, Gg, Rp, Gg, Rp, Gg, Gg, Gs^Fms, Gs^Fms, Gs^Fms, Gs^Fms, Gs, Gg
Gg, Gg, Gg, Gg, Gg, Gs, Gg^Es, Gs, Rb^Gvs, Gs^Vh, Rp, Gg, Gs, Gg, Gs, Gs, Gg, Gg, Gg, Ww, Ww, Ww, Ww, Ww, Ww, Ww, Ww, Ww, Ww, Ww^Ewf, Hh^Ve, Hh^Fms, Cv, Cv, 2 Kv, Cv, Hh^Fms, Rrc, Gg^Ve, Rrc, Kv, Rp, Rp, Rp, Rp, Rp, Rp, Rp, Rp, Rp, Rp, Rp, Rp, Gs, Gg, Gs^Fms, Gs, Gg, Gg
Gg, Gs, Gs, Gs, Gg, Gg, Gg^Es, Gg, Rp, Rp, Gg, Gs, Gg, Gg, Gg^Es, Gg, Gs, Gs, Ww^Ewf, Ww, Ww, Ww, Ww, Ww, Ww, Ww, Ww, Ww, Ww, Ww, Hh^Fms, Hh^Fms, Kv, Cv, Cv, Cv, Cv, Rrc, Rrc, Rrc, Rp, Rp, Rp, Rp, Rp, Rp, Rp, Rp, Rp, Rp, Rp, Rp, Rp, Rp, Rp, Gs, Gg, Gg, Gg
Gg, Gg, Gg, Gg, Gg^Es, Gs, Gs, Gg, Rp, Gg, Gg, Gg, Gg, Gg, Gs, Gg, Gll, Gs^Fms, Gs^Fms, Ww, Ww, Ww, Wo, Wo, Wo, Wo, Wo, Cme, Ww^Bsb\, Hh^Fms, Rp, Rp, Hh^Fms, Hh^Fms, Cv, Hh^Fms, Gg^Ve, Cv, Kv, Cv, Gg, Gg, Gs, Gg, Gs, Gg, Gs, Gg, Gg, Gg, Gg, Rp, Rp, Rp, Rp, Rp, Rp, Gg, Gg
Gg, Gs, Gg, Gg, Gs, Gs, Gg, Gg, Ww^Bsb|, Gg, Gg, Gs, Gs, Gs, Gs^Fms, Gll, Hh^Fms, Gs^Fms, Gll, Ww, Ww, Ww, Wo, Wo, Wo, Wo, Wo, Ww, Ww^Bsb/, Kv, Hh^Fms, Hh, Hh^Fms, Hh^Fms, Cv, Gg^Ve, Rrc, Rrc, Cv, Gg, Gs, Gs, Gg, Gs, Gg, Gs, Gg, Gg, Gll, Gs, Gg, Gg, Gg, Rp, Rp, Rp, Rp, Rp, Rp
Gg, Gs^Es, Gg, Gs, Gg, Gg, Ww, Ww, Ww^Bsb|, Ww, Ww, Gs, Gs^Fms, Gs^Fms, Hh, Hh^Fms, Hh, Hh^Fms, Hh, Ww, Ww, Ww, Wo, Wo, Wo, Wo, Ww, Cme, Ww, Hh^Fms, Hh^Ve, Hh^Fms, Hh, Gll, Kv, Rrc, Rrc, Cv, Gg, Gg, Gs, Gs, Gs, Gg, Gg, Gg, Gll, Gs^Fms, Gs^Fms, Gs^Fms, Gg, Gg, Gg, Gg, Gg, Rp, Rp, Rp, Rp
Gg, Gg, Gg, Gg, Gg, Ww, Ww, Ww, Rp, Ww, Ww, Ww, Gs^Fms, Gll, Hh, Hh^Fms, Hh^Fms, Hh, Hh^Fms, Ww, Ww, Ww, Ww, Ww, Ww, Wo, Ww, Ww, Ww, Ww^Ewf, Gs^Fms, Hh^Fms, Gs^Fms, Gg, Gg, Cv, Rp, Kv, Gg, Gg, Gg^Ve, Gg, Gs, Gs, Hh, Gll, Hh, Gs^Fms, Gs^Fms, Gll, Gll, Gs, Gs, Gs, Gg^Em, Gg, Gg, Rp, Rp
Gg, Gg, Ww, Ww, Ww, Ww, Ww, Gs, Rp, Gg, Ww, Ww, Ww, Gs^Fms, Gll, Hh^Fms, Hh^Fms, Hh, Gs^Fms, Gs^Fms, Ww^Ewl, Ww, Ww, Ww, Ww, Ww, Ww, Ww, Ww, Ww, Ww, Gs^Fms, Gs^Fms, Gs, Gg, Gg, Rp, Gg, Gg, Gs, Gs, Gs, Gg, Gs^Fms, Hh^Fms, Hh, Hh, Hh^Fms, Hh, Hh^Fms, Hh, Gs^Fms, Gs, Gg, Gs, Gs, Gg, Gg, Gg
Ww, Ww, Ww, Ww, Ww, Ww, Gg, Gg, Rp, Gg, Gs, Ww, Ww, Ww, Ww, Hh^Fms, Gll, Gs^Fms, Gll, Gs^Fms, Ww, Ww, Ww^Ewl, Ww, Ww, Ww, Ww, Ww, Ww, Ww, Ww, Gll, Gs, Gs, Gg, Gg, Rp, Gg, Gs, Gg, Gg, Gg, Gs, Gs^Fms, Hh, Hh^Fms, Hh, Hh^Fms, Hh^Fms, Hh, Hh^Fms, Gs^Fms, Gll, Gg, Gg, Gs, Gg, Gs, Gs
Ww, Ww, Ss, Gg, Gs, Gg, Gs, Gg, Rp, Gg, Gg, Gg, Gg, Ww, Ww, Ww, Ww, Ww, Ww, Ww, Ww^Ewl, Ww, Gs^Fms, Gll, Gs^Fms, Gs^Fms, Gll, Ww, Gs, Ww, Gg, Gg, Gg, Gg, Gg, Gg, Rp, Gg, Gs, Gg, Gg^Es, Gg, Gs, Gs^Fms, Gll, Hh^Vh, Gs^Fms, Hh^Fms, Hh, Hh^Fms, Hh, Hh, Gs^Fms, Gg, Gg, Gg^Es, Gs, Gs, Gs
Ww, Ww, Ww, Gs, Gg, Gg, Gg, Gg, Gs, Rp, Rp, Gs, Gg, Gs, Gg, Ww, Ww, Ww, Ww, Ww, Hh, Gs^Fms, Hh^Fms, Hh, Hh, Hh, Hh^Fms, Gs^Fms, Gs^Fms, Gs, Gg, Gs, Gg, Gs, Gs, Gg, Rp, Gg, Gg, Gs, Gs, Gg^Es, Gs, Gg, Gs, Gll, Gll, Gs^Fms, Hh^Fms, Hh, Hh, Hh^Fms, Hh, Gs, Gs, Gg, Gs^Es, Gg, Gg
Gg, Ww, Ww, Ww, Ww, Gg, Gg, Gg, Gs^Vh, Gg, Rp, Gg, Gg, Gg, Gg, Gg, Gg, Gg, Gs, Gll, Hh^Fms, Hh, Hh^Fms, Hh^Fms, Hh, Hh^Fms, Hh^Fms, Hh, Gll, Gs, Gs, Gg, Gs^Es, Gg, Gg, Gs, Gg, Rp, Rp, Gg, Gg, Gs, Gs, Gs, Gg, Gg, Gs^Fms, Gs^Fms, Hh^Fms, Hh^Fms, Hh, Hh^Fms, Gs^Fms, Gs^Fms, Gg, Gg, Gg, Gs, Gg
Gg, Gs, Gg, Ww, Ww, Gg, Gg, Rb^Gvs, Rb^Gvs, Gs, Rp, Gg, Gs, Gs, Gg, Gs, Gg, Gs, Gs, Gs^Fms, Hh^Fms, Hh^Fms, Hh, Gll, Hh^Fms, Hh, Hh^Fms, Hh, Hh^Fms, Gs^Fms, Gs, Gg, Gs, Gg^Es, Gs^Em, Gg, Gs, Gg, Gg, Rp, Gg, Gg, Gs, Gs, Gs, Gg, Gs, Gs^Fms, Gll, Gs^Fms, Gs^Fms, Gll, Gs^Fms, Gs^Fms, Gs, Gs, Gs, Gg, Gg
Gs, Gg, Gs, Ww, Ww, Ww, Gg, Gg, Gg, Gs, Gg, Rp, Rp, Gg, Gg, Gg, Gg, Gg, Gs, Gs^Fms, Gs^Fms, Gs^Fms, Gs^Fms, Gs^Fms, Gll, Gll, Gs^Fms, Hh^Fms, Gs^Fms, Gll, Gg, Gs, Gg, Gg, Gg, Gg, Rb^Gvs, Rb^Gvs, Gg, Rp, Gg, Gs, Gg, Gg, Gg, Gg^Es, Gs, Gs, Gs, Gll, Gg, Gg, Gs, Gs, Gg, Gs, Gg, Gs, Gg
Gs^Fms, Gs, Gs^Fms, Gs, Ww, Ww, Ww, Gg, Gg, Gg, Gg, Gg, Gs, Rp, Rp, Gg, Gg, Gg, Gg, Gg, Gs, Gs, Rp, Gg, Gg, Gs, Gs, Gll, Rp, Gg, Gg, Gs, Gs, Gg, Gg, Gg, Gg, Gs^Vh, Gg, Rp, Gg, Gs, Gs, Gg, Gs, Gg, Gg, Gs, Gg, Gs, Gg, Gg, Gg, Gg, Gs, Gg, Gg, Gs, Gg
Hh, Gs^Fms, Hh^Fms, Gs^Fms, Gs^Fms, Ww, Ww, Ww, Ww, Gg, Gg, Gg^Es, Gs, Gg, Gs, Rp, Rp, Gg, Gg, Gg, Rp, Rp, Gg, Rp, Rp, Gg, Rp, Rp, Gg, Rp, Rp, Gg, Gg, Gg, Gg, Gg, Rp, Gg, Rp, Rp, Gg, Gg, Gs, Gs, Gs, Gg, Gs, Gs^Fms, Gs^Fms, Gs, Gg, Gg, Gs, Gs, Gg, Gg, Gg, Gs, Gg
Hh^Fms, Hh, Hh^Fms, Hh, Hh, Gll, Gs^Fms, Ww, Ww, Gg, Gg, Gg, Gg, Gg, Gs, Gg, Gg, Rp, Rp, Rp, Gg, Gg, Gs, Gs, Gg, Rp, Gg, Gs, Gs^Es, Gg, Gg, Rp, Rp, Gg, Rp, Rp, Gg, Rp, Rp, Gg, Gg, Gs, Gs, Gs, Gs, Gg, Gs, Gs^Fms, Gg, Gs, Gs, Gs, Gg, Re^Vct, Gs, Gg, Gg, Gs, Gg
Hh, Hh^Fms, Hh, Hh^Fms, Hh^Fms, Gs^Fms, Gs, Ww, Ww, Gg, Gg, Gs, Gs, Gg^Es, Gg, Gs, Gs, Gg, Rp, Gg, Gs^Vh, Gs, Gg, Gg, Gg, Gs, Gs, Gs, Gg, Gs, Gs, Gg, Gg, Rp, Gll, Gg, Gs, Gg, Gg, Rp, Rp, Gg, Gg, Gg, Gg, Gg, Gg, Gg, Gs, Gs, Gg, Gg, Gg, Gg, Gg, Gs, Gs^Es, Gs, Gg
Hh^Fms, Hh^Fms, Hh^Fms, Hh, Hh^Fms, Gll^Em, Gs^Fms, Ww, Ww, Gg, Gg, Gs, Gs, Gg, Gg, Gs^Em, Gg, Gg, Rp, Gs, Rb^Gvs, Rb^Gvs, Gg, Gs, Gs^Fms, Gs^Fms, Gll, Gs^Fms, Gs^Fms, Gs^Fms, Hh, Gs, Hh, Gs^Fms, Hh, Gs^Fms, Hh, Gs, Gs, Gg, Gg, Rp, Gg, Gg^Es, Gs, Re^Vct, Gg, Gs, Gg, Gg, Ce, Ce, Ce, Gg, Gs, Gs, Gg, Gg, Gg
Hh, Gs^Fms, Gs^Fms, Hh, Gs^Fms, Gs^Fms, Ww, Ww, Ww, Gg, Gg^Es, Gs, Gg^Es, Gs, Gg, Gg, Gg, Gg, Rp, Gs, Gs, Gg, Gg, Gs, Gs^Fms, Gll, Hh, Hh, Hh^Fms, Hh^Fms, Hh^Fms, Hh, Hh^Fms, Hh^Fms, Hh^Fms, Hh, Hh, Gs^Fms, Gs^Fms, Gg, Gg, Rp, Gg, Gg, Gs, Gg, Gg, Gg, Ce, Ce, Ke, Gs^Ecf, Ce, Gg, Gs^Fms, Gs^Fms, Gll^Em, Gg, Gs
Gs^Fms, Gll, Ww, Gll, Ww, Ww, Ww, Ww, Gg, Gg, Gs^Es, Gs, Gg, Gs^Es, Gg, Gs, Gg, Gg, Rp, Gg, Gg, Gs, Gs, Gs, Gs^Fms, Gs^Fms, Hh^Fms, Hh^Fms, Hh^Fms, Hh^Fms, Hh^Fms, Hh^Fms, Hh^Fms, Hh, Hh^Fms, Hh^Fms, Hh^Fms, Hh^Fms, Hh, Gs^Fms, Gg, Rp, Rp, Gg, Gg, Gg, Gg, Gg, Ce, Gs^Ecf, Ce, Ce, Gg, Gg, Gs, Gs^Fms, Gs^Fms, Gs^Fms, Gg
Ww, Ww, Ww, Ww, Ww, Ww, Gg, Gg, Gs, Gs, Gg, Gg, Gg, Gg, Gs, Gs, Gg, Gg, Rp, Gg, Gg, Gg, Gs, Gg, Gll, Hh, Hh^Fms, Hh^Fms, Hh, Hh, Hh, Hh^Fms, Hh^Fms, Hh^Fms, Hh, Hh^Fms, Hh^Fms, Hh^Fms, Hh^Fms, Gll^Em, Gg, Gg, Gg, Rp, Rp, Gg, Gg, Gg, Gg, Ce, Gg, Gg, Gg, Gg, Gg, Gg, Gs, 1 Gs, Gg
Ww, Ww, Gg, Ww, Gg, Gg, Gs, Gs, Gg^Es, Gg, Gg^Es, Gs, Gg, Gs, Gg^Es, Gs, Gg, Gg, Rp, Gg, Gg, Gg, Gg^Es, Gg, Gg, Gs^Fms, Gs^Fms, Hh^Fms, Gll, Gll^Em, Gs^Fms, Hh^Fms, Hh^Fms, Hh^Fms, Hh^Fms, Hh^Fms, Hh, Hh, Gs^Fms, Gs^Fms, Gs, Gg, Gg, Gg, Gg, Rp, Rp, Gg, Gg, Gg, Gs, Gg, Gg, Gs, Gs, Gg, Gs, Gs, Gg
Gg, Gg, Gs, Gg, Gs, Gg, Gs, Gs^Es, Gg, Gs, Gg, Gg, Gg, Gg, Gg, Gs^Es, Gg, Gg, Rp, Gg, Gg, Gg, Gg, Gg, Gg, Gg, Gs, Gs^Fms, Gg, Gs^Fms, Gs, Gll, Gs^Fms, Hh, Gll, Hh, Gs^Fms, Hh, Gs, Gs, Gg^Es, Gs, Gg^Es, Gs, Gg, Gs, Gs, Rp, Rp, Gg, Gg, Gs, Gg, Re^Vct, Gg, Gg, Gg, Gs, Gg
Gg, Gs, Gs, Gg^Es, Gg, Gg, Gg, Gs, Gg, Gg, Gg^Es, Gg, Gg, Gg, Gs, Gs, Gg, Gg, Rp, Gg, Gg, Gg, Gg, Gg, Gg, Gs, Gg, Gs, Gg, Gg, Gg, Gs, Gs, Gs^Fms, Gg, Gg, Gg, Gs, Gg, Gg, Gg, Gg, Gg, Gg, Gg, Gg, Gs, Gs, Gg, Rp, Rp, Gg, Gg, Gg, Gg, Gg, Gg, Gg, Gg
Gg^Es, Gg, Gg, Gg, Gg, Gg, Gg, Gg, Gg, Gs, Gg, Gg, Gs, Gg, Gg, Gg, Gg, Gg, Rp, Gg, Gg, Gg, Gg, Gg, Gg, Gg^Es, Gg^Es, Gg, Gg, Gg, Gg, Gg, Gg, Gg, Gg, Gg, Gg, Gg, Gg, Gg, Gg, Gs, Gg, Gs, Gg, Gg, Gg, Gg, Gg, Gg, Gg, Rp, Gg, Gg, Gg, Gg, Gg, Gg, Gg
