Mm, Gg, Mm, Gg, Mm, Mm, Mm, Mm, Mm, Gg^Fms, Hh^Fms, Gg, Gg, Gg, Gg, Gg, Gs, Gg, Hh, Hh, Hh, Hh, Hh, Hh, Gs, Gg, Gg, Gg, Gg, Gg, Gg, Gg, Gg, Gg, Gg, Gg, Gg, Gg, Gg, Gg, Gg, Gg, Gd, Gg, Gg, Gg, Gd, Rp, Rb, Rp, Gg, Gg, Gg, Gg, Gg, Gg, Gs, Gg, Gg, Gs, Gs, Gg, Gg, Gg, Gs^Fms, Gg, Hh^Fms, Gg, Hh^Fms, Hh^Fms, Hh^Fms, Hh, Hh, Gg
Mm, Mm, Mm, Mm, Mm, Mm, Hh^Fms, Mm, Hh^Fms, Hh^Fms, Gs^Fms, Gs^Fms, Gg, Gg, Gs, Gs, Gs^Fms, Hh^Fms, Hh, Hh^Fms, Hh^Fms, Hh, Hh, Hh^Fms, Gs^Fms, Gs, Gs, Gg, Gg, Gg, Gg, Gg, Gg, Gg, Gg, Gs, Gg, Gg, Gs, Gs, Gd, Gd, Gd^Xfw, Gd, Gd, Gd, Cer, Rp, Cer, Rp, Gd, Gg, Gd, Gs, Gd, Gg, Gg, Gs, Gs, Gg, Gg, Gs, Gs, Gs^Fms, Gs^Fms, Hh, Gll, Hh^Fms, Gs^Fms, Hh, Hh, Hh^Fms, Hh, Hh
Mm, Mm, Hh^Fms, Mm, Hh^Fms, Hh^Fms, Hh^Cov, Hh, Gs^Fms, Gs^Fms, Gs, Gg, Gs, Gg, Gs^Fms, Gs^Fms, Hh^Fms, Hh^Fms, Hh, Hh, Hh^Fms, Hh, Gs^Fms, Gll, Gll, Gs, Gg, Gg, Gg, Gg^Es, Gg, Gg, Gs, Gg, Gll, Gs^Fms, Gll, Gg, Gs^Fms, Gd^Fetd, Gd^Fetd, Gd^Xfw, Gd^Fetd, Gd^Xfw, Gd, Gd, Gd, Cer, Rb, Rp, Gd, Gd^Xfw, Gd^Xfw, Gd^Xfw, Gd^Fetd, Gd, Gll, Gs^Fms, Gs^Fms, Gg, Gg, Gg, Gg, Gs, Gs, Gs^Fms, Gs^Fms, Gs^Fms, Gll, Gll, Hh, Hh, Hh^Fms, Hh
Mm, Mm, Hh^Fms, Hh, Hh, Gll^Cov, Gs^Kov, Gll^Cov, Gs, Gs, Gg, Gg, Gg, Gs, Hh, Hh, Hh, Hh, Hh^Fms, Hh, Hh^Fms, Hh^Fms, Gs^Fms, Gs^Fms, Gg, Gs^Fms, Gs, Gg, Gg, Gg, Gs, Gs, Gs^Fms, Gg, Gs^Fms, Gs^Fms, Hh^Fms, Hh, Hh, Hh^Fms, Hh, Gd^Fetd, Mm, Hhd, Hhd, Cer, Gd, 2 Ke, Rb, Cer, Gd, Gd, Gd^Fetd, Gd^Fetd, Gd^Fetd, Gll, Hh, Gs^Fms, Hh^Fms, Gll, Gs^Fms, Gs, Gs, Gg, Gs, Gg, Gg, Gs^Fms, Hh^Fms, Hh, Hh^Fms, Hh, Hh, Hh^Fms
Mm, Mm, Mm, Hh^Fms, Hh, Gs^Cov, Gll^Cov, Gs^Cov, Gg, Gg, Gg^Es, Gg, Gs, Gg, Hh, Hh, Hh, Hh^Fms, Hh^Fms, Hh, Hh, Hh, Gs^Fms, Gll, Gg, Gs, Gg, Gg, Gs, Gs, Gll, Gs^Fms, Gll, Gll, Hh^Fms, Hh^Fms, Mm, Hh, Mm, Mm, Mm, Mm, Mm, Mm, Hhd, Cer, Cer, Cer, Cer, Cer, Gd^Fetd, Gd^Fetd, Hhd, Gd^Fetd, Hh^Fms, Hh^Fms, Mm, Hh, Mm, Hh^Fms, Hh^Fms, Gs^Fms, Gg, Gs, Gs^Es, Gg, Gg, Gll, Gs^Fms, Hh^Fms, Hh^Fms, Hh, Hh^Fms, Hh
Mm, Mm, Mm, Hh, Hh, Gs^Fms, Gs^Fms, Gs, Gg, Gg, Gg^Es, Gs, Gs, Gs^Fms, Hh^Fms, Hh^Fms, Hh, Hh^Fms, Hh^Fms, Hh, Hh, Gll, Gs^Fms, Gs^Fms, Gs, Gg, Gg, Gg, Gs, Gs^Fms, Gll, Hh^Fms, Hh, Hh, Hh, Mm, Mm, Mm, Mm, Mm, Mm, Mm, Mm, Gd^Fetd, Gd^Fetd, Rp, Rp, Rb, Rp, Rp, Hhd, Hhd, Mm, Mm, Mm, Mm, Mm, Mm, Mm, Mm, Mm, Hh, Gs, Gg, Gg, Gs, Gs, Gg, Gll, Gs^Fms, Hh, Hh^Fms, Hh^Fms, Hh
Mm, Mm, Hh^Fms, Hh, Gll, Gll, Gg, Gg, Gg, Gg, Gg^Es, Gg, Gg, Gs^Fms, Hh^Fms, Hh, Gs, Hh, Hh, Hh^Fms, Gs^Fms, Gg, Gs, Gs, Gg, Gg, Gg, Gg, Gs, Gs^Fms, Hh^Fms, Hh^Fms, Mm, Mm, Mm, Mm, Mm, Mm, Mm, Mm, Mm, Mm, Hh, Gd^Fetd, Gd^Xfw, Rb, Rb, Rp, Gd^Xfw, Gd, Gd^Fetd, Mm, Mm, Mm, Mm, Mm, Mm, Mm, Mm, Mm, Hh, Hh, Gll, Gg^Em, Gs, Gg, Gg, Gg, Gg, Hh, Hh^Fms, Hh^Fms, Hh, Hh
Hh^Fms, Hh^Fms, Hh, Hh, Gs^Fms, Gs^Fms, Gs, Gs, Gg, Gg, Gg, Gg^Es, Gg, Gg, Gg, Gs, Gg, Gg, Gs, Gg, Gs, Gg, Gg, Gg, Gg, Gg, Gg^Es, Gg, Gg, Gs, Hh, Mm, Mm, Mm, Mm, Mm, Mm, Mm, Hh^Fms, Hh^Fms, Hh^Fms, Hh, Gd^Fetd, Gd^Fetd, Gd, Rp, Rp, Rp, Gd^Fetd, Gd^Fetd, Mm, Mm, Mm, Mm, Mm, Mm, Hh^Fms, Mm, Hh, Mm, Hh^Fms, Gll, Gs^Fms, Gll, Hh^Fms, Hh^Fms, Hh^Fms, Hh, Gg, Gs^Fms, Gs, Hh, Gs, Gg
Gs^Fms, Hh^Fms, Gll, Gs^Fms, Gs, Gg, Gg, Gg, Gg, Gg, Gg, Gg, Gg, Gg, Gg, Gg, Gg, Gs, Gg, Gs, Gg, Gg, Gg, Gg, Gg, Gg^Es, Gg, Gg, Gg, Gg, Gs^Fms, Hh^Fms, Hh^Fms, Mm, Mm, Mm, Hh, Hh^Fms, Hh, Hh, Gs^Fms, Gll, Gd, Gd, Rp, Rp, Rp, Rp, Gs^Fms, Hh, Hh, Mm, Hh^Fms, Mm, Hh, Hh^Fms, Gs^Fms, Hh, Hh^Fms, Hh^Fms, Gs^Fms, Gs^Fms, Gll, Hh^Fms, Hh, Hh, Hh^Fms, Hh, Gg, Gg, Gg, Gs, Gg, Gg
Gg, Gs^Fms, Gg, Gs, Gg, Gs, Gg, Gg, Gg, Gg, Gg, Gg, Gg, Gg, Gg, Gg, Gg, Gg, Gg, Gg, Gg, Gg, Gg, Gg, Gg, Gg, Gg, Gg, Gg, Gg, Gg, Gs^Fms, Hh, Mm, Mm, Mm, Hh, Hh, Hh, Gs^Fms, Gs, Gg, Rp, Rp, Rp, Rp, Rp, Rp, Gll, Gs^Fms, Gll, Hh^Fms, Gs^Fms, Hh, Gll, Gll, Gs^Fms, Gll, Gg, Gs^Fms, Gs, Gg, Gg, Gs, Gs, Gs^Fms, Gll, Gs^Fms, Gg, Gg, Gs, Gg, Gs, Gg
Gs, Gs, Gg, Gg, Gg, Gs, Gs, Gs, Gg, Gs, Gg, Gs, Gg, Gg, Gs, Gs, Gs, Gs^Fms, Gs, Gs, Gg, Gg, Gs, Gs, Gs^Fms, Gs, Gs, Gg, Gg, Gg, Hh, Hh, Hh^Fp, Mm, Mm, Mm, Mm, Hh^Fp, Hh, Hh^Fms, Rp, Rp, Rp, Rp, Rp, Rp, Gs, Gg, Gs^Fms, Gs^Fms, Gs, Gs^Fms, Gg, Gs^Fms, Gg, Gg, Gs, Gs, Gg, Gs, Gg, Gg, Gg, Gg, Gg, Gg, Gg, Gg, Gs, Gg, Gg, Gg, Gg, Gg
Gg, Gg, Gg, Gg, Gg, Gg, Gg, Gs, Gs, Gs, Gs, Gs, Gs, Gs, Gs, Gs, Gg, Gs, Gg, Gg, Gg, Gg, Gs, Gs^Fms, Gs^Fms, Gs^Fms, Gs^Fms, Gs, Gs, Gg, Gg, Hh, Hh^Fp, Mm, Mm, Mm, Mm, Hh^Fp, Rp, Rp, Rp, Rp, Rp, Rp, Gs^Fms, Gs, Gs^Fms, Gs, Gg, Gs, Gg, Gg, Gs, Gs, Gg, Gg, Gg^Es, Gg, Gs, Gg, Gs, Gs, Gg, Gs, Gg^Es, Gg, Gg, Gg, Gs, Gg, Gs, Gs, Gg, Gg
Gg, Gg, Gg, Gg, Gs, Gg, Gs, Gs, Gs, Gs, Gs^Fms, Gs, Gs^Fms, Gs, Gs^Fms, Gs, Gs, Gg, Gg, Gg^Es, Gg, Gg, Gs, Gs^Fms, Gg, Gs^Fms, Gg, Gs^Fms, Gs, Gg, Gg, Gg, Hh^Fp, Mm, Mm, Mm, Mm, Hh^Fp, Rp, Rp, Rp, Rp, Hh, Gs^Fms, Gs^Fms, Gs^Fms, Gs^Fms, Gll, Gs, Gg, Gg, Gg, Gs, Gg, Gg, Gg, Gs, Gs, Gg, Gg, Gg, Gg, Gs, Gg, Gg, Gs, Gg, Gg, Gg, Gg, Gg, Gg, Gg, Gg
Gg, Gg, Gs, Gs, Gs^Fms, Gs, Gs, Gs, Gs, Gs^Fms, Gs^Fms, Gs^Fms, Gg, Gs^Fms, Gs^Fms, Gs^Fms, Gs^Fms, Gs, Gs, Gg, Gg, Gg, Gs, Gs^Fms, Gs^Fms, Gs^Fms, Gs^Fms, Gs^Fms, Gs, Gg, Gg, Hh, Hh, Hh^Fp, Hh^Fp, Mm, Hh^Fp, Hh^Fp, Rp, Rp, Rp, Hh, Hh^Fp, Hh, Hh, Gs^Fms, Gs^Fms, Gs^Fms, Gs, Gg, Gg, Gg, Gg, Gs, Gg, Gg, Gs^Es, Gg, Gg, Gg, Gg, Gs, Gs^Fms, Gg, Gs^Fms, Gg, Gs^Fms, Gs, Gs, Gg, Gg, Gg, Gs, Gg
Gg, Gg, Gs, Gs^Fms, Gs^Fms, Gs, Gs^Fms, Gs^Fms, Gs^Fms, Gs^Fms, Gg, Gs^Fms, Gs^Fms, Gs^Fms, Gs^Fms, Gg, Gs^Fms, Gg, Gs^Fms, Gs, Gs, Gg, Gs, Gs^Fms, Gs^Fms, Gs^Fms, Gs^Fms, Gs^Fms, Gs, Gg, Gg, Hh, Hh, Hh^Fp, Hh, Hh^Fp, Hh, Hh, Rp, Rp, Rp, Hh, Hh^Fp, Hh^Fp, Hh, Hh, Gs^Fms, Gs^Fms, Gs, Gg, Gg, Gs, Gg, Gg, Gg, Gg, Gg^Es, Gg, Gg, Gs, Gg, Gg, Gll, Gll, Gll, Gs^Fms, Gs^Fms, Gs^Fms, Gs^Fms, Gs, Gs, Gg, Gs, Gg
Gg, Gg, Gs, Gs^Fms, Gs^Fms, Gs^Fms, Gg, Gs^Fms, Gs^Fms, Gs^Fms, Gs^Fms, Gs^Fms, Gs^Fms, Gs^Fms, Gs^Fms, Gs^Fms, Gs^Fms, Gs^Fms, Gs^Fms, Gs, Gs, Gg, Gg, Gs, Gs, Gs^Fms, Gs, Gs, Gg, Gg, Gg, Hh, Hh^Fms, Hh^Fms, Hh, Hh, Rp, Rp, Rp, Rp, Rp, Hh, Hh, Hh^Fp, Hh, Hh, Gs^Fms, Gs^Fms, Gs, Gg, Gg, Gg, Gg, Gg^Es, Gs, Gg, Gg, Gs, Gg, Gg, Gs, Gs^Fms, Gs^Fms, Gs^Fms, Gs^Fms, Gs^Fms, Gll^Em, Gll, Gll, Gs^Fms, Gg, Gg, Gg, Gg
Gg, Gs, Gs^Fms, Gs^Fms, Gg, Gs^Fms, Gg, Gs^Fms, Gs^Fms, Gs^Fms, Ds, Ds, Ww, Ds, Ds, Gs^Fms, Gs^Fms, Gg, Gg, Gs^Fms, Gs^Fms, Gs, Gs, Gg, Gg, Gs, Gs, Gs, Gg, Gg, Gg, Hh, Hh, Hh, Rp, Rp, Rp, Rp, Rp, Rp, Hh^Fms, Hh, Hh, Hh, Gs^Fms, Gs^Fms, Gs^Fms, Gs^Fms, Gs, Gg, Gs, Gg, Gg, Gs^Fms, Gs^Fms, Gg, Gs, Gg, Gg, Gs, Gg, Gs^Fms, Gs^Fms, Gs^Fms, Gll^Em, Gs^Fms, Gs^Fms, Gs^Fms, Gs^Fms, Gg, Gs, Gg, Gs, Gg
Gs, Gs, Gs^Fms, Gs^Fms, Gs^Fms, Gs^Fms, Gs^Fms, Gs^Fms, Ds, Gs^Fms, Ww, Ww, Wo, Ww, Ww, Ds, Gs^Fms, Gs^Fms, Gs^Fms, Gs^Fms, Gs^Fms, Gs^Fms, Gs, Gg, Gg, Gg, Gg, Gg, Gg^Es, Gg, Gg, Gg, Rp, Rp, Rp, Rp, Rp, Rp, Hh, Hh, Hh^Fp, Hh, Hh, Gs^Fms, Gs^Fms, Gs^Fms, Gs^Fms, Gs, Gg, Gs, Gg, Gg, Gg, Gs^Fms, Gll, Gs^Fms, Gs, Gg, Gg, Gs, Gs^Fms, Gll, Gs^Fms, Gs^Fms, Gs^Fms, Gs^Fms, Gll, Gll, Gs, Gs, Gg, Gg, Gg, Gg
Gs, Gs^Fms, Gs^Fms, Gs^Fms, Gs^Fms, Gs^Fms, Ds, Ds, Ww, Ww, Wo, Wo, Wo, Wo, Wo, Ww, Ww, Gs^Fms, Gs^Fms, Gs^Fms, Gg, Gs^Fms, Gs, Gg, Gg, Gg, Gg, Gs, Gg, Gg^Es, Gs, Gg, Rp, Rp, Rp, Rp, Hh, Hh, Hh^Fp, Hh^Fp, Hh^Fp, Hh, Hh, Gs^Fms, Gs^Fms, Gs^Fms, Gs, Gs, Gg, Gg, Gs, Gs, Gg, Gg, Gg, Gs, Gg, Gg, Gg, Gs, Gs, Gs^Fms, Gs^Fms, Gll, Gll, Gs^Fms, Gg, Gs^Fms, Gs, Gs, Gg, Gs, Gg, Gg
Ww, Gs^Fms, Gs^Fms, Gs^Fms, Ds, Gs^Fms, Ww, Ww, Wo, Wo, Ww, Wo, Wo, Wo, Wo, Ww, Ww, Ds, Gs^Fms, Gs^Fms, Gs^Fms, Gs^Fms, Gs, Gs, Gg, Gg, Gll, Gs^Fms, Gll, Gs^Fms, Gs^Fms, Gs, Rp, Rp, Rp, Gs^Fms, Hh, Hh, Hh, Hh^Fp, Hh, Hh, Hh, Gs^Fms, Gs^Fms, Gs, Gg, Gg, Gg, Gg, Gg, Gg, Gg, Gg, Gg, Gs, Gg, Gg, Gg, Gs, Gs, Gs, Gg, Gs^Fms, Gs^Fms, Gg, Gs, Gs, Gg, Gg, Gg, Gg, Gg, Gg
Ww, Ww, Ww, Ds, Ww, Ww, Wo, Wo, Ww, Ww, Ww, Ww, Ww, Wo, Wo, Wo, Ww, Ds, Gs^Fms, Gs^Fms, Gs^Fms, Gs^Fms, Gs, Gg, Gg^Es, Gs, Gs^Fms, Gs^Fms, Gll, Gs^Fms, Gs^Fms, Gll, Rp, Rp, Rp, Gll, Gs^Fms, Hh, Hh^Fms, Hh^Fms, Hh, Hh, Gs^Fms, Gs^Fms, Gs^Fms, Gs, Gg, Gg, Gg, Gs, Gg, Gg^Es, Gs, Gg, Gs, Gs, Gg, Gg^Em, Gs, Gg, Gg, Gs, Gs, Gs, Gs, Gs, Gg, Gg, Gg, Gg, Gg, Gg, Gg, Gg
Gs, Ww, Ww, Ww, Wo, Wo, Ww, Ww, Gs^Fms, Ds, Gs^Fms, Ww, Ww, Ww, Wo, Wo, Ww, Gs^Fms, Gs^Fms, Gs^Fms, Gs, Gs, Gs, Gg, Gg, Gs, Gs, Gs^Fms, Gs^Fms, Gs^Fms, Gll, Gs^Fms, Rp, Rp, Rp, Gs, Gll, Gs^Fms, Gs^Fms, Hh, Gs^Fms, Gs^Fms, Gs^Fms, Gs^Fms, Gs^Fms, Gs, Gg, Gg, Gg, Gs, Gg, Gg, Gs, Gg, Gg, Gg, Gs, Gs, Gs, Gg, Gg, Gg, Gs, Gs, Gs, Gg, Gs, Gs, Gs, Gs, Gg, Gg^Es, Gg, Gg
Gs^Fms, Gs, Ds, Ww, Wo, Wo, Ww, Ww, Gs^Fms, Gs^Fms, Gs^Fms, Gs, Ww, Wo, Wo, Wo, Ww, Gs^Fms, Gs^Fms, Gs^Fms, Gs, Gs, Gg, Gg, Gg, Gg, Gg, Gs, Gg, Gs^Fms, Gg, Gs, Rp, Rp, Rp, Gs^Fms, Gs^Fms, Gs^Fms, Gs^Fms, Gs^Fms, Gs^Fms, Gs^Fms, Gs^Fms, Gs, Gs, Gs, Gg, Gg, Gg, Gg, Gs, Gg, Gs, Gs, Gs, Gs, Gs^Fms, Gs^Fms, Gs^Fms, Gs, Gs, Gg, Gs, Gg, Gg, Gg, Gg, Gg, Gg, Gg^Es, Gg, Gg, Gs, Gs
Gs^Fms, Ds, Ww, Ww, Wo, Wo, Ww, Ww, Gs^Fms, Gs^Fms, Gs^Fms, Gs, Ww^Bw\, Wo, Wo, Ww, Ds, Gs^Fms, Gs^Fms, Gs, Gg, Gg, Gs, Gg, Gg, Gg, Gg, Gg, Cv, Gg, Gg, Gg, Rp, Rp, Rp, Gs^Fms, Gs^Fms, Gs^Fms, Cv, Gs^Fms, Gs^Fms, Gs^Fms, Cv, Gs, Gg, Gg, Gs, Gg, Gg, Gg, Gg, Gs, Gs^Fms, Gs^Fms, Gs^Fms, Gs^Fms, Gll, Gs^Fms, Gs^Fms, Gs^Fms, Gs, Gg, Gg, Gg, Gg^Es, Gg, Gs, Gs, Gg, Gs, Gg, Gg, Gg, Gg
Gs^Fms, Ds, Ww, Ww, Wo, Wo, Wo, Ww, Ww, Gs^Fms, Ww, Ww, Ww, Wo^Bw\, Ww^Bw\, Ww, Ds, Gs, Gs, Gs, Gg, Gg, Gg, Gg, Gs^Fms, Gs^Fms, Cv, Cv, Rr, Cv, Cv, Cv, Rp, Rp, Rp, Cv, Cv, Cv, Rr, Cv, Cv, Cv, Rr, Cv, Cv, Gg, Gg, Gg, Gg, Gs, Gg, Gs, Gs^Fms, Gs^Fms, Gll, Gs^Fms, Gs^Fms, Gll, Gll, Gs^Fms, Gs, Gg, Gg, Gs, Gg, Gs, Gg, Gs, Gg, Gs, Gs, Gg, Gg, Gg
Gs^Fms, Gs^Fms, Gs^Fms, Ww, Ww, Wo, Wo, Ww, Ww, Ww, Wo, Wo, Wo, Wo, Ww, Ww^Bw\, Ww^Bw\, Gg, Gg, Gs, Gs, Gg, Gg, Gg, Gs^Fms, Cv, Rr, Rr, Rr^Vhc, Rr, Cv, Rr, Rr, Rr, Rr, Rr, Cv, Rr, Rr, Rr, Rr, Rr, Rr^Vhc, Rr, Rr, Cv, Gg, Gs, Gs, Gs, Gg, Gs, Gs^Fms, Gs^Fms, Gs^Fms, Gs^Fms, Gs^Fms, Gs^Fms, Gs^Fms, Gs^Fms, Gs, Gg, Gg, Gg, Gg, Gg, Gg, Gs, Gs, Gg, Gs, Gs, Gg, Gg
Gs^Fms, Gs^Fms, Gs^Fms, Ww, Ww, Ww, Ww, Wo, Wo, Wo, Wo, Wo, Wo, Wo, Ww, Ww, Ds, Gs, Gg, Gg, Gg, Gg, Gs, Gg, Gg, Cv, Rr, Rr, Rr, Rr, Rr, Rr, Rr^Vhc, Rr, Rr, Rr, Rr, Rr, Rr, Rr, Rr, Rr, Rr, Rr, Rr, Cv, Gg, Gg, Gg, Gs, Gg, Gs, Gs^Fms, Gs^Fms, Gll^Em, Gs^Fms, Gs^Fms, Gll, Gs^Fms, Gs^Fms, Gs, Gg, Gg, Gg, Gg, Gg, Gg, Gg, Gs, Gg, Gs, Gg, Gg, Gg
Gs^Fms, Gs^Fms, Gs^Fms, Ds, Ds, Ww, Ww, Wo, Wo, Wo, Wo, Wo, Wo, Ww, Ww, Ww, Ds, Gs, Gg, Gs, Gg, Gs, Gg, Gg, Cv, Cv, Rr, Rr, Rr, Rr, Rr, Rr, Rr, Rr, Rr, Rr, Rr, Rr^Vhc, Rr, Rr, Rr, Rr, Rr, Rr, Rr, Cv, Gg, Gg, Gg, Gg, Gg, Gs, Gs^Fms, Gs^Fms, Gs^Fms, Gs^Fms, Gs^Fms, Gs^Fms, Gs, Gs, Gs, Gs, Gg, Gs, Gg, Gg, Gg, Gg, Gg, Gg^Es, Gg, Gg^Es, Gs, Gg
Gs^Fms, Gs^Fms, Gs^Fms, Gs^Fms, Gs^Fms, Ds, Ds, Ww, Ww, Wo, Wo, Wo, Ww, Ww, Ds, Ww, Ds, Gs, Gg, Gg, Gs, Gg, Gg, Gg, Cv, Rr, Rr, Rr^Vhc, Rr, Rr, Rr, Rr, Rr, Rr, Rr, Rr, Rr, Rr, Rr, Rr, Rr, Rr, Rr, Rr^Vhc, Rr, Cv, Cv, Gg, Gg, Gg, Gg, Gs, Gs, Gs^Fms, Gs, Gs^Fms, Gg, Gs^Fms, Gs, Gg, Gs, Gg, Gg, Gg, Gg, Gs, Gs, Gg, Gg, Gg, Gg, Gg, Gg, Gs
Gs^Fms, Gs^Fms, Gs^Fms, Gs^Fms, Gs^Fms, Gs^Fms, Ds, Ww, Ww, Wo, Wo, Ww, Wo, Ww, Ww, Ds, Ds, Gs, Gg, Gg, Gs, Gs, Gg, Gg, Cv, Rr, Rr, Rr, Rr, Rr, Rr, Rr, Rr, Rr, Rr, Rr, Rr, Rr, Rr, Rr, Rr, Rr, Rr, Rr, Rr, Rr, Cv, Gg, Gg, Gg, Gg^Em, Gg, Gg, Gs, Gg, Gs, Gs, Gs, Gs, Gs, Gg, Gs, Gg, Gg, Gg, Gg, Gg, Gg, Gg, Gs, Gg, Gg, Gs, Gg
Gs^Fms, Gs^Fms, Gs^Fms, Gs^Fms, Gs^Fms, Gs^Fms, Ds, Ww, Wo, Wo, Wo, Wo, Wo, Wo, Ww, Ds, Ds, Gs, Gg, Gs, Gg, Gg, Rp, Rp, Rp, Rr, Rr, Rr, Cv, Cv, Cv, Kv, Rrc, Rr, Rrc, Kv, Cv, Cv, Cv, Cv, Cv, Rr, Rr, Rr, Rr, Rr, Cv, Gg, Gg, Gs, Gg, Gs, Gs, Gg, Gs, Gg, Gs, Gs, Gg, Gg, Gs, Gg, Gg, Gs, Gs, Gg, Gg, Gs, Gg, Gg, Gg, Gg, Gs, Gg
Gs^Fms, Gs^Fms, Gs^Fms, Gs^Fms, Gs^Fms, Ds, Ww, Wo, Wo, Wo, Wo, Wo, Wo, Ww, Wo, Ww, Ww, Ds, Gs, Gg, Rp, Rp, Rp, Rp, Rp, Rr, Rr, Kv, Cv, Cv, Rrc, Rrc, Rrc, Rrc, Rrc, Rrc, Rrc, Rrc, Rrc, Cv, Cv, Kv, Rr, Rr, Rr, Rr, Cv, Gg, Gg, Gs, Gs, Gg, Gg, Gs, Gg, Gs, Gg^Es, Gg, Gg, Gg, Gg, Gs, Gg, Gg, Gs, Gg^Es, Gg, Gg, Gg, Gg^Es, Gs, Gg, Gg, Gg^Es
Gs^Fms, Gs^Fms, Gs^Fms, Gs^Fms, Gs^Fms, Ww, Ww, Wo, Ww, Wo, Ww, Wo, Wo, Wo, Wo, Wo, Wo, Ww, Gs^Fms, Gs^Fms, Rp, Rp, Rp, Rp, Cv, Rr, Rr, Cv, Cv, Cv, Rrc, Rrc, Rr^Vhc, Rrc, Rrc, Rr^Vhc, Rrc, Rrc, Rrc, Cv, Cv, Cv, Rr, Rr^Vhc, Rr, Rr, Cv, Gg, Gs, Gg, Gs^Es, Gg, Gg, Gg, Gs, Gg^Es, Gg, Gs, Gg, Gs, Gs, Gs, Gg, Gs, Gs, Gg, Gg, Gg, Gg, Gg, Gg, Gg, Gg, Gs
Gs, Gs, Gs, Gs^Fms, Gs, Ww, Ww, Ww, Ww, Ww, Ww, Ww, Ww, Ww, Ww, Ww, Ww, Ww, Gll, Gs^Fms, Rp, Rp, Rp, Cv, Rr, Rr, Rr, Kv, Cv, Cv, Rrc, Rrc, Rrc, Rrc, Cv, Rrc, Rrc, Rrc, Rrc, Cv, Cv, Kv, Rr, Rr, Rr, Cv, Gg, Gg, Gg, Gg, Gg, Gs, Gg, Gg, Gg, Gg, Gg, Gg, Gg, Gg, Gg, Gg, Gg, Gg, Gg, Gg, Gs, Gs, Gs, Gg, Gg, Gs, Gg, Gs
Rp, Rp, Rp, Rp, Rp, Rp, Rp, Rp, Rp, Rp, Rp, Rp, Rp, Rp, Rp, Rp, Rp, Rp, Rp, Rp, Rp, Rp, Rp, Cv, Rr, Rr, Rr, Rr, Rrc, Rrc, Rrc, Rrc, Rrc, Cv, 3 Kv, Cv, Rrc, Rrc, Rrc, Rrc, Rr, Rr, Rr, Rr, Rr, Cv, Rp, Rp, Rp, Rp, Rp, Rp, Rp, Rp, Rp, Rp, Rp, Rp, Rp, Rp, Rp, Rp, Rp, Gg, Gg, Gg, Gg, Gg, Gg, Gg, Gg, Gg, Gg, Gg
Rp, Rp, Rp, Rp, Rp, Rp, Rp, Rp, Rp, Rp, Rp, Rp, Rp, Rp, Rp, Rp, Rp, Rp, Rp, Rp, Rp, Rp, Rp, Kv, Rr, Rr, Rr, Rr, Rrc, Rrc, Rrc, Rrc, Rrc, Cv, Kv, Cv, Rrc, Rr^Vhc, Rrc, Rrc, Rr, Rr, Rr, Rr, Rr, Rp, Rp, Rp, Rp, Rp, Rp, Rp, Rp, Rp, Rp, Rp, Rp, Rp, Rp, Rp, Rp, Rp, Rp, Rp, Rp, Gg, Gg, Gg, Gg, Gs, Gg, Gg, Gs, Gg
Gg, Rp, Gg, Rp, Gg, Rp, Gg, Rp, Gg, Rp, Gg, Rp, Gg, Rp, Gg, Rp, Gg, Rp, Gg, Rp, Rp, Rp, Rp, Cv, Rr, Rr, Rr, Rr, Cv, Rrc, Rrc, Rrc, Rrc, Cv, Cv, Cv, Rrc, Rrc, Rrc, Rrc, Cv, Rr, Rr, Rr, Rr, Cv, Gg, Rp, Gg, Rp, Gg, Rp, Gg, Rp, Gg, Rp, Gg, Rp, Gg, Rp, Gg, Rp, Rp, Rp, Rp, Rp, Rp, Gg, Gg, Gg, Gg, Gg, Gg, Gg
Gg, Gg, Gg, Gg, Gg, Gg, Gg, Gg, Gg, Gg, Gg, Gg, Gg, Gg, Gg, Gg, Gg, Gg, Gg, Gg, Rp, Rp, Rp, Cv, Cv, Rr, Rr, Kv, Cv, Cv, Rrc, Rrc, Rr^Vhc, Rrc, Rrc, Rrc, Rr^Vhc, Rrc, Rrc, Cv, Cv, Kv, Rr, Rr^Vhc, Rr, Cv, Cv, Gg, Gs, Gg, Gs, Gg, Gg, Gg, Gs, Gg, Gg, Gg, Gs, Gg, Gg, Gg, Gg, Rp, Rp, Rp, Rp, Rp, Rp, Gg, Rp, Gg, Rp, Gg
Gg, Gg, Gg, Gg, Gg, Gg, Gg, Gg, Gg, Gg, Gg^Es, Gg, Gg, Gg, Gg, Gg, Gg, Gg, Gs, Gs^Fms, Rp, Rp, Rp, Rp, Rp, Rr, Rr, Cv, Cv, Cv, Rrc, Rrc, Rrc, Rrc, Rrc, Rrc, Rrc, Rrc, Rrc, Cv, Cv, Cv, Rr, Rr, Rr, Rr, Cv, Gg, Gg, Gg, Gg, Gs, Gg, Gg, Gs, Gs, Gs, Gg, Gg, Gs, Gg, Gg, Gg, Gg, Gg, Rp, Rp, Rp, Rp, Rp, Rp, Rp, Rp, Rp
Gs, Gg, Gg, Gg, Gg, Gg, Gg, Gg, Gg^Es, Gs, Gs, Gg, Gs, Gg, Gg, Gs, Gs, Gg, Gs, Gs^Fms, Gs^Fms, Rp, Rp, Rp, Rp, Rr, Rr, Cv, Cv, Cv, Rrc, Rrc, Rrc, Rrc, Rrc, Rrc, Rrc, Rrc, Rrc, Cv, Cv, Cv, Rr, Rr, Rr^Vhc, Rr, Cv, Gg, Gg, Gg, Gg, Gg, Gs, Gs, Gs, Gg, Gg, Gs, Gg, Gg, Gg, Gg, Rb^Gvs, Gg, Gg, Gg, Gg, Rp, Rp, Rp, Rp, Rp, Rp, Rp
Gs^Fms, Gs, Gs, Gg, Gg, Gg, Gg, Gg^Es, Gg, Gg, Gs, Gg, Gs, Gs, Gg, Gs, Gg, Gs, Gg, Gs, Gg, Gg, Gg, Rp, Rp, Rr, Rr, 4 Kv, Cv, Rrc, Cv, Rrc, Kv, Rrc, Rr, Rrc, Kv, Rrc, Cv, Rrc, Cv, Kv, Rr, Rr, Rr, Rr, Cv, Gg, Gg, Gg, Gs, Gg, Gg, Gg, Gg, Gg, Gg, Gs, Gg, Gg, Rb^Gvs, Rb^Gvs, Rb^Gvs, Rb^Gvs, Rb^Gvs, Gg, Gg, Gg, Gs, Gg, Gg, Gs, Gg, Gg
Gs^Fms, Gs^Fms, Gs^Fms, Gs, Gs, Gg, Gg, Gg, Gg, Gs, Gg, Gg, Gg, Gg, Gg, Gg, Gg, Gs, Gg, Gg, Gg, Gg, Gg, Gg, Cv, Rr, Rr, Rr, Rr, Cv, Rr, Cv, Rr, Rr, Rr, Rr, Rr, Cv, Rr, Cv, Rr, Rr, Rr, Rr, Rr, Cv, Gg, Gg, Gg, Gs, Gg, Gg, Gg, Gg, Gg, Gg, Gg, Gg, Rb^Gvs, Rb^Gvs, Rb^Gvs, Rb^Gvs, Rb^Gvs, Rb^Gvs, Rb^Gvs, Rb^Gvs, Rb^Gvs, Gg, Gg, Gg, Gs, Gs, Gg, Gg
Gs^Fms, Gg, Gg, Gs^Fms, Gg, Gg, Gg, Gg, Gg, Gg, Gg, Gg, Gg, Gg, Gg, Gg, Gg, Gg, Gg, Gg, Gg, Gg, Gg, Gg, Cv, Rr, Rr, Rr, Rr, Rr, Rr, Rr, Rr, Rr, Rr, Rr, Rr, Rr, Rr, Rr, Rr, Rr, Rr, Rr, Rr, Cv, Gg, Gg, Gg, Gg, Gg, Gg, Gg, Gs, Gg, Gg, Gg, Rb^Gvs, Rb^Gvs, Rb^Gvs, Rb^Gvs, Rb^Gvs, Rb^Gvs, Rb^Gvs, Rb^Gvs, Rb^Gvs, Rb^Gvs, Rb^Gvs, Gg, Gg, Gg, Gg, Gg, Gg
Gg, Gg, Gs^Fms, Gs^Fms, Gs, Gs, Gg, Gg, Gs, Gg, Gs, Gg, Gg, Gg, Gs, Gs, Gs, Gg, Gg, Gg, Gg, Gg, Gs, Gs, Cv, Rr, Rr, Rr, Rr, Rr, Rr, Rr, Rr, Rr, Rr, Rr, Rr^Vhc, Rr, Rr, Rr, Rr, Rr, Rr, Rr, Rr, Cv, Gg, Gg, Gg, Gg, Gg, Gg, Gg, Gg, Rb^Gvs, Rb^Gvs, Rb^Gvs, Gg, Gg, Rb^Gvs, Rb^Gvs, Rb^Gvs, Rb^Gvs, Rb^Gvs, Rb^Gvs, Rb^Gvs, Gg, Gg, Rb^Gvs, Rb^Gvs, Rb^Gvs, Gg, Gg, Gg
Gg, Gg, Gs^Fms, Gs^Fms, Gs, Gs, Gs, Gs, Gs^Fms, Gs, Gs^Fms, Gs, Gs, Gg, Gs, Gs, Gg, Gs, Gs, Gs, Gg, Gs, Gs^Fms, Gs^Fms, Gs^Fms, Cv, Rr, Rr^Vhc, Rr, Rr, Rr, Rr, Rr^Vhc, Rr, Rr, Rr, Rr, Rr, Rr^Vhc, Rr, Rr, Rr, Rr, Rr, Rr, Cv, Gg, Gg, Gg, Gg, Gg, Gs, Rb^Gvs, Rb^Gvs, Rb^Gvs, Rb^Gvs, Rb^Gvs, Rb^Gvs, Rb^Gvs, Gg, Gg, Rb^Gvs, Rb^Gvs, Rb^Gvs, Gg, Gg, Rb^Gvs, Rb^Gvs, Rb^Gvs, Rb^Gvs, Rb^Gvs, Rb^Gvs, Rb^Gvs, Gg
Gs^Fms, Gs^Fms, Gs, Gs, Gg, Gs, Gs^Fms, Gg, Gs^Fms, Gs^Fms, Gll, Gs^Fms, Gs^Fms, Gs, Gs, Gs, Gg, Gs, Gg, Gs, Gs, Gs, Gs^Fms, Gs^Fms, Gs^Fms, Cv, Rr, Rr, Rr, Rr, Cv, Rr, Rr, Rr, Rr, Rr, Cv, Rr, Rr, Rr, Rr, Rr, Rr^Vhc, Rr, Rr, Cv, Gs, Gg, Gg, Gg, Rb^Gvs, Rb^Gvs, Rb^Gvs, Rb^Gvs, Rb^Gvs, Rb^Gvs, Rb^Gvs, Rb^Gvs, Rb^Gvs, Rb^Gvs, Rb^Gvs, Gg, Gg, Gg, Rb^Gvs, Rb^Gvs, Rb^Gvs, Rb^Gvs, Rb^Gvs, Rb^Gvs, Rb^Gvs, Rb^Gvs, Rb^Gvs, Rb^Gvs
Gs, Gs, Gs^Efm, Gg, Gs, Gs, Gs^Fms, Gs^Fms, Gll, Gs^Fms, Gs^Fms, Gll, Gs^Fms, Gs^Fms, Gs, Gs, Gg, Gg, Gg, Gs, Gs^Fms, Gll, Gll, Gs^Fms, Gs^Fms, Cv, Cv, Rr, Rr, Rr, Cv, Rr, Rp, Rr, Rp, Rr, Cv, Rr, Rr, Rr, Cv, Rr, Rr, Rr, Cv, Cv, Gs^Fms, Gs, Gg, Gg, Gg, Rb^Gvs, Rb^Gvs, Rb^Gvs, Rb^Gvs, Rb^Gvs, Rb^Gvs, Rb^Gvs, Rb^Gvs, Rb^Gvs, Gg, Gg, Rb^Gvs, Gg, Gg, Rb^Gvs, Rb^Gvs, Rb^Gvs, Rb^Gvs, Rb^Gvs, Rb^Gvs, Rb^Gvs, Rb^Gvs, Rb^Gvs
Gg, Gs, Gs^Efm, Gs, Gs^Fms, Gs^Fms, Gs^Fms, Gs^Fms, Gs^Fms, Gll, Gll, Gll, Gs^Fms, Gs^Fms, Gs^Fms, Gs, Gg, Gg, Gg, Gs, Gs^Fms, Gs^Fms, Gs^Fms, Gs^Fms, Gs^Fms, Gs^Fms, Gs^Fms, Cv, Cv, Cv, Gg, Cv, Rp, Rp, Rp, Cv, Gs, Cv, Cv, Cv, Gs^Fms, Cv, Cv, Cv, Gs^Fms, Gs^Fms, Gs^Fms, Gs, Gs, Gg, Gg, Gs, Gg, Rb^Gvs, Rb^Gvs, Rb^Gvs, Rb^Gvs, Rb^Gvs, Gg, Gg, Rb^Gvs, Rb^Gvs, Rb^Gvs, Rb^Gvs, Rb^Gvs, Gg, Gg, Rb^Gvs, Rb^Gvs, Rb^Gvs, Rb^Gvs, Rb^Gvs, Gg, Gg
Gg, Gg^Efm, Gg, Gs^Fms, Gs^Fms, Gs^Fms, Gs^Fms, Gs^Fms, Gs^Fms, Gs^Fms, Gs^Fms, Gs^Fms, Gs^Fms, Gll, Gs^Fms, Gs, Gg, Gg, Gg, Gg, Gll, Gs^Fms, Gs^Fms, Gll, Gll, Gs^Fms, Gs^Fms, Gs^Fms, Gs^Fms, Gs, Gg, Gg, Rp, Rp, Rp, Gs, Gs^Fms, Gs^Fms, Gs^Fms, Gs^Fms, Gs^Fms, Gs^Fms, Gs^Fms, Gs^Fms, Gs^Fms, Gs^Fms, Gs^Fms, Gg, Gs, Gg, Gg, Gs, Gg, Gg, Gg, Rb^Gvs, Gg, Gg, Rb^Gvs, Rb^Gvs, Rb^Gvs, Rb^Gvs, Rb^Gvs, Rb^Gvs, Rb^Gvs, Rb^Gvs, Rb^Gvs, Gg, Gg, Rb^Gvs, Gg, Gg, Gg, Gg
Gg^Efm, Gg, Gs, Gs^Fms, Gs^Fms, Gll, Gs^Fms, Gs^Fms, Gs^Fms, Gll, Gll, Gll, Gll, Gs^Fms, Gll, Gs, Gg, Re^Vct, Gg, Gs, Gs^Fms, Gs^Fms, Gs^Fms, Gs^Fms, Gs^Fms, Gll, Gs^Fms, Gs^Fms, Gs^Fms, Gs, Gg, Gg, Rp, Rp, Rp, Gs, Gs^Fms, Gs^Fms, Gs^Fms, Gs^Fms, Gll, Gs^Fms, Gll, Gs^Fms, Gll, Gs^Fms, Gs^Fms, Gs, Gg, Gg, Gg, Gg, Gg, Gg, Gg, Gg, Gg, Rb^Gvs, Rb^Gvs, Rb^Gvs, Rb^Gvs, Rb^Gvs, Rb^Gvs, Rb^Gvs, Rb^Gvs, Rb^Gvs, Rb^Gvs, Rb^Gvs, Gg, Gg, Gg, Gg, Gg, Gg
Gs, Gg^Efm, Gs, Gs^Fms, Gs^Fms, Gs^Fms, Gll, Gs^Fms, Gll, Gs^Fms, Gs^Fms, Gs^Fms, Gs^Fms, Gs^Fms, Gll, Gs, Gs, Gs, Gs, Gs, Gs, Gs^Fms, Gs, Gs, Gs, Gs^Fms, Gg, Gll, Gs, Gs, Gg, Gg, Rp, Rp, Rp, Gs, Gs, Gs^Fms, Gs, Gll, Gs, Gs, Gs^Fms, Gs^Fms, Gs^Fms, Gs^Fms, Gs^Fms, Gs, Gg, Gg, Gg, Gs, Gg, Gg, Gs, Gg, Gs, Gg, Gg, Rb^Gvs, Rb^Gvs, Rb^Gvs, Rb^Gvs, Rb^Gvs, Rb^Gvs, Rb^Gvs, Gg, Gg, Gg, Gg, Gg, Gs, Gs, Gg
Gg, Gg^Efm, Gg, Gs^Fms, Gll, Gs^Fms, Gll, Gs^Fms, Gs^Fms, Gs^Fms, Gs^Fms, Gs^Fms, Gs^Fms, Gll, Gs^Fms, Gs, Gs, Gg, Ce, Gs, Gs, Gs, Gg, Gs, Gg, Gs, Gs, Gs, Gg, Gg, Gg, Gg, Rp, Rp, Rp, Gs, Gs, Gs, Gg, Gg, Gg, Gs, Gs, Gs^Fms, Gs^Fms, Gs^Fms, Gs, Gs, Gg, Gg, Gg, Gg, Gg, Gg, Gs, Gg, Gg, Gs, Gg, Gg, Gg, Rb^Gvs, Rb^Gvs, Rb^Gvs, Gg, Gg, Gg, Gg, Gg, Gs^Es, Gg^Es, Gg, Gg, Gg
Gg, Gs^Efm, Gs^Efm, Gg, Gs^Fms, Gs^Fms, Gs^Fms, Gll, Gs^Fms, Gll, Gs^Fms, Gll, Gs^Fms, Gs^Fms, Gs, Gs, Gs, Ce, 5 Ke, Ce, Gg, Gg, Gs, Gs, Gs, Gg, Re^Vct, Gg, Gg, Gg, Gg, Gg, Rp, Rp, Rp, Gs, Gg, Gs, Gs, Gg, Gg, Gg, Gg, Gs, Gs, Gs, Gg, Gg, Gg, Gg, Gg, Gg, Gg^Es, Gg, Gg^Es, Gg, Gg, Gg, Gg, Gs, Gs, Gg, Gg, Gg, Gg, Gg, Gg, Gg, Gg, Gg, Gg, Gg, Gg, Gg
Gs, Gs, Gg^Efm, Gs, Gs, Gs^Fms, Gs^Fms, Gs^Fms, Gs^Fms, Gs^Fms, Gs^Fms, Gs^Fms, Gs, Gs, Gg, Gs^Es, Gs^Es, Ce, Ce, Ce, Gg, Gs, Gs^Fms, Gs^Fms, Gs^Fms, Gs, Gs, Gg, Gs, Gg, Gg, Gg, Rp, Rp, Rp, Gs, Gs, Gs, Gg, Gg, Gg, Gg, Gg^Es, Gs, Gg, Gg, Gg, Gg, Re^Vct, Gg^Es, Gg, Gs, Gg, Gg, Gg, Gs, Gs, Gg, Re^Vct, Gg, Gg, Gg, Gs, Gs, Gs, Gs, Gg^Es, Gs, Gs, Gg, Gg, Gg, Gg, Gg
Gg^Efm, Gg, Gg^Efm, Gg^Efm, Gg, Gs, Gs, Gs^Fms, Gs, Gs, Gs, Gs, Gg^Efm, Gg, Re^Vct, Gs^Efm, Gg^Efm, Gg, Gg, Gs^Efm, Gs, Gs, Gs^Fms, Gs^Fms, Gll, Gs^Fms, Gll, Gs, Gs^Fms, Gs, Gs, Gg, Rp, Rp, Rp, Gg, Gg, Gs, Gg, Gg, Gs, Gg, Gs, Gs, Gg, Gg, Gs, Gs, Gg, Gs, Gg, Gg, Ce, Ce, Ce, Gg, Gs, Gg^Es, Gg, Gg, Gg, Gg, Gg, Gg, Gg, Gg, Gs, Gs, Gg, Gg, Gs^Es, Gg, Gs, Gg
Gg^Efm, Gg, Gg, Gg^Efm, Gg^Efm, Gg^Efm, Gs, Gs, Gs, Gs, Gs, Gg^Efm, Gg, Gg, Gg, Gg, Gg, Gg, Gg, Gs, Gs, Gll, Gs^Fms, Gs^Fms, Gs^Fms, Gs^Fms, Gll, Gs^Fms, Gs^Fms, Gs^Fms, Gs, Gg, Rp, Rp, Rp, Gg, Gg^Efm, Gs^Efm, Gs, Gs, Gg^Efm, Gg, Gs, Gg, Gg, Gg, Gg, Gg, Gg, Gg, Gg, Gg, Ce, Ke, Ce, Gs, Gg, Gg, Gs, Gg, Gg, Gg, Gg, Gg, Gg, Gg, Gs, Gs^Fms, Gs^Fms, Gs^Fms, Gs^Fms, Gs, Gs, Gg
Gg^Efm, Gg^Efm, Gg^Efm, Gg^Efm, Gg^Efm, Gg^Efm, Gg, Gs^Efm, Gs, Gs^Efm, Gg, Gs, Gs, Gs, Gs^Efm, Gg^Efm, Gs^Efm, Gg, Gs^Efm, Gs^Efm, Gs, Gs^Fms, Gs^Fms, Gs^Fms, Gs^Fms, Gs^Fms, Gs^Fms, Gll, Gs^Fms, Gs^Fms, Gs, Gg, Rp, Rp, Rp, Gg, Gg, Gg^Efm, Gg^Efm, Gs, Gs, Gg^Efm, Gs^Efm, Gg, Gg, Gs, Gs, Gg, Gg^Es, Gg^Es, Gg, Gg, Gs, Ce, Gg, Gg, Gg, Gs, Gg, Gs, Gg, Gg, Gg, Gg, Gs, Gg, Gg, Gs^Fms, Gs^Fms, Gll, Gs^Fms, Gs, Gg, Gg
Gg, Gg^Efm, Gg^Efm, Gg^Efm, Gg^Efm, Gg, Gg, Gs, Gg, Gg^Efm, Gg, Gg^Efm, Gs, Gg^Efm, Gs, Gg, Gg, Gs, Gs, Gs, Gg, Gg, Gs^Fms, Gs^Fms, Gs^Fms, Gs^Fms, Gll, Gs^Fms, Gll, Gs^Fms, Gs, Gg, Rp, Rp, Rp, Gg, Gs, Gs, Gs, Gs, Gs, Gg, Gs, Gg, Gg, Gg, Gg, Gs, Gg, Gg, Gs, Gs, Gll, Gg, Gs^Fms, Gs, Gs^Fms, Gs, Gs^Fms, Gg, Gg, Gg, Gg, Gg, Gs, Gg, Gs^Fms, Gll, Gll^Em, Gll, Gg, Gs, Gg, Gg
Gs, Gg, Gg^Efm, Gg^Efm, Gg^Es, Gg^Efm, Gg^Efm, Gg, Gg, Gg^Efm, Gg, Gg, Gs, Gs, Gs^Fms, Gs, Gll, Gg, Gs^Fms, Gs^Fms, Gs^Fms, Gs^Fms, Gs^Fms, Gll, Gs^Fms, Gs^Fms, Gs^Fms, Gs^Fms, Gs^Fms, Gs^Fms, Gs^Fms, Gs, Rp, Rp, Rp, Gs, Gs^Fms, Gs^Fms, Gll, Gs^Fms, Gs^Fms, Gs, Gg, Gg, Gg, Gg, Gg, Gg, Gg^Es, Gg, Gs, Gs^Fms, Gll, Gs^Fms, Gll, Gll^Em, Gll, Gll, Gs^Fms, Gs, Gs, Gg, Gg, Gs^Es, Gg, Gg, Gs, Gs^Fms, Gll, Gs^Fms, Gs, Gs, Gg, Gg
Gs, Gg, Gg^Efm, Gg, Gg^Es, Gg, Gg, Gg^Efm, Gg^Efm, Gg, Gg^Efm, Gg, Gs, Gs^Fms, Gs^Fms, Gs^Fms, Gs^Fms, Gll, Gs^Fms, Gs^Fms, Gll, Gs^Fms, Gs^Fms, Gs^Fms, Gs^Fms, Gll, Gs^Fms, Gs^Fms, Gll, Gs^Fms, Gs^Fms, Gs^Fms, Rp, Rp, Rp, Gs, Gs^Fms, Gll^Em, Gs^Fms, Gs^Fms, Gs^Fms, Gs^Efm, Gg^Efm, Gg, Gg, Gg, Gg, Gs, Gs, Gg, Gg, Gs^Fms, Gs, Gs^Fms, Gs, Gs^Fms, Gll, Gs^Fms, Gll^Em, Gs^Fms, Gs^Fms, Gg, Gs, Gg, Gg, Gg, Gg, Gs, Gg, Gg, Gg, Gg, Gg, Gg
Gs, Gg, Gg, Gg, Gs, Gg, Gg, Gg, Gg, Gg^Efm, Gg, Gg, Gs^Fms, Gs^Fms, Gll, Gs^Fms, Gs^Fms, Gll, Gs^Fms, Gll, Gs^Fms, Gs^Fms, Gs^Fms, Gll, Gs^Fms, Gs^Fms, Gll, Gs^Fms, Gll, Gs^Fms, Gs^Fms, Gs^Fms, Rp, Rp, Rp, Gs^Fms, Gs^Fms, Gs^Fms, Gll, Gs^Fms, Gs^Fms, Gs, Gs, Gg, Gg, Gg, Gg, Gg, Gg, Gg^Es, Gs, Gs, 1 Gg, Gg, Gg, Gs^Fms, Gs, Gs, Gs, Gs^Fms, Gs, Gg, Gg, Gg, Gs, Gg, Gg, Gg, Gg, Gg, Gg, Gs, Gg, Gg
Gs, Gg, Gg, Gs, Gg, Gg, Gs, Gs, Gg, Gg, Gg, Gs, Gs^Fms, Gs^Fms, Gs^Fms, Gs^Fms, Gs^Fms, Gs^Fms, Gs^Fms, Gs^Fms, Gs^Fms, Gs^Fms, Gs^Fms, Gs^Fms, Gs^Fms, Gs^Fms, Gs^Fms, Gll, Gs^Fms, Gs^Fms, Gs^Fms, Gs^Fms, Rp, Rp, Rp, Gs^Fms, Gs^Fms, Gs^Fms, Gs^Fms, Gll, Gs^Fms, Gs^Fms, Gs^Fms, Gs, Gg, Gg, Gg, Gg, Gg, Gs, Gs, Gg, Gg, Gg, Gg, Gs, Gg, Gg, Gg, Gs, Gs, Gs, Gg, Gg, Gg, Gg, Gg, Gg^Es, Gs, Gg, Gs^Es, Gg, Gg, Gg
