Ww, Ww, Ww, Ds, Gs^Fms, Gs^Fms, Gs^Fms, Gs^Fms, Gs^Fms, Gs^Fms, Gs^Fms, Gs^Fms, Gs^Fms, Gs^Fms, Gs^Fms, Gg, Gs, Gg
Ww, Ww, Ww, Ds, Ds, Gs^Fms, Gs^Fms, Gs^Fms, Gs^Fms, Gll, Gs^Fms, Gs^Fms, Gll, Gs^Fms, Gs, Gs, Gg, Gg
Wo, Ww, Ww, Ww, Ds, Gll, Gs, Gs^Fms, Gs, Gs^Fms, Gs, Gll, Gg, Gs, Gg, Gg, Gg, Gg
Wo, Wo, Ww, Ww, Ww, Ds, Gs, Gg, Gs, Gs, Gg^Em, Gg, Gg, Gg, Gg, Gg^Es, Gs, Gg
Ww^Bw\, Wo, Ww, Ww, Ww, Ds, Ds, Gs, Gg, Gg^Efm, Gg^Efm, Gs, Gs^Efm, Gs, Gs, Gs, Gg, Gg
Wo, Ww^Bw\, Ww^Bw\, Ww, Ww, Ww, Ds, Gs^Es, Gg, Gg, Gs, Gs^Efm, Gg^Efm, Gg^Efm, Gg, Gg, Gg, Gg
Wo, Wo, Ww, Ww^Bw\, Ww^Bw\, Ww, Ds, Gs, Gg^Efm, Gs, Gs^Ecf, Gg, Gg, Gg^Efm, Gg^Em, Gs, Gg, Gg
Wo, Wo, Ww, Ww, Ww, Ww^Bw\, Ds, Gs, Gg^Efm, Gs, 1 Gg, Gs, Gs, Gg^Efm, Gs, Gs, Gg, Gg
Ww, Ww, Ww, Ww, Ds, Ds, Gs, Gs, Gg^Efm, Gg, Gg, Gs, Gs, Gs^Efm, Gs^Efm, Gs^Es, Gs, Gg
Ww, Ww, Ww, Ww, Ds, Gs, Gg, Gg^Efm, Gg, Gg, Gs, Gs^Efm, Gg, Gg, Gg, Gg, Gg, Gs
Ww, Ww, Ww, Ds, Gs, Gs, Gg, Gg, Gg, Gs, Gg^Efm, Gg^Efm, Gg, Gg, Gg, Gg, Gg, Gg
Ww, Ww, Ww, Ds, Gg, Gg, Gg, Gg, Gg, Gs^Es, Gs, Gg^Efm, Gg, Gg, Gg, Gg, Gs, Gs
