Mm, Mm, Mm, Hh, Hh^Fms, Hh, Hh, Hh, Gs, Gg, Gg, Gs, Gs^Fms, Gg, Gs^Fms, Gg, Gs^Fms, Gg, Gll, Gg, Gs^Fms, Gg, Gs, Gg, Gg, Gg, Gg, Gg, Gs, Gg, Gg, Gs, Gs, Gg, Gs, Gg, Gg, Hh^Fms, Hh^Fms, Hh, Md, Md, Hh, Hh, Hh^Fms, Gg, Gg, Gg, Hh, Hh, Mm, Mm, Mm, Mm, Mm, Mm, Mm
Mm, Mm, Hh^Fms, Mm, Hh^Fms, Hh^Fms, Hh, Hh, Gs, Gg, Gs, Gs, Gs^Fms, Gs^Fms, Gll, Gs^Fms, Gll, Gs^Fms, Gs^Fms, Gll, Gs^Fms, Gs^Fms, Gs^Fms, Gs, Gs, Gg, Gg, Gs, Gs, Gg, Gg, Gg, Gs^Fms, Gg, Gs, Gs, Gg, Gs^Fms, Gs^Fms, Hh^Fms, Hh, Hh, Hh, Hh^Fms, Gs^Fms, Gll, Gs^Fms, Gs^Fms, Gs^Fms, Hh, Hh, Hh, Mm, Mm, Mm, Mm, Mm
Hh^Fms, Hh^Fms, Hh, Hh^Fms, Gs^Fms, Hh, Gs, Gs, Gg, Gs, Gs, Gs^Fms, Gs^Fms, Gll, Gs, Gs, Gll, Gll, Gs^Fms, Gs^Fms, Gll, Gll, Gll, Gs^Fms, Gs^Fms, Gs, Gs, Gg, Gs, Gg, Gg, Gs^Fms, Gs^Fms, Gs^Fms, Gll, Gg, Gg, Gg, Gg, Gll, Gg, Gll, Gg, Gll, Gg, Gg, Gs^Fms, Gll, Gll, Hh, Gs^Fms, Hh, Hh, Mm, Mm, Mm, Mm
Hh^Fms, Hh^Fms, Gll, Gll, Gs^Fms, Gs^Fms, Gs, Gg, Gs, Gs, Gs^Fms, Gs^Fms, Gll, Gs^Fms, Gll, Gll, Hh, Gll, Hh^Fms, Gll, Gll, Hh^Fms, Hh^Fms, Gll, Gs^Fms, Gg, Gg, Gg, Gg, Gs^Fms, Gll, Gll, Gll, Gs^Fms, Gs^Fms, Gs, Gs, Gg, Gs, Gg, Gs, Gg, Gs^Fms, Gg, Gs^Fms, Gll, Gs^Fms, Gll, Gs^Fms, Gs^Fms, Gs^Fms, Gll, Hh, Mm, Hh, Mm, Mm
Hh^Fms, Gll, Gs^Fms, Gs^Fms, Gs, Gs, Gg, Gg, Gs, Gs^Fms, Gll, Gll, Gll, Gll, Hh^Fms, Hh^Fms, Hh, Hh^Fms, Hh, Hh^Fms, Hh^Fms, Hh, Mm, Hh^Fms, Hh^Fms, Gs, Gs, Gg, Gs^Fms, Gs^Fms, Hh^Fms, Gll, Hh^Fms, Gs^Fms, Gs^Fms, Gg, Gg, Gg, Gg, Gg, Gs^Fms, Gs^Fms, Gll, Gs^Fms, Gll, Gs^Fms, Gs^Fms, Gll, Gll, Gs^Fms, Gll, Gs^Fms, Hh, Hh, Hh, Mm, Mm
Gg, Gs^Fms, Gs, Gs, Gs, Gs, Gs, Gs, Gs^Fms, Gs^Fms, Hh, Hh, Hh^Fms, Hh, Hh^Fms, Hh^Fms, Mm, Mm, Mm, Hh, Mm, Mm, Mm, Mm, Mm, Hh^Fms, Gg, Gg, Hh^Fms, Hh^Fms, Hh, Hh, Hh, Hh, Hh^Fms, Gg, Gg, Gs, Gs, Gg, Hh, Gg^Fms, Hh, Gll, Hh, Gll, Gll, Gs^Fms, Gs^Fms, Gg, Gll, Gll, Gs^Fms, Hh, Hh, Hh, Hh
Gs, Gs, Gg, Gs, Gg, Gs^Fms, Gs^Fms, Gs^Fms, Gs^Fms, Hh, Hh^Fms, Hh^Fms, Hh, Hh^Fms, Hh, Hh, Mm, Mm, Mm, Mm, Mm, Mm, Mm, Mm, Cte, Kte, Rb, Gg, Kte, Mm, Mm, Mm, Mm, Mm, Hh, Hh^Fms, Gg, Gs, Gs, Gg, Cte, Hh, Hh^Fms, Hh^Fms, Hh^Fms, Hh^Fms, Hh^Fms, Gs^Fms, Gs^Fms, Gs^Fms, Gs^Fms, Gs^Fms, Gs, Gg, Gg, Hh, Gg
Gs^Fms, Gg, Gg, Gs, Gs^Fms, Gll, Gll, Gll, Hh, Hh^Fms, Hh, Mm, Mm, Mm, Mm, Mm, Mm, Mm, Mm, Mm, Mm, Mm, Xu, Mm, Xu, Uh, Uue, Rb, Cte, Mm, Mm, Mm, Mm, Mm, Mm, Cte, Cte, Gs, Gg, Cte, Kte, Mm, Mm, Mm, Mm, Hh, Hh, Hh^Fms, Hh^Fms, Gll, Gs^Fms, Gll, Gs, Gs, Gs, Gg, Gg
Gs^Fms, Gg, Gs, Gs, Gll, Gs^Fms, Gs^Fms, Hh, Hh^Fms, Hh^Fms, Mm, Mm, Mm, Mm, Mm, Mm, Mm, Mm, Xu, Mm, Xu, Xu, Xu, Xu, Tb, Tb, Uu, Uue, Xu, Xu, Xu, Xu, Xu, Mm, Mm, Kte, Uue, Rb, Rb, Cte, Mm, Mm, Mm, Mm, Mm, Mm, Mm, Hh, Hh^Fms, Hh, Gll, Gs^Fms, Gs, Gg, Gg, Gs, Gs
Gs^Fms, Gll, Gg, Gs, Gg, Gs^Fms, Gs^Fms, Hh^Fms, Mm, Mm, Mm, Mm, Mm, Mm, Mm, Mm, Xu, Xu, Xu, Xu, Xu, Xu, Xu, Xu, Tb, Uu, Tb, Xu, Xu, Xu, Xu, Xu, Xu, Xu, Xu, Xu, Tb, Uue, Uue, Xu, Xu, Mm, Mm, Mm, Mm, Mm, Mm, Mm, Hh, Gll, Gll, Gs^Fms, Gg, Gs, Gg, Gg, Gs
Gll, Gs^Fms, Gg, Gs, Gs, Gs^Fms, Hh, Hh, Mm, Mm, Mm, Mm, Xu, Xu, Xu, Xu, Xu, Xu, Xu, Xu, Xu, Xu, Xu, Xu, Uh, Uu, Uu, Xu, Xu, Xu, Xu, Xu, Xu, Xu, Xu, Xu, Tb, Uu, Uu, Xu, Xu, Xu, Xu, Mm, Mm, Mm, Mm, Mm, Hh^Fms, Hh, Gs^Fms, Gs^Fms, Gs, Gs, Gs, Gs, Gg
Gs^Fms, Gs^Fms, Gg, Gs, Gg, Gs^Fms, Hh^Fms, Hh^Fms, Mm, Mm, Xu, Xu, Xu, Xu, Xu, Xu, Xu, Xu, Xu, Xu, Xu, Xu, Xu, Xu, Xu, Tb, Xu, Uu, Uu, Xu, Xu, Xu, Xu, Xu, Xu, Xu, Xu, Uu, Uu, Tb, Xu, Xu, Xu, Xu, Xu, Mm, Cte, Mm, Hh^Fms, Gs^Fms, Gs, Gs, Gg, Gg, Gs, Gg, Gg
Gg, Gll, Gg, Gs, Gs, Gs^Fms, Gs^Fms, Hh, Cte, Mm, Xu, Xu, Xu, Xu, Xu, Xu, Xu, Xu, Tb, Uh, Uh, Xu, Xu, Xu, Xu, Xu, Uu, Uu, Xu, Uu, Xu, Xu, Xu, Xu, Xu, Xu, Xu, Xu, Uu, Uu, Xu, Xu, Xu, Xu, Xu, Xu, Kte, Cte, Gg, Gg, Gg, Gg, Gg, Gg, Gs, Gg, Gg
Gg, Gs, Gs, Gg, Gg, Gs, Gs, Gs^Fms, Cte, Kte, Xu, Xu, Xu, Xu, Xu, Xu, Xu, Uu, Uu, Tb, Uu, Uu, Uu, Uu, Uu, Uu, Xu, Xu, Xu, Uu, Xu, Xu, Xu, Xu, Xu, Xu, Xu, Xu, Uu, Uu, Xu, Xu, Xu, Xu, Xu, Xu, Uue, Rb, Rb, Gg, Gg, Gg, Gs^Fms, Gg, Gs, Gg, Gg
Gs, Gg, Gs^Fms, Gs, Gs, Gs, Gs, Rb, Uue, Uh, Tb, Xu, Xu, Xu, Xu, Xu, Xu, Xu, Tb, Tb, Uu, Uu, Tb, Tb, Xu, Xu, Xu, Xu, Xu, Uu, Uu, Xu, Xu, Xu, Xu, Xu, Tb, Uh, Uu, Uu, Xu, Xu, Xu, Xu, Uu, Uu, Uu, Uue, Kte, Cte, Hh^Fms, Gll, Gll, Gs^Fms, Gs^Fms, Gs, Gg
Gs^Fms, Gs^Fms, Gll, Gs^Fms, Gs^Fms, Gg, Cte, Rb, Uue, Uu, Uu, Xu, Xu, Xu, Xu, Xu, Xu, Xu, Uu, Uu, Uu, Uu, Uu, Tb, Xu, Xu, Xu, Xu, Xu, Xu, Uu, Uu, Uu, Xu, Uu, Xu, Uu, Uu, Uu, Uu, Uu, Xu, Uu, Uu, Uu, Uu, Xu, Xu, Mm, Cte, Mm, Hh^Fms, Hh, Gll, Gll, Gs^Fms, Gg
Gg, Gs^Fms, Gs^Fms, Gll, Gll, Gg^Fms, Cte, Kte, Xu, Uu, Uu, Uu, Uu, Xu, Uu, Xu, Uu, Uu, Xu, Uu, Tb, Tb, Uu, Uh, Xu, Xu, Xu, Xu, Xu, Tb, Uu, Uu, Xu, Uu, Xu, Uu, Uu, Uu, Tb, Uu, Uu, Uu, Uu, Uu, Xu, Xu, Xu, Xu, Mm, Mm, Mm, Mm, Hh^Fms, Gll, Gs^Fms, Gs^Fms, Gg
Gs^Fms, Gs^Fms, Gll, Gs^Fms, Hh^Fms, Hh^Fms, Mm, Mm, Xu, Xu, Xu, Uu, Uu, Uu, Xu, Uu, Xu, Xu, Xu, Uh, Tb, Tb, Xu, Xu, Xu, Xu, Xu, Xu, Xu, Uu, Uu, Uu, Xu, Xu, Xu, Xu, Xu, Xu, Xu, Xu, Uu, Uu, Xu, Xu, Xu, Xu, Xu, Mm, Mm, Mm, Mm^Fms, Hh^Fms, Hh, Gs^Fms, Gs^Fms, Gll, Gs
Gs^Fms, Gll, Hh, Gs^Fms, Hh, Hh, Mm, Mm, Xu, Xu, Xu, Uu, Uu, Xu, Xu, Xu, Xu, Xu, Xu, Xu, Xu, Xu, Xu, Xu, Xu, Xu, Xu, Xu, Xu, Uu, Uu, Uu, Xu, Xu, Xu, Xu, Xu, Xu, Xu, Xu, Uu, Xu, Xu, Xu, Xu, Xu, Xu, Mm, Mm, Mm, Mm, Hh^Fms, Hh, Gll, Gs^Fms, Gll, Gg
Gg, Gs^Fms, Hh^Fms, Hh^Fms, Mm, Mm, Mm, Xu, Xu, Xu, Xu, Uu, Uu, Xu, Xu, Xu, Xu, Xu, Xu, Xu, Xu, Xu, Xu, Xu, Xu, Xu, Xu, Xu, Uu, Cte, Cte, Cte, Uu, Xu, Xu, Xu, Xu, Xu, Xu, Uu, Uu, Xu, Xu, Xu, Xu, Xu, Xu, Xu, Mm, Mm, Mm, Hh^Fms, Hh^Fms, Gs^Fms, Gs^Fms, Gll, Gg
Gg, Gll, Hh^Fms, Mm, Mm, Mm, Mm, Xu, Xu, Xu, Xu, Uu, Xu, Uu, Xu, Xu, Xu, Xu, Xu, Xu, Uu, Tb, Uu, Xu, Xu, Xu, Uu, Uu, Xu, Xu, 3 Kte, Xu, Xu, Uu, Uu, Xu, Xu, Xu, Uu, Uu, Uu, Xu, Xu, Xu, Xu, Xu, Xu, Xu, Xu, Mm, Mm, Mm, Hh, Gll, Gs^Fms, Gs^Fms, Gg
Gg, Gg^Fms, Hh^Fms, Mm, Mm, Mm, Mm, Xu, Xu, Xu, Xu, Uu, Uu, Uu, Uu, Xu, Uu, Uu, Uu, Uu, Uu, Uu, Uu, Uu, Cte, Uu, Xu, Xu, Uh, Cte, Cte, Cte, Uh, Xu, Xu, Uu, Cte, Uu, Uu, Uu, Uu, Uu, Uu, Xu, Xu, Xu, Xu, Xu, Xu, Mm, Mm, Mm, Mm, Hh^Fms, Hh, Gs^Fms, Gg
Gs^Fms, Gll, Gll, Hh^Fms, Mm, Mm, Mm, Xu, Xu, Xu, Xu, Xu, Xu, Uu, Uu, Uu, Uu, Uu, Xu, Tb, Xu, Uu, Uu, Uu, Cte, Xu, Cte, Uh, Uh, Uh, Uu, Uh, Uh, Uh, Cte, Xu, Cte, Uu, Uu, Uu, Xu, Uu, Uu, Tb, Uh, Xu, Xu, Xu, Xu, Xu, Mm, Mm, Mm, Hh^Fms, Gll, Gs^Fms, Gs^Fms
Gs^Fms, Gs^Fms, Hh^Fms, Hh, Mm, Mm, Mm, Xu, Xu, Xu, Xu, Xu, Xu, Xu, Uu, Uu, Xu, Xu, Xu, Xu, Xu, Xu, Xu, Cte, Xu, 1 Kte, Cte, Uh, Uh, Uh, Qxu^Bs|, Uh, Uh, Uh, Cte, Kte, Xu, Cte, Xu, Xu, Xu, Xu, Uu, Uu, Uu, Xu, Xu, Xu, Xu, Xu, Mm, Mm, Mm, Hh, Hh^Fms, Gs^Fms, Gll
Gg, Gs^Fms, Hh^Fms, Mm, Mm, Mm, Mm, Xu, Xu, Xu, Xu, Xu, Xu, Tb, Uu, Xu, Xu, Xu, Xu, Xu, Xu, Xu, Xu, Uu, Xu, Cte, Uh, Uh, Uh, Ql, Cte, Ql, Uh, Uh, Uh, Cte, Xu, Uu, Xu, Xu, Xu, Xu, Uu, Uu, Tb, Xu, Xu, Xu, Xu, Xu, Mm, Mm, Mm, Hh^Fms, Hh^Fms, Gs^Fms, Gg
Gg, Gll, Hh^Fms, Mm, Mm, Mm, Mm, Mm, Mm, Xu, Xu, Xu, Xu, Tb, Uu, Xu, Xu, Xu, Xu, Xu, Xu, Xu, Xu, Uu, Xu, Uh, Uh, Uh, Ql, Cte, Ur, Cte, Ql, Uh, Uh, Uh, Xu, Uu, Xu, Xu, Xu, Xu, Xu, Tb, Tb, Uh, Xu, Xu, Xu, Xu, Mm, Mm, Mm, Mm, Hh, Gs^Fms, Gs^Fms
Gs^Fms, Gll, Hh^Fms, Hh, Hh, Mm, Mm, Mm, Mm, Mm, Xu, Xu, Xu, Tb, Uu, Uu, Uu, Xu, Xu, Xu, Xu, Xu, Xu, Uu, Xu, Uh, Uh, Uh, Uh, Cte, Cte, Cte, Uh, Uh, Uh, Uh, Xu, Uu, Xu, Xu, Xu, Xu, Xu, Uh, Tb, Xu, Xu, Xu, Xu, Mm, Mm, Mm, Mm, Mm, Hh, Gs^Fms, Gs^Fms
Gll, Gs^Fms, Gll, Hh^Fms, Gs^Fms, Hh^Fms, Hh^Fms, Mm, Mm, Mm, Mm, Xu, Xu, Xu, Xu, Uu, Uu, Uu, Tb, Xu, Xu, Xu, Xu, Uu, Xu, Cte, Cte, Uh, Uh, Ql, Qxu^Bs|, Ql, Uh, Uh, Cte, Cte, Xu, Uu, Xu, Xu, Xu, Xu, Xu, Xu, Xu, Xu, Xu, Xu, Mm, Mm, Mm, Mm, Hh^Fms, Hh, Gll, Gll, Gs^Fms
Gs, Gs^Fms, Gs^Fms, Gll, Gs^Fms, Hh, Hh, Hh^Fms, Mm, Mm, Mm, Xu, Xu, Xu, Xu, Tb, Xu, Uu, Uu, Xu, Xu, Xu, Uu, Cte, Cte, 4 Kte, Cte, Uh, Uh, Uh, Uu, Uh, Uh, Uh, Cte, 2 Kte, Cte, Cte, Uu, Xu, Xu, Xu, Xu, Xu, Xu, Xu, Xu, Mm, Mm, Mm, Mm, Hh^Fms, Hh, Hh, Gs^Fms, Gs^Fms, Gg
Gg, Gs, Gg, Gll, Gs^Fms, Gll, Hh, Hh^Fms, Mm, Mm, Mm, Xu, Xu, Xu, Xu, Xu, Xu, Tb, Uu, Uu, Uu, Uu, Uh, Uu, Cte, Xu, Xu, Uh, Uh, Uh, Cte, Uh, Uh, Uh, Xu, Xu, Cte, Uu, Uu, Uu, Uu, Xu, Xu, Xu, Xu, Xu, Xu, Mm, Mm, Mm, Mm, Hh^Fms, Hh^Fms, Gs^Fms, Gs^Fms, Gs^Fms, Gg
Gg, Gs, Gs, Gs^Fms, Gll, Hh^Fms, Hh, Mm, Mm, Mm, Mm, Mm, Xu, Xu, Xu, Xu, Xu, Xu, Xu, Uu, Uu, Uh, Uu, Uu, Xu, Uu, Uu, Xu, Xu, Cte, 5 Kte, Cte, Xu, Xu, Uu, Uu, Xu, Uu, Uu, Uu, Uu, Xu, Xu, Xu, Xu, Xu, Xu, Xu, Xu, Mm, Mm, Mm, Hh, Hh, Hh^Fms, Gll, Gg
Gs^Fms, Gg, Gg, Gs^Fms, Gll, Hh^Fms, Hh^Fms, Mm, Mm, Mm, Mm, Mm, Xu, Xu, Xu, Xu, Xu, Xu, Xu, Xu, Uu, Uu, Xu, Xu, Xu, Xu, Xu, Uu, Uu, Xu, Cte, Xu, Uu, Uu, Xu, Xu, Xu, Xu, Xu, Uu, Xu, Xu, Xu, Xu, Xu, Xu, Xu, Xu, Xu, Mm, Mm, Mm, Mm, Hh, Hh^Fms, Gll, Gg
Gg, Gs^Fms, Gs, Gg, Gs^Fms, Gs^Fms, Gs^Fms, Hh, Mm, Mm, Mm, Mm, Xu, Xu, Xu, Xu, Xu, Xu, Xu, Xu, Uu, Xu, Xu, Xu, Xu, Xu, Xu, Xu, Xu, Cte, Uu, Cte, Xu, Xu, Xu, Xu, Xu, Xu, Xu, Uu, Uu, Xu, Xu, Xu, Xu, Xu, Xu, Xu, Xu, Mm, Mm, Mm, Mm, Hh^Fms, Hh, Gs^Fms, Gg
Hh, Gs^Fms, Gs, Gs, Gs^Fms, Gs^Fms, Hh^Fms, Hh^Fms, Mm, Mm, Mm, Mm, Xu, Xu, Xu, Xu, Xu, Xu, Uu, Uu, Uu, Uu, Xu, Xu, Xu, Xu, Xu, Xu, Xu, Uu, Uu, Uu, Xu, Xu, Xu, Xu, Xu, Xu, Xu, Xu, Xu, Uu, Uu, Xu, Xu, Xu, Xu, Xu, Xu, Xu, Mm, Mm, Mm, Mm, Hh, Gs^Fms, Gs^Fms
Hh^Fms, Hh^Fms, Gll, Gll, Gs^Fms, Hh, Hh, Mm, Mm, Mm, Mm, Xu, Xu, Xu, Xu, Xu, Xu, Uh, Uu, Uu, Xu, Uu, Uu, Xu, Xu, Xu, Xu, Xu, Xu, Uu, Uu, Uu, Uu, Xu, Xu, Xu, Xu, Xu, Xu, Xu, Uu, Uu, Tb, Tb, Xu, Xu, Xu, Xu, Xu, Mm, Mm, Mm, Mm, Hh^Fms, Hh, Gll, Gs^Fms
Hh, Hh^Fms, Gs^Fms, Gs^Fms, Gll, Hh, Mm, Mm, Mm, Mm, Mm, Xu, Xu, Xu, Xu, Xu, Xu, Uu, Uu, Xu, Xu, Xu, Xu, Uu, Uu, Uh, Uu, Uh, Uu, Uu, Tb, Uu, Xu, Uu, Uu, Xu, Uu, Uu, Uu, Uu, Xu, Xu, Xu, Uh, Xu, Xu, Xu, Xu, Mm, Mm, Mm, Mm, Mm, Hh^Fms, Gs^Fms, Gs^Fms, Gg
Hh, Gs^Fms, Gll, Gs^Fms, Gs^Fms, Hh^Fms, Hh^Fms, Mm, Mm, Mm, Mm, Xu, Xu, Xu, Xu, Xu, Xu, Uu, Uu, Xu, Xu, Xu, Xu, Xu, Uu, Uu, Uu, Uu, Xu, Tb, Xu, Xu, Xu, Xu, Xu, Uu, Xu, Uu, Uu, Uu, Xu, Xu, Xu, Xu, Xu, Xu, Xu, Mm, Mm, Mm, Mm, Mm, Hh^Fms, Hh, Gll, Gs^Fms, Gg
Gg, Gg, Gs, Gs, Gll, Gs^Fms, Hh^Fms, Mm, Mm, Mm, Kte, Xu, Xu, Xu, Xu, Xu, Uu, Uu, Uu, Xu, Xu, Xu, Xu, Xu, Uu, Xu, Xu, Xu, Xu, Xu, Xu, Xu, Xu, Xu, Xu, Xu, Xu, Xu, Uu, Uu, Xu, Xu, Xu, Xu, Xu, Xu, Mm, Mm, Mm, Mm, Hh, Hh^Fms, Hh, Gs^Fms, Gs^Fms, Gs^Fms, Gg
Gs, Gs, Gg, Gg, Gs^Fms, Gs^Fms, Gs^Fms, Hh^Fms, Hh^Fms, Cte, Cte, Xu, Uu, Uu, Uu, Uu, Uu, Uu, Uu, Xu, Xu, Xu, Xu, Xu, Xu, Uu, Uu, Xu, Xu, Xu, Xu, Xu, Xu, Xu, Xu, Xu, Xu, Xu, Uu, Uu, Xu, Xu, Xu, Xu, Xu, Xu, Mm, Mm, Mm, Mm, Mm, Hh, Hh^Fms, Gs^Fms, Gll, Gs^Fms, Gg
Gg, Gs, Gs, Gs^Fms, Gs^Fms, Gll, Gll, Gs^Fms, Gll, Gs^Fms, Uue, Uu, Uu, Xu, Xu, Xu, Xu, Uu, Uh, Uu, Uu, Xu, Xu, Xu, Xu, Xu, Uu, Xu, Xu, Xu, Xu, Xu, Xu, Xu, Xu, Tb, Uu, Uu, Xu, Xu, Xu, Xu, Xu, Xu, Xu, Mm, Mm, Mm, Mm, Mm, Mm, Hh^Fms, Hh, Gll, Gg, Gs, Gg
Gg, Gg, Gs, Gs, Gg, Gg, Gg, Gg, Gg, Rb, Rb, Uue, Cte, Xu, Xu, Xu, Xu, Xu, Xu, Xu, Xu, Uu, Uu, Uu, Uu, Xu, Uu, Uh, Xu, Xu, Xu, Xu, Xu, Xu, Xu, Uu, Uue, Xu, Kte, Xu, Mm, Mm, Mm, Mm, Mm, Mm, Mm, Mm, Mm, Mm, Hh^Fms, Hh^Fms, Gs^Fms, Gs^Fms, Gll, Gs, Gs
Gs, Gs, Gs, Gs, Gs, Gs, Gg, Gg, Gs, Gs, Gll, Hh, Cte, Kte, Mm, Xu, Xu, Xu, Xu, Xu, Uu, Uu, Xu, Xu, Xu, Uu, Xu, Xu, Xu, Xu, Xu, Xu, Xu, Xu, Kte, Uue, Rb, Cte, Cte, Cte, Mm, Mm, Mm, Mm, Mm, Mm, Mm, Mm, Mm, Hh, Hh^Fms, Gs^Fms, Gs^Fms, Gs^Fms, Gs^Fms, Gg, Gg
Hh, Hh, Hh, Gs, Gs, Gs, Gg, Gg, Gg, Gs, Gs^Fms, Hh^Fms, Mm, Mm, Mm, Mm, Mm, Xu, Xu, Xu, Uu, Uu, Xu, Xu, Xu, Xu, Xu, Xu, Xu, Xu, Xu, Xu, Xu, Cte, Cte, Cte, Rb, Hh, Hh^Fms, Mm, Hh^Fms, Mm, Mm, Mm, Mm, Mm, Mm, Mm, Mm, Mm, Hh^Fms, Gll, Gll, Gs^Fms, Gll, Gs^Fms, Gg
Hh, Hh^Fms, Hh, Gg, Gs, Gg, Gg, Gg, Gg, Gs^Fms, Gll, Hh^Fms, Hh, Mm, Mm, Mm, Mm, Mm, Mm, Mm, Uue, Uue, Mm, Mm, Mm, Mm, Mm, Mm, Mm, Xu, Mm, Xu, Mm, Mm, Mm, Hh^Fms, Gg, Gs, Gg, Hh^Fms, Hh, Hh^Fms, Hh, Hh, Hh^Fms, Mm, Mm, Mm, Mm, Mm, Hh, Hh, Gll, Gll, Gll, Gs^Fms, Gg
Hh, Hh^Fms, Hh^Fms, Gs^Fms, Gg, Gs, Gs, Gg, Gs^Fms, Gs^Fms, Gs^Fms, Gll, Hh^Fms, Mm, Mm, Mm, Mm, Mm, Hh^Fms, Hh^Fms, Rb, Rb, Hh^Fms, Mm, Mm, Mm, Mm, Mm, Mm, Mm, Mm, Mm, Mm, Mm, Mm, Hh, Hh^Fms, Gg, Gs, Gg, Gg, Gs^Fms, Gll, Hh, Gs^Fms, Hh^Fms, Hh, Hh^Fms, Hh^Fms, Hh^Fms, Hh, Gs^Fms, Gs^Fms, Gs^Fms, Gs^Fms, Gll, Gg
Hh, Hh, Hh^Fms, Gs^Fms, Gg, Gs, Gs, Gg, Gs^Fms, Gll, Gll, Hh, Hh^Fms, Mm, Mm, Mm, Mm, Mm, Hh, Gs, Gg, Gs, Hh^Fms, Hh^Fms, Mm, Mm, Mm, Mm, Mm, Mm, Mm, Mm, Mm, Mm, Mm, Mm, Hh^Fms, Hh^Fms, Gg, Gg, Gg, Gs^Fms, Gs^Fms, Gll, Gs^Fms, Gll, Gs^Fms, Gs^Fms, Gs^Fms, Hh^Fms, Gll, Gll, Gll, Gs^Fms, Gll, Gs^Fms, Hh
Hh, Hh^Fms, Hh, Hh, Gg, Gg, Gg, Gs, Gg, Gs^Fms, Gs^Fms, Gll, Hh, Hh, Hh, Mm, Mm, Mm, Hh^Fms, Gs^Fms, Gg, Gg, Gg, Hh, Hh^Fms, Mm, Mm, Mm, Mm, Mm, Mm, Mm, Mm, Mm, Mm, Mm, Hh^Fms, Hh^Fms, Gs^Fms, Gg, Gg, Gg, Gs, Gs^Fms, Gll, Gs^Fms, Gs^Fms, Gs^Fms, Gll, Gs^Fms, Gs^Fms, Gll, Gs^Fms, Gs^Fms, Hh, Hh^Fms, Hh
Hh, Hh^Fms, Hh, Gll, Gll, Gg, Gg, Gs, Gg, Gg, Gll, Gs^Fms, Gs^Fms, Hh^Fms, Hh^Fms, Hh, Hh^Fms, Hh, Hh, Gg, Gs, Gg, Gg, Hh, Gs^Fms, Hh, Hh^Fms, Mm, Mm, Mm, Hh, Mm, Hh, Mm, Mm, Mm, Hh, Hh, Gs^Fms, Gs^Fms, Gs, Gg, Gg, Gg, Gs, Gg, Gs, Gg, Gg, Gg, Gg, Gll, Gs^Fms, Gll, Hh, Hh, Hh
Hh^Fms, Hh^Fms, Hh^Fms, Hh, Gs^Fms, Gg, Gg, Gs, Gg, Gs, Gg, Gs^Fms, Gs^Fms, Gs^Fms, Gs^Fms, Hh^Fms, Gs^Fms, Hh, Gll, Gs, Gg, Gg, Gs, Gs, Gg, Gs^Fms, Gs^Fms, Hh^Fms, Hh^Fms, Hh^Fms, Gll, Hh, Hh^Fms, Hh^Fms, Hh^Fms, Hh, Hh, Gll, Gs^Fms, Gg, Gs, Gg, Gg, Gg, Gg, Gg, Gs, Gs, Gg, Gg, Gs^Fms, Gs^Fms, Gll, Hh, Hh^Fms, Hh^Fms, Hh
Mm, Hh^Fms, Hh^Fms, Hh, Hh^Fms, Gs^Fms, Gs^Fms, Gs, Gs, Gs, Gg, Gg, Gg, Gs^Fms, Gll, Gll, Gs^Fms, Gs^Fms, Gs^Fms, Gg, Gs, Gs, Gg, Gs, Gg, Gll, Gs^Fms, Gs^Fms, Gs^Fms, Gs^Fms, Gs^Fms, Hh, Gll, Hh^Fms, Gs^Fms, Hh, Gll, Gs^Fms, Gg, Gs, Gg, Gg, Gg, Gg, Gs, Gs, Gg, Gg, Gg, Gg, Gll, Gs^Fms, Hh, Hh, Mm, Hh, Mm
Mm, Mm, Hh, Hh^Fms, Hh, Hh^Fms, Hh^Fms, Gg, Gll, Gs, Gs, Gg, Gg, Gs^Fms, Gs^Fms, Gll, Gll, Gs^Fms, Gll, Gg, Gs, Gg, Gg, Gg, Gg, Gs^Fms, Gs^Fms, Gll, Gll, Gs^Fms, Gll, Gs^Fms, Gs^Fms, Gll, Gs^Fms, Gs^Fms, Gs^Fms, Gs^Fms, Gs, Gs, Gg, Gg, Gg, Gs, Gg, Gg, Gs, Gs, Gg, Gg, Gs^Fms, Gs^Fms, Hh^Fms, Hh^Fms, Mm, Mm, Mm
Mm, Mm, Hh^Fms, Hh^Fms, Hh^Fms, Hh, Hh^Fms, Gs^Fms, Gs^Fms, Gg, Gg, Gs, Gg, Gs, Gg, Gs^Fms, Gs^Fms, Gs^Fms, Gg, Gg, Gs, Gs, Gs, Gg, Gs, Gg, Gg, Gs^Fms, Gs^Fms, Gs^Fms, Gg, Gs^Fms, Gs, Gs, Gs, Gg, Gs, Gs, Gs, Gs, Gs, Gs, Gg, Gg, Gg, Gg, Gg, Gg, Gg, Gg, Gg, Gs^Fms, Gll, Hh^Fms, Hh, Mm, Mm
Mm, Mm, Hh, Hh^Fms, Hh^Fms, Hh, Hh, Gll, Gs^Fms, Gg, Gs, Gs, Gg, Gg, Gs, Gg, Gg, Gg, Gg, Gg, Gs, Gg, Gg, Gg, Gs, Gs, Gg, Gg, Gs, Gg, Gg, Gg, Gg, Gs, Gg, Gg, Gg, Gg, Gg, Gg, Gg, Gg, Gs, Gg, Gs, Gs, Gs^Fms, Gg, Gg, Gs, Gs, Gs^Fms, Hh^Fms, Hh, Mm, Mm, Mm
Mm, Mm, Mm, Hh^Fms, Hh^Fms, Hh^Fms, Hh^Fms, Gll, Gs^Fms, Gg, Gs^Fms, Gg, Gll, Gg, Gg, Gs, Gg, Gg, Gs, Gs, Gll, Gg, Gg, Gg, Gg, Gg, Gs, Gs, Gs^Fms, Gs, Gg, Gg, Gs, Gg, Gg, Gg, Gs, Gg, Gg, Gg, Gs, Gs, Gs^Fms, Gs, Gs^Fms, Gs^Fms, Gs^Fms, Gs, Gs, Gg, Gg, Hh, Hh^Fms, Hh^Fms, Hh^Fms, Mm, Mm
Mm, Mm, Mm, Mm, Mm, Hh^Fms, Hh^Fms, Hh, Hh, Hh, Hh, Gs^Fms, Gs^Fms, Gs^Fms, Gg, Gg, Gs, Gs, Gs^Fms, Gs^Fms, Gs^Fms, Gs^Fms, Gs^Fms, Gg, Gll, Hh, Hh, Hh, Hh^Fms, Hh, Hh, Gg, Gg, Gs, Gg, Gs, Gg, Gg, Gs^Fms, Gs^Fms, Gs^Fms, Gs^Fms, Gs^Fms, Gs^Fms, Hh, Hh, Hh, Gs^Fms, Gs, Gg, Gg, Hh, Hh, Hh^Fms, Hh^Fms, Mm, Mm
Mm, Mm, Mm, Mm, Mm, Mm, Hh^Fms, Hh^Fms, Hh^Fms, Hh^Fms, Hh^Fms, Hh^Fms, Gll, Gs^Fms, Gs^Fms, Gs, Gg, Gs^Fms, Gs^Fms, Gs^Fms, Gll, Gs^Fms, Hh^Fms, Hh, Hh, Hh, Mm, Mm, Mm, Hh^Fms, Hh^Fms, Hh, Gg, Gg, Gs, Gs, Gg, Gs^Fms, Gll, Gll, Hh, Gll, Hh^Fms, Hh^Fms, Mm, Hh^Fms, Mm, Hh, Gs^Fms, Gs, Gs, Gs, Gs, Hh^Fms, Hh, Hh^Fms, Hh
Mm, Mm, Mm, Mm, Mm, Mm, Mm, Hh, Hh, Hh^Fms, Hh^Fms, Hh, Hh, Gs^Fms, Gs^Fms, Gg, Gg, Gs^Fms, Gg, Hh, Hh, Hh^Fms, Gg^Fms, Hh^Fms, Gg, Mm, Mm, Mm, Hh^Fms, Mm, Gg^Fms, Hh, Gg, Gg, Gs, Gg, Gg, Gs^Fms, Gs^Fms, Hh, Gg, Hh^Fms, Mm, Mm, Hh, Mm, Mm, Hh, Hh, Gg, Gg, Gg, Gg, Gs, Gg, Hh, Hh
