Gg, Gs, Gs, Ww, Ww, Gg, Gs^Fms, Gg, Hh, Gg, Hh^Fms, Hh, Hh, Gg, Gg, Ww, Ww, Gg, Gg, Gg, Gg^Es, Gg, Rp, Gg, Gs, Gg, Gs, Gg, Gg, Gg, Gg, Gg, Gg, Rp, Gs, Gs, Gs, Gg, Gs, Gg, Gg, Gg, Gs, Gg, Gg, Gg, Gg, Gg, Gg, Rp, Rp, Gg, Gg, Gg, Gg, Ww, Ww, Ww, Gg, Gg, Gg, Gg, Gs^Fms, Gg, Gll, Gg, Gll, Gs^Fms, Gs^Fms, Gg, Gs^Fms, Gg, Gs, Gg
Gll, Gs, Gg, Ww, Ww, Gll, Gs^Fms, Gs^Fms, Gs^Fms, Hh^Fms, Hh^Fms, Hh, Hh^Fms, Hh^Fms, Gs^Fms, Ww, Gs^Fms, Gs^Fms, Gll, Gg, Gg, Gs, Rp, Gg, Gg, Gs, Gg^Es, Gs, Gg, Gs, Gg^Es, Gs, Gg, Rp, Gg, Gs, Gg, Gs^Es, Gs, Gg, Gg^Es, Gg, Gs, Gg, Gg, Gs, Gg, Gg, Rp, Rp, Gg^Es, Gg, Gs, Gs, Gll, Gs^Fms, Ww, Ww, Ww, Gs, Gs, Gll, Gll, Gs^Fms, Gll, Gs^Fms, Gs^Fms, Gs^Fms, Gll^Em, Gll, Gll, Gll, Gs^Fms, Gg
Gs^Fms, Gs^Fms, Gs, Ww, Ww, Gll, Gs, Gs^Fms, Gll, Gs^Fms, Gll, Hh^Fms, Gs^Fms, Gs^Fms, Gs^Fms, Ww, Ww, Gs^Fms, Gll, Gs^Fms, Gg, Gs, Rp, Gg, Gs, Gs, Gg, Gs^Es, Gs, Gs, Gg, Gg, Gg, Rp, Rp, Gg, Gg, Gg, Gg, Gg, Gs, Gs, Gg, Gg, Gg, Gs^Es, Rp, Rp, Gg, Gg, Gg^Es, Gg, Gs, Gs^Fms, Gll, Gg, Gll, Ww, Ww, Ww, Ww, Gg^Es, Gg, Gll, Gs^Fms, Gll, Gs^Fms, Gs^Fms, Gll, Gs^Fms, Gg, Gs^Fms, Gg, Gg
Gs^Fms, Gs^Fms, Gs, Ww, Ww, Ww, Ww, Gll, Ww, Gs, Gs, Gs^Fms, Gs^Fms, Gs^Fms, Gll, Ww, Ww, Ww, Gll, Gg, Gs, Gg, Gg, Rp, Rp, Gg, Gg, Gg, Gg, Gg, Gs^Fms, Gs, Gs, Gg, Gg, Rp, Rp, Gg, Gg, Gg, Gg, Gg, Gg, Gg, Rp, Rp, Gg, Gg, Gg, Gg, Re^Vct, Gg, Gs, Gs^Fms, Gg, Gs, Gs^Fms, Gs^Fms, Gs^Fms, Ww, Ww, Gs, Gs, Gs^Fms, Gg, Gll, Gg, Gs^Fms, Gg, Gg, Gg, Gs, Gs, Gs
Gs^Fms, Gs^Fms, Gll, Gg, Gg, Ww, Ww, Ww, Ww, Ww, Ww, Gll, Gs^Fms, Gll, Gs, Ww, Ww, Ww, Gll, Gg, Gs^Fms, Gs, Gg, Gg^Es, Gg, Rp, Rp, Gg, Gs, Gs^Fms, Gll, Gs^Fms, Gs, Gg, Gs, Gg, Gg, Rp, Rp, Gll, Gs^Fms, Gs, Rp, Rp, Gg, Gg, Ce, Gg, Gg, Gg, Gg, Gg, Gg, Gs, Gg, Gg, Gs, Gll, Gs^Fms, Ww, Ww, Gg, Gs, Gg, Gg, Gg, Gg^Efm, Gs^Efm, Gg, Gs^Es, Gg, Gg, Rp, Rp
Gs^Fms, Gs^Fms, Gs^Fms, Gll, Gg, Gs, Gs, Ww, Gg, Ww, Ww, Gll, Gg, Gs, Ww, Ww, Ww, Ww, Gs^Fms, Gs^Fms, Gll, Gg, Gg^Efm, Gs^Es, Gs, Gg, Rp, Gg, Gs, Gs^Fms, Gg, Gg, Gs, Gg, Gg, Gg, Gg, Gs, Gs^Fms, Rp, Rp, Rp, Gg, Gg, Gg, Ce, 3 Ke, Ce, Gg, Gg, Gg, Gs, Gg, Gg, Gg, Gg, Gs, Gs^Fms, Gs^Fms, Ww, Ww, Ww, Ww, Gg, Gg, Gs, Gs, Gs^Efm, Gg, Gs, Gg, Rp, Gg, Gg
Hh^Fms, Hh^Fms, Hh^Fms, Gs^Fms, Gs^Fms, Gg, Gg, Gs, Gg^Es, Ww, Ww, Ww, Ww, Ww, Ww, Ww, Gll, Gs^Fms, Gll, Gs^Fms, Gll, Gg, Gg, Gs, Gg, Gg, Rp, Gg, Gg, Gg^Es, Gg^Es, Gg, Gg, Gg^Efm, Gs^Efm, Gs, Gs, Gg, Gg, Gs^Fms, Rp, Gs^Fms, Gs, Gg, Ce, Ce, Ce, Ce, Ce, Gg, Gg, Gg, Gs, Gs^Es, Gg, Gg, Gg, Gs^Fms, Gs, Gs, Gg, Ww, Ww, Gg, Gll, Gs^Fms, Gg, Gg, Gg, Gs, Gg, Rp, Gg, Gg
Hh^Fms, Hh, Hh^Fms, Hh, Gs^Fms, Gs^Fms, Gs^Fms, Gg, Gg, Gg, Gs, Ww, Ww, Ww, Ww, Ww, Gs^Fms, Gs^Fms, Gg, Gs^Fms, Gs^Fms, Gs, Gs, Gs^Efm, Gs, Gg, Rp, Gg, Gg, Gg, Gg, Gg, Gg, Gg, Gs^Efm, Gg^Efm, Gg, Gs, Gs, Gg, Rp, Gg, Gg, Gg, Gg, Gg, Ce, Gg, Gg, Gg, Gg, Gg, Gs, Gg, Gg, Gg, Gg, Gll, Gg, Gg, Gs, Ww, Ww, Ww, Gs^Fms, Gll, Gg, Gg, Gg, Gg, Gg, Rp, Gs, Gg
Hh^Fms, Hh, Hh^Fms, Hh, Hh, Gll, Gs^Fms, Gll, Gs^Fms, Gg^Es, Gs, Gg, Gg, Ww, Ww, Ww, Ww, Gs^Fms, Gs, Gll, Gll, Gs^Fms, Gs, Gg, Gg, Gg, Gg, Rp, Rp, Gg, Gg, Gs, Gs, Gg, Gg, Gs, Gg, Gg, Gs, Gg, Rp, Gg, Gg, Gg, Gg, Gg, Gg, Gg, Gg, Gg, Gg, Re^Vct, Gg, Gg, Gg, Gg, Gs^Fms, Gs^Fms, Gll, Gg, Gs^Fms, Gs^Fms, Ww, Ww, Gll, Gs^Fms, Gs^Fms, Gs, Gg, Gs, Gs, Rp, Gg, Gg
Hh, Hh, Hh^Fms, Hh^Fms, Hh^Fms, Gs^Fms, Gll^Em, Gll^Em, Gs^Fms, Gs, Gg, Gg, Gs^Fms, Gs^Fms, Ww, Ww, Ww, Gs, Gll, Gg, Gs^Fms, Gs^Fms, Gg, Gg^Es, Gg^Es, Gs, Gs, Gg, Gg, Rp, Rp, Gs^Fms, Gs^Fms, Gs, Gs, Gs, Gg, Gs, Gs^Vh, Gg, Gg, Rp, Rp, Gg, Gg, Gg, Gg, Gg, Gg, Gg, Gg, Gg, Gg, Gg, Gg, Gg, Gll, Gs^Fms, Gs^Fms, Gll, Gs^Fms, Gll, Ww, Ww, Gs^Fms, Gs^Fms, Gs, Gs, Gg, Gs, Gg, Rp, Gs, Gg
Hh, Hh^Fms, Hh^Fms, Hh^Fms, Hh, Hh, Gs^Fms, Gll, Gs^Fms, Gg, Gg, Gs^Fms, Gll, Gs^Fms, Gll, Ww, Ww, Gg, Gs^Fms, Gs^Fms, Gs, Gs, Gg, Gs, Gs^Fms, Gg, Gg, Gs, Gg, Gll, Gs^Fms, Rp, Rp, Gs^Fms, Gg, Gg, Gg, Re^Gvs, Re^Gvs, Gs, Gs, Gs^Fms, Rp, Gg, Gs, Gg, Gg, Gg, Gg^Es, Gg^Es, Gg, Gg, Gg, Gg, Gs, Gg, Gs, Gs^Fms, Gll, Gs^Fms, Gs^Fms, Gll, Ww, Ww, Gs, Gg, Gs, Gg, Re^Gvs, Re^Gvs, Gs^Vh, Rp, Gs, Gg
Hh^Fms, Hh, Hh^Fms, Hh^Fms, Hh, Gs^Fms, Gs^Fms, Gs^Fms, Gll, Gg, Gg, Gs^Fms, Gs^Fms, Gll, Gs^Fms, Ww, Ww, Ww, Ww, Gs, Gs^Vc, Gg^Es, Gg, Gs^Fms, Gs, Gll, Gs^Fms, Gg, Gg, Gll, Gs, Gs^Fms, Gs^Fms, Rp, Rp, Gg, Gg, Gs, Gg, Gg, Gg, Gg, Rp, Gs^Fms, Gg, Gg, Gg, Gg, Gs^Vh, Gs, Gs, Gg, Gg, Gs, Gs^Fms, Gg, Ww, Ww, Ww, Ww, Ww, Ww, Ww, Ww, Gg, Gg, Gg, Gs, Gg, Gg, Rp, Rp, Gs, Gg
Hh, Hh^Fms, Hh^Fms, Hh^Fms, Gll^Em, Gll, Gs^Fms, Gll, Gg, Gg, Gg, Gs, Gs, Gg, Gs, Gs^Fms, Gg, Ww, Ww, Ww, Ww, Ww, Ww, Ww, Ww, Gll, Gs^Fms, Gg, Gg, Gg, Gg, Gs, Gg, Gg, Gg, Rp, Rp, Gg, Gs^Fms, Gs, Gs, Gg, Gs, Rp, Rp, Gg, Gg, Gg, Re^Gvs, Re^Gvs, Gg, Gg, Gs, Gs^Fms, Ww, Ww, Ww, Ww, Ww, Ww, Ww, Ww, Gg, Gg, Gs, Gg, Gs, Gg, Rp, Rp, Gg, Gg^Es, Gg, Gg
Hh, Hh, Gs^Fms, Gll, Gs^Fms, Gs^Fms, Gg, Gg, Gs, Gg, Gg, Gg^Efm, Gg, Gs, Gg, Gg, Gg^Es, Gg, Gg, Ww, Gs^Fms, Ww, Ww, Ww, Ww, Gs^Fms, Gs^Fms, Gg, Gg, Gs, Gg, Gg, Gs, Gg, Gg, Gs, Gs^Fms, Rp, Rp, Gs^Fms, Gs, Gg, Gg, Gs^Fms, Rp, Gs, Gg, Gg, Gs, Gs, Gg, Gg, Gs, Gs^Fms, Ww, Ww, Gs^Fms, Gs^Fms, Gs^Fms, Ww, Gg, Gs, Gs, Gs, Gg, Gs^Es, Gg, Gg, Rp, Gg, Gg, Gs, Gs, Gg
Gs^Fms, Gs^Fms, Gs, Gll, Gg, Gg, Gg, Gs, Gg^Efm, Gs^Efm, Gg, Gs^Efm, Gs, Gs, Gs, Gg^Es, Gs, Gs, Gg, Gs^Fms, Gs^Fms, Gs^Fms, Ce, Ww, Ww, Ww, Ww, Gg, Gg, Gg, Gs, Gg, Gg, Gs, Gg, Gs, Gll, Gs^Fms, Rp, Gs^Fms, Gg, Gg, Gg, Gg, Rp, Gs^Fms, Gg, Gg, Gg, Gg, Gg, Gs, Gg, Gg, Ww, Ww, Gs^Fms, Gll, Gs^Fms, Gg, Gs, Gg, Gs^Es, Gg, Gg, Gg, Gg, Gg, Rp, Gg, Gg, Gg, Gg^Es, Gg
Gg, Gs, Gg, Gg, Gs, Gs, Gs^Fms, Gg, Gg, Gg, Gs^Fms, Gg, Gg, Gg, Gg, Gg, Gs, Gs, Re^Vct, Gg, Gg, Ce, Ke, Ce, Gs^Fms, Ww, Gs^Fms, Ww, Ww, Gg, Gg, Gs, Gs, Gs, Gg, Gg, Gs, Gs^Fms, Rp, Gg, Gg, Gg, Gs^Fms, Gs, Gg, Rp, Rp, Gg, Gg, Gg, Gs, Gg, Gg, Gg, Ww, Ww, Ww, Gs^Fms, Gs^Fms, Gg, Gs, Gg, Gg, Gs, Gg, Gg, Kv, Gg, Rp, Gg, Kv, Gg, Gs^Es, Gg
Gs, Gg, Gg, Gs^Es, Gg, Gs^Fms, Gll, Gll, Gs^Fms, Gll, Gll, Gs^Fms, Gs, Gg, Gg, Gs, Gg^Es, Gg, Gs, Gg, Ce, Ce, Ce, 1 Ce, Ce, Ww, Ww, Ww, Ww, Ww, Gg, Gg, Gs, Gs, Gs^Vh, Gg, Gg, Gs, Rp, Gg, Gg, Gs, Gs^Fms, Gs^Fms, Gg, Gg, Gs^Vh, Rp, Gg, Gg, Gg, Gs, Gs, Gg, Gs^Vh, Ww, Ww, Gs^Fms, Gll, Gg, Gs, Gg, Gs, Gs, Gs, Gg, Gg, Gg, Rp, Gg, Gg, Gg, Gs, Gg
Gg, Gg^Es, Gg, Gs, Gg, Gg, Gs, Gs^Fms, Gll, Gs^Fms, Gs^Fms, Gg, Gll, Gs^Fms, Gs, Gg, Gg, Gg, Gg, Gs, Gg, Gg, Ce, Gg, Gs, Gg, Gs, Gg, Ww, Ww, Gg, Gs, Gg, Gg, Re^Gvs, Re^Gvs, Gg, Gg, Rp, Gs, Gg, Gg, Gg, Gs, Gg, Re^Gvs, Gs, Rp, Rp, Gg, Gg, Gg^Es, Gg, Re^Gvs, Re^Gvs, Ww, Ww, Ww, Gs^Vh, Re^Gvs, Gg, Gg, Re^Gvs, Gg, Gg, Gs, Rp, Rp, Cv, Rp, Rp, Gg, Gg, Gg
Gg, Gg, Gs^Efm, Gg, Gg^Efm, Gg, Gs, Gg, Gll, Gs^Fms, Gll^Em, Gs^Fms, Gll, Gg, Gs^Fms, Gg, Gg, Gg, Gs^Es, Gs, Gg, Gg, Gg, Gg, Gg, Gg, Gs^Efm, Gg, Ww, Ww, Ww, Gg, Gs, Gg, Gs, Gg, Gs, Gg, Rp, Gg, Gg, Gs, Gg, Gs, Gg, Gg, Gg, Gg, Gg, Rp, Gg, Gg, Gg, Gs, Gg, Gg, Ww, Ww, Ww, Ww, Ww, Gs, Gd^Vhr, Gg, Rp, Rp, Cv, Gg, Cv, Gg, Cv, Rp, Rp, Gg
Gs, Gg^Efm, Gs, Gg, Gg, Gs, Gs, Gs^Fms, Gs^Fms, Gg, Gll, Gg, Gll, Gg, Gg, Gg, Gs, Gs, Gg, Gg, Re^Vct, Gg, Gs, Gs, Gg, Gg^Efm, Gs, Gg, Gg, Ww, Ww, Gg, Gg, Gs, Gg, Gg, Gg, Gs^Fms, Rp, Gg, Gg, Gg, Gs, Gg, Gs, Gg, Gg, Gg, Gg, Rp, Gg, Gg, Gg, Gg, Gs, Gg, Gg, Ww, Ww, Ww, Ww, Ww, Rp, Rp, Gs, Gg, Gg, Cv, Kv, Cv, Gg, Gg, Gg, Rp
Gg, Gg, Gg^Efm, Gg, Gs, Gg, Gg, Gs, Gs^Efm, Gg, Gs, Gs^Fms, Gg, Gs^Fms, Gs, Gs, Gg, Gg, Gs, Gg, Gg, Gg, Gg, Gg, Gs, Gs, Gg, Gg, Gs^Vh, Ww, Ww, Ww, Gs, Gg, Gg, Gg, Rp, Rp, Gs, Rp, Rp, Gg, Gg, Gs^Fms, Gs^Fms, Gll, Gs^Fms, Gs, Gg, Rp, Rp, Gg, Gg, Gg, Gg, Gg, Gg, Gg, Gg, Gg, Ww^Bsb/, Ww^Bsb/, Gg, Gs, Gg, Gs, Gg, Cv, Cv, Cv, Gg, Gg^Es, Gg, Gg
Gg, Gg, Gg, Gs, Gs, Gg^Efm, Gg, Gs, Gs, Gs, Gg, Gs, Gs, Gg, Gs, Gg, Gg, Gs^Es, Gg, Gs, Gs, Gg, Gs, Gg, Gg, Gg, Gg, Gs, Re^Gvs, Re^Gvs, Ww, Ww, Gs^Fms, Gg, Rp, Rp, Gs, Gg, Gs, Gs, Gg, Rp, Kvr, Hh, Hh^Fms, Hh^Fms, Hh, Gll, Gg, Gg^Es, Gg, Rp, Rp, Gg, Cvr, Gg, Cvr, Gg, Rp, Rp, Ww, Ww, Ww, Gs, Gg, Gs, Gg, Gg, Gg, Gg, Gg, Gs, Gs, Gg
Rp, Gg, Gg, Gg, Gs, Gg, Gg^Efm, Gs, Gs, Gg^Efm, Gg^Efm, Gg^Efm, Gg, Gs, Gg, Gg, Gg, Gs, Gg, Gs^Efm, Gg^Efm, Gg, Gg, Gs, Gs, Gg, Gs, Gs, Gg, Gg, Ww, Ww, Ww^Bsb/, Rp, Gg, Gg, Gs^Fms, Gs^Fms, Gs^Fms, Gg, Kvr, Rp, Cvr, Hh^Fms, Hh, Hh^Fms, Hh, Gs^Fms, Gg, Gg^Es, Gs, Gg, Cvr, Rp, Rp^Cov, Kvr, Rp^Cov, Rp, Cvr, Gs^Fms, Hh, Ww, Ww, Ww, Gs, Gs, Gs, Gg^Es, Gs^Es, Gs, Gs^Es, Gs, Gg, Gg
Gg, Rp, Rp, Gg, Gg, Gg, Gs, Gg, Gg, Gg, Gs, Gs, Gg, Gs, Gg, Gs, Gg, Gg, Gs, Gs^Vc, Gg, Gg, Gs, Gg, Gg, Gg, Gs, Gg, Gg, Gg, Rp, Ww^Bsb/, Ww, Gg, Gg, Gs, Gs^Fms, Hh, Hh^Fms, Gs^Fms, Cvr, Rp^Cov, Kvr, Cvr, Ds, Hh^Fms, Ww, Gs^Fms, Gg, Gs, Gg, Gg, Gg, Cvr, Cvr, Rp, Cvr, Cvr, Hh^Fms, Hh^Fms, Hh^Fms, Hh^Fms, Ww, Ww, Gg, Gs, Gg, Gg, Gg, Re^Gvs, Gd^Vhr, Gg, Gg, Gs
Gg, Gg, Gg, Rp, Rp, Gg, Gg, Gg, Gg, Gg, Gg, Gg, Gs, Gs, Gg^Es, Gs, Gg, Gg, Gs, Gg, Gg, Gs, Gs, Gs, Gs, Gs, Gg, Gg, Rp, Rp, Gs^Fms, Ww, Ww, Ww, Ww, Gs^Fms, Hh^Fms, Hh^Fms, Hh, Cvr, Kvr, Rp, Ww, Ww, Ww, Ww, Ww, Ww, Ww, Gg, Ww, Gg, Ww, Cvr, Kvr, Rp, Kvr, Cvr, Hh^Fms, Hh, Hh, Ww, Ww, Ww, Gg, Gg, Gs, Gs^Es, Gg, Re^Gvs, Gg^Es, Gg, Gs, Gg
Gg, Gg, Gg, Gg, Gg, Rp, Rp, Gg, Rp, Rp, Rp, Gg, Gg, Gg, Gg, Gg, Gg, Gs, Gg, Gg^Es, Gs, Gs, Gs, Gg, Gg, Gg, Rp, Rp, Gs, Gg, Gg, Gs, Gg, Ww, Ww, Ww, Hh, Hh^Fms, Hh^Fms, Ds, Ww, Ww^Bsb|, Wo, Wo, Wo, Wo, Wo, Ww, Ww, Ww, Wo, Ww, Ww, Ww, Ww, Ww^Bsb|, Ww, Ww, Ww, Ds, Ww, Ww, Ww, Gg, Gg, Gs, Gg, Gg, Gg, Gs, Gs, Gs, Gg, Gg
Gs, Gs, Gs, Gg^Es, Gg^Es, Gs, Gs, Rp, Gs, Gg, Gg, Rp, Rp, Gg, Rp, Gg, Gg, Gs, Gs, Gs, Gg, Gg, Gg, Gg, Rp, Rp, Gg, Gg, Gs, Gg, Gg, Gg, Gs, Gs^Vc, Ww, Ww, Ds, Ds, Ww, Ww, Wo, Ww^Bsb|, Wo, Wo, Wo, Wo, Wo, Wo, Wo, Wo, Wo, Wo, Wo, Ww, Wo, Ww^Bsb|, Wo, Ww, Wo, Ww, Ww, Ww, Gll, Gg, Gs^Fms, Gll, Gs^Fms, Gg, Gg, Gg, Gg, Gs, Gg, Gg
Gs^Fms, Gg, Gs^Fms, Gs, Gs, Re^Vct, Gg, Gs, Gg, Gg, Gg, Gs, Gs, Rp, Gg, Rp, Rp, Gg, Gg, Gg, Gg, Gg, Rp, Rp, Gg, Gg, Gs, Gs, Gs^Es, Gs, Gg^Es, Gs, Gg, Ds, Ww, Ww, Ww, Ww, Wo, Wo, Wo, Wo^Bsb|, Wo, Wo, Wo, Wo, Wo, Wo, Wo, Wo, Wo, Wo, Wo, Wo, Wo, Wo^Bsb|, Wo, Wo, Ww, Ww, Gs^Fms, Gs^Fms, Hh^Fms, Hh^Fms, Hh, Gll, Gll, Gs^Fms, Gs^Fms, Gg, Gs, Gs, Gg, Gg
Gg, Gll, Gll^Em, Gs^Fms, Gs^Fms, Gs, Gg, Gg, Gg, Ce, Gg, Gg, Gg, Gs, Gs^Es, Gg, Gg, Rp, Rp, Gg, Rp, Rp, Gg, Gg, Gs, Gg, Gg, Gg, Gs, Gg, Gs, Gg, Gg, Ds, Ww, Wo, Wo, Wo, Wo, Wo, Wo, Wo^Bsb|, Wo, Wo, Wo, Wo, Wo, Wo, Wo, Wo, Wo, Wo, Wo, Wo, Wo, Wo^Bsb|, Wo, Ww, Ds, Gs^Vc, Gs^Fms, Hh, Hh^Fms, Hh^Fms, Hh^Fms, Hh, Gs^Fms, Gs^Fms, Gs^Fms, Gg, Gg, Gs^Es, Gg, Gg
Gll, Gs^Fms, Gs^Fms, Gll, Gll, Gs^Fms, Gs, Gg, Ce, Ce, Ce, Ce, Gg, Gg, Gg, Gg^Es, Gg, Gg, Rp, Rp, Gg, Gg, Gs^Es, Gg, Gg, Hh^Vc, Hh^Fms, Gg, Gg, Gs, Gs, Gg, Gs, Ww, Ww, Ww, Wo, Wo, Wo, Wo, Wo, Wo^Bsb|, Wo, Wo, Wo, Wo, Wo, Wo, Ww, Wo, Wo, Wo, Wo, Wo, Wo^Bsb/, Cvr, Wo, Ww, Ww, Gs^Fms, Gs^Fms, Hh^Fms, Hh, Hh^Fms, Hh, Hh^Fms, Hh, Gs^Fms, Gs^Fms, Gg, Gs, Gs^Es, Gg^Em, Gg
Gs^Fms, Gll, Gll^Em, Gll, Gs^Fms, Gs^Fms, Gs, Gg, Ce, 5 Ke, Ce, Gg, Gg, Gs^Es, Gg, Gg, Rp, Rp, Gg, Gg^Es, Gg, Gs^Es, Gg, Gg, Gs^Fms, Hh, Hh^Fms, Hh^Fms, Gs^Fms, Gg, Gg, Gg, Ds, Ww, Ww, Wo, Wo, Wo, Wo, Wo, Wo, Cvr, Wo^Bsb\, Wo, Wo, Wo, Ww, Ww, Cvr, Ww, Ww, Ww, Ww^Bsb/, Wo^Bsb/, Wo, Wo, Wo, Ww, Ww, Gll, Gs^Fms, Gs^Fms, Hh, Hh^Fms, Hh, Hh^Fms, Gll^Em, Gll, Gs^Fms, Gg, Gg, Gs, Gg, Gg
Gs^Fms, Gll^Em, Gll, Gll, Gll, Gs^Fms, Gs, Gg, Gg, Ce, Gg, Ce, Gg, Gg, Rp, Rp, Gg, Gg, Gg, Gs, Hh^Fms, Gll, Gll, Gs^Fms, Hh, Hh^Fms, Hh^Fms, Hh^Fms, Gs^Fms, Gs^Fms, Gll, Ds, Ww, Ww, Wo, Wo, Wo, Wo, Wo, Wo, Wo, Wo, Wo, Wo^Bsb\, Ww^Bsb\, Ww, Kvr, Cvr, Rp^Vhcr, Kvr, Rrc, Ww^Bsb/, Ww, Wo, Wo, Wo, Wo, Ww, Ww, Ds, Gs^Fms, Gs^Fms, Gs^Fms, Hh^Fms, Gll, Hh^Fms, Gll, Gll, Gs^Fms, Gll, Gg, Gs^Es, Gg^Es, Gg
Gs^Fms, Gll, Gg, Gs^Fms, Gs, Gs^Fms, Gg, Gg, Gg, Gg, Gg, Gg, Rp, Rp, Rp, Gg, Gs, Gs, Gs^Fms, Gs^Fms, Hh^Fms, Hh^Fms, Hh^Fms, Hh, Hh, Hh^Fms, Hh^Fms, Hh, Gll, Gs^Fms, Gll, Ds, Ww, Ww, Wo, Wo, Wo, Wo, Ww, Wo, Wo, Wo, Ww, Ww, Kvr, Rrc, Rrc, Rp^Vhcr, Rp^Vhcr, Rrc, Rp^Vhcr, Kvr, Ww, Wo, Wo, Wo, Wo, Wo, Ww, Ds, Gs^Fms, Gs^Fms, Gll, Gs^Fms, Gll, Gs^Fms, Gll, Gs^Fms, Gll, Gs^Fms, Gg, Gs, Gg, Gg
Gs, Gs^Fms, Gs, Gs, Gg, Gs, Gg, Re^Vct, Gs, Gs, Rp, Rp, Gg, Gg, Rp, Gg, Gg, Gg, Gg, Gs^Fms, Gs^Fms, Hh^Fms, Hh^Fms, Hh^Fms, Hh^Fms, Hh^Fms, Gs^Fms, Gll, Gs^Fms, Gs^Fms, Gll, Gs, Ww, Ww, Wo, Wo, Wo, Ww, Kvr, Ww, Ww, Wo, Ww, Cvr, Rp^Vhcr, Rrc, Rp^Vhcr, Rrc, Rrc, Rrc, Rp^Vhcr, Cvr, Ww, Wo, Wo, Wo, Wo, Wo, Ww, Ww, Gll, Gs^Fms, Gs^Fms, Gll, Gs^Fms, Gs^Fms, Gs^Fms, Gll, Gll, Gll, Gs^Fms, Gg, Gg, Gg
Gs, Gs, Gg, Gg, Gs^Em, Gs^Es, Gg, Gg, Rp, Rp, Gg, Gg, Gs^Es, Gg, Rp, Gs, Gs, Gg, Gs, Gll, Gll, Gs^Fms, Gs^Fms, Gll, Gs^Fms, Gs^Fms, Gs^Fms, Gs^Fms, Gs^Fms, Gs^Fms, Gg, Ds, Ww, Ww, Wo, Wo, Wo, Ww, Gs^Fms, Gs^Fms, Ww, Wo, Ww, Kvr, Rrc, Rrc, Cvr, Kvr, Rrc, Kvr, Cvr, Cvr, Ww, Wo, Wo, Wo, Wo, Wo, Ww, Ww, Gll, Gs^Fms, Gs^Fms, Gs^Fms, Gll, Gll^Em, Gs^Fms, Gs^Fms, Gs^Fms, Gll, Gs^Fms, Gll, Gs, Gg
Gg, Gg, Gs, Gs, Gs, Gg, Rp, Rp, Gg, Gs, Gg^Efm, Gs^Es, Gs^Vh, Gg, Rp, Gg, Gg, Gs, Gg^Es, Gg, Gg, Gs^Fms, Gs^Fms, Gll, Gs^Fms, Gs^Fms, Gll, Gll, Gs, Gll, Ds, Ww, Wo, Wo, Wo, Wo, Wo, Ww, Ww, Ww, Wo, Wo, Ww^Bsb/, Rrc, Kvr, Cvr, Ww, Ww, Ww^Bsb|, Ww, Ww, Ww, Ww, Ww, Wo, Wo, Wo, Wo, Wo, Ww, Ds, Gs^Fms, Hh^Fms, Hh^Fms, Hh^Fms, Hh^Fms, Hh^Fms, Gs^Fms, Gs^Fms, Gs^Fms, Gs^Fms, Gg, Gs, Gg
Gs, Gs, Gg, Gg, Rp, Rp, Gg, Gg, Gs, Gs^Efm, Gg, Re^Gvs, Gg, Gg, Rp, Gg, Gs, Gg, Gs, Gg^Es, Gs^Es, Gg, Gs^Vc, Gs^Fms, Ww, Gg, Ww, Ww, Ww, Ww, Ww, Ww, Wo, Wo, Wo, Wo, Wo, Wo, Ww, Ww, Ww^Bsb/, Wo^Bsb/, Wo, Ww, Ww, Ww, Wo, Ww, Wo^Bsb|, Wo, Wo, Wo, Wo, Wo, Wo, Wo, Wo, Wo, Wo, Ww, Ww, Ds, Hh, Hh^Fms, Hh, Hh, Hh^Fms, Gll, Hh^Fms, Gll, Gs^Fms, Gs^Fms, Gg, Gg
Gg, Gg, Rp, Rp, Gs, Gg, Gg, Gs^Efm, Gg, Gg, Gg^Efm, Gg^Efm, Gg, Gg, Rp, Gs, Gs, Gs^Es, Gg, Gg, Gg, Gg, Ww, Ww, Ww, Ww, Ww, Ww, Ww, Ww, Ds, Ww, Ww, Wo, Wo, Wo, Wo, Wo, Ww^Bsb/, Cvr, Gs^Fms, Ww, Wo, Ww, Wo, Wo, Ww, Wo, Ww^Bsb|, Ww, Ww, Wo, Wo, Wo, Wo, Wo, Wo, Wo, Wo, Wo, Ww, Ww, Mm, Mm, Mm, Hh, Hh^Fms, Hh, Hh^Fms, Gll, Gs^Fms, Gll, Gs^Fms, Gg
Rp, Rp, Gs, Gs, Gs^Fms, Gg, Gs^Fms, Gg, Gg, Gg, Gg, Gs, Gs, Gs, Rp, Gs, Gg, Gg, Gll, Gg, Ww, Ww, Ww, Ww, Gll, Ww, Gs^Fms, Gs^Fms, Gg, Gs, Gs^Es, Ds, Ww, Ww, Wo, Wo, Wo^Bsb/, Wo^Bsb/, Ww, Gs^Fms, Ww, Ww, Wo, Ww, Wo, Wo, Ww, Ww, Rrc, Ww, Kvr, Ww, Ww, Wo, Wo, Wo, Wo, Wo, Wo, Wo, Ww, Ww, Mm, Mm^Xm, Mm^Xm, Mm, Mm, Hh^Fms, Hh, Gll, Gs^Fms, Gs^Fms, Gg, Gg
Gg, Gg, Gs^Fms, Gs^Fms, Gs^Fms, Gs^Fms, Gll^Em, Gs^Fms, Gs^Fms, Gs^Fms, Gs^Fms, Gs, Gs, Gg, Rp, Gg, Gs^Fms, Gs^Fms, Gs^Fms, Gs^Fms, Ww, Ww, Gs^Fms, Gs^Fms, Gll, Gll, Gs^Fms, Gll, Gs, Gg^Es, Gg, Cvr, 4 Kvr, Ww, Ww^Bsb/, Wo^Bsb/, Wo, Wo, Wo, Ww, Wo, Wo, Wo, Wo, Wo, Wo, Ww, Ww, Rrc, Rrc, Rrc, Rrc, Rrc, Ww, Ww, Wo, Wo, Wo, Wo, Ww, Ww, Ww, Mm, Mm, Mm, Mm^Xm, Mm, Hh^Fms, Hh^Fms, Gs^Fms, Gll, Gll, Gs^Fms, Gg
Gg, Gll, Gs^Fms, Gs^Fms, Gll^Em, Gll, Gs^Fms, Gll, Ww, Gs^Fms, Gs^Fms, Gs^Fms, Gll, Gg, Rp, Gll, Gs^Fms, Gll, Gs^Fms, Gll, Ww, Ww, Gs, Gll, Gs^Fms, Gs^Fms, Gs, Gs, Gg, Gg, Kvr, Cvr, Rp, Ww^Bsb/, Ww, Wo, Wo, Wo, Wo, Wo, Wo, Wo, Wo, Wo, Ww, Ww, Gd^Fetd, Kvr, Cvr, Cvr, Kvr, Cvr, Cvr, Kvr, Ww, Ww, Wo, Wo, Wo, Ww, Ww, Mm, Mm, Mm, Mm^Xm, Mm, Mm, Hh, Hh^Fms, Hh, Gll^Em, Gll, Gs^Fms, Gg
Gs^Fms, Gll, Gs^Fms, Gs^Fms, Gs^Fms, Gll, Ww, Ww, Ww, Ww, Ww, Gs^Fms, Gg, Gg, Ww^Bsb|, Gg, Ww, Gs^Fms, Ww, Ww, Ww, Ww, Gg, Gs, Gg, Gg, Gg, Gg^Es, Gg, Gg, Rp, Rp^Cov, Kvr, Ww, Ww, Wo, Ww, Wo, Wo, Wo, Wo, Wo, Wo, Wo, Ww, Ww, Ww, Gd^Fetd, Kvr, Rp^Vhcr, Gd^Fetd, Rp^Vhcr, Kvr, Gd^Fetd, Gd^Fetd, Ww, Wo, Wo, Wo, Ww, Ww, Mm, Mm^Xm, Mm, Mm, Mm, Mm, Hh, Hh^Fms, Hh, Gll, Gs^Fms, Gll, Gg
Gg, Gs^Fms, Gs^Fms, Gs^Fms, Ww, Ww, Ww, Ww, Gg, Ww, Ww, Ww, Ww, Ww, Ww^Bsb|, Ww, Ww, Ww, Ww, Ww, Ww, Gg, Gg, Gg, Gs, Gg^Es, Gs, Gs, Rp, Rp, Kvr, Cvr, Cvr, Ds, Ds, Ww, Ww, Ww, Ww, Wo, Wo, Wo, Wo, Wo, Wo, Ww, Ww, Gd^Fetd, Cvr, Rp^Vhcr, 2 Kvr, Rp^Vhcr, Cvr, Gd^Fetd, Gd^Fetd, Ww, Wo, Wo, Wo, Ww, Ww, Mm, Mm, Mm^Xm, Mm^Xm, Mm, Mm, Hh, Hh^Fms, Hh^Fms, Gs^Fms, Gs^Fms, Gll, Gg
Ww, Gll, Ww, Ww, Ww, Ww, Re, Gg, Rb^Wm, Gg, Gg, Ww, Ww, Ww, Rp, Ww, Gg, Ww, Gg, Ww, Gs, Gs, Gs, Gg, Gg, Gg, Rp, Rp, Gs, Gll, Gs^Fms, Gs^Fms, Gs^Fms, Gll, Gs^Fms, Gs^Fms, Gs^Fms, Ww, Ww, Ww, Wo, Wo, Wo, Wo, Wo, Ww, Ww, Kvr, Gd^Fetd, Cvr, Gd^Fetd, Cvr, Gd^Fetd, Kvr, Ww, Ww, Ww, Wo, Wo, Ww, Ww, Ww, Mm, Mm, Mm, Mm, Mm, Hh^Fms, Hh, Hh, Gs^Fms, Gs^Fms, Gs^Fms, Gg
Ww, Ww, Ww, Ww, Gg, Gg, Rb^Gvs, Rb^Gvs, Rb^Gvs, Rb^Gvs, Rb^Gvs, Gg, Gg, Gg, Rp, Gg, Rp, Gg, Gg^Efm, Gg^Efm, Gs^Fms, Gs^Fms, Gs^Fms, Gs, Gg, Rp, Gg, Gg, Gs, Gs^Fms, Gs^Fms, Gs^Fms, Gll, Gll, Gs^Fms, Gs^Fms, Hh^Fms, Gll^Vc, Ds, Ww, Ww, Wo, Wo, Wo, Wo, Wo, Ww, Ww, Ww, Gd^Fetd, Ww, Gd^Fetd, Ww, Ww, Ww, Ww, Wo, Wo, Ww, Ww, Ww, Mm, Mm, Mm^Xm, Mm^Xm, Mm, Hh, Hh, Hh^Fms, Gll, Gs^Fms, Gll, Gll, Gg
Gg, Ww, Gg, Gg, Gs^Vh, Gg, Re, Rb^Gvs, Gs^Vh, Rb^Gvs, Re, Gg, Gs^Vh, Gg, Gg, Rp, Gg, Rp, Gg, Gs, Gs^Fms, Gs^Fms, Gs^Fms, Gs, Gs, Rp, Gs, Gg, Gs, Gs^Fms, Gll, Gs^Fms, Gll, Gs^Fms, Hh^Fms, Hh^Fms, Hh, Hh^Fms, Ds, Ww, Ww, Wo, Wo, Wo, Wo, Wo, Wo, Wo, Wo, Wwr, Wo, Ww, Ww, Wo, Ww, Wo, Ww, Ww, Ww, Ww, Mm, Mm^Xm, Mm^Xm, Mm, Mm, Mm^Xm, Mm, Hh^Fms, Hh, Gs^Fms, Gll^Em, Gs^Fms, Gs^Fms, Gll
Gg^Em, Gg, Rb^Gvs, Rb^Gvs, Rb^Gvs, Rb^Gvs, Rb^Gvs, Gg, Re, Re, Rb^Gvs, Rb^Gvs, Rb^Gvs, Rb^Gvs, Rb^Gvs, Gg, Gg, Rp, Gs, Gs^Fms, Gs^Fms, Gs^Fms, Gs, Gg, Rp, Rp, Gs, Gs, Gg^Es, Gll, Gll, Gs^Fms, Gs^Fms, Gs^Fms, Hh, Hh^Fms, Mm, Hh^Fms, Mm, Ww, Ww, Ww, Ww, Ww, Ww, Ww, Ww, Ww, Ww, Wwr, Ww, Ww, Ww, Ww, Ww, Ww, Mm^Xm, Ww, Mm, Mm^Xm, Mm, Mm^Xm, Mm, Mm^Xm, Mm, Mm, Mm, Hh^Fms, Hh, Hh, Gs^Fms, Gll, Gll, Gs^Fms
Gg, Gg, Gg, Rb^Gvs, Rb^Gvs, Rb^Gvs, Gg, Re, Gs^Vh, Gg, Re, Rb^Gvs, Rb^Gvs, Rb^Gvs, Gg, Gg, Rp, Rp, Gs^Fms, Gs^Fms, Gs^Fms, Gs^Fms, Gs, Gg, Rp, Gg, Gg, Gg, Gg^Es, Gll, Gs^Fms, Gll, Hh, Gll, Hh, Hh^Fms, Hh^Fms, Mm^Xm, Mm^Xm, Ww, Ww, Ww, Ww, Ww, Mm, Ww, Mm, Ww, Mm^Xm, Wwr, Wwr, Ww, Mm, Ww, Mm, Mm, Mm, Mm^Xm, Mm^Xm, Mm^Xm, Mm, Mm, Mm, Mm, Mm, Mm, Hh, Hh^Fms, Hh, Hh, Gll, Gs^Fms, Gs^Fms, Gs^Fms
Gs, Gs, Gs, Gg, Gs, Gg^Em, Rb^Gvs, Rb^Gvs, Rb^Gvs, Rb^Gvs, Rb^Gvs, Gg, Gg, Gg, Rp, Rp, Gg, Gs, Gs^Fms, Gs^Fms, Gs, Gs, Rp, Rp, Gg, Gs, Gg, Gg, Gs, Gs^Fms, Gs^Fms, Hh^Fms, Hh^Fms, Hh^Fms, Hh^Fms, Hh^Fms, Mm, Mm, Mm, Mm^Xm, Mm^Xm, Mm, Mm, Mm, Mm, Mm, Mm^Xm, Mm^Xm, Mm, Mm, Hh, Ww, Mm, Mm, Mm^Xm, Mm^Xm, Mm^Xm, Mm^Xm, Mm, Mm, Mm, Mm, Mm, Mm, Mm, Mm, Hh, Hh^Fms, Hh^Fms, Hh, Gll, Gll, Gs^Fms, Gg
Gs^Fms, Gs^Fms, Gs^Fms, Gg, Gg, Gg, Gg, Rb^Gvs, Rb^Gvs, Rb^Gvs, Gg, Gg, Rp, Rp, Gs, Rp, Rp, Gs, Rp, Gg, Rp, Rp, Gg, Gg, Rb^Gvs, Rb^Gvs, Rb^Gvs, Gg, Gs, Gs^Fms, Hh, Hh^Fms, Hh^Fms, Hh, Hh^Fms, Hh, Hh, Mm, Hh, Mm, Mm^Xm, Mm^Xm, Mm^Xm, Mm, Mm^Xm, Mm^Xm, Mm, Mm, Hh, Hh, Mm^Xm, Mm, Mm^Xm, Mm^Xm, Mm^Xm, Mm, Mm, Mm, Mm, Mm, Mm, Mm, Hh, Mm, Hh^Fms, Hh, Hh^Fms, Hh^Fms, Hh, Gs^Fms, Gs^Fms, Gs^Fms, Gll, Gg
Hh^Fms, Gll, Gs^Fms, Gs, Gg^Efm, Gs^Es, Gs^Es, Gg, Gg, Gg, Rp, Rp, Gg, Gs, Rb^Gvs, Gg, Gs, Rp, Gg^Es, Rp, Gg, Gg, Gg, Gs^Vh, Rb^Gvs, Rb^Gvs, Rb^Gvs, Rb^Gvs, Gg, Gs, Gs^Fms, Hh, Hh^Fms, Hh^Fms, Hh^Fms, Hh^Fms, Hh, Hh, Hh, Mm, Mm, Mm, Mm^Xm, Mm, Mm^Xm, Mm^Xm, Mm, Mm, Hh, Mm, Mm, Mm^Xm, Mm^Xm, Mm, Mm, Mm, Mm, Hh, Hh^Fms, Hh, Hh^Fms, Hh^Fms, Hh^Fms, Hh^Fms, Hh, Hh^Fms, Hh, Hh, Gll, Gll, Gll, Gs^Fms, Gll, Gg
Hh^Fms, Hh^Fms, Gs^Fms, Gll, Gg^Efm, Gs, Gs, Gg, Rp, Rp, Gg, Gg, Rb^Gvs, Rb^Gvs, Rb^Gvs, Rb^Gvs, Rb^Wm, Gg, Gg^Es, Gs, Rb^Gvs, Rb^Gvs, Rb^Gvs, Re, Gg, Rb^Wm, Gg, Gg, Gg, Gs, Gs^Fms, Gs^Fms, Gll, Hh, Hh, Hh^Fms, Hh^Fms, Hh^Fms, Hh^Fms, Hh^Fms, Hh^Fms, Mm, Mm, Mm^Xm, Mm, Mm, Mm, Mm^Xm, Hh, Mm, Mm, Mm, Mm, Mm, Mm, Mm, Hh, Hh, Hh^Fms, Hh, Hh, Hh, Hh^Fms, Hh^Fms, Hh^Fms, Hh^Fms, Hh, Gs^Fms, Gs^Fms, Gs^Em, Gll, Gs^Fms, Gll, Gg
Hh, Hh^Fms, Gs^Fms, Gs^Fms, Gg, Gs, Gg, Rp, Gg, Re, Rb^Gvs, Rb^Gvs, Rb^Gvs, Rb^Gvs, Rb^Gvs, Rb^Gvs, Gg, Gg, Gg, Gs^Vh, Rb^Gvs, Rb^Gvs, Rb^Gvs, Rb^Gvs, Gg, Gg, Gs, Gg, Gll, Gll, Gll, Gs^Fms, Gs^Fms, Gll, Gs^Fms, Hh^Fms, Hh^Fms, Hh^Fms, Hh^Fms, Hh, Hh, Hh, Hh, Hh^Fms, Hh^Fms, Hh, Hh^Fms, Mm, Hh, Mm, Hh, Mm, Hh^Fms, Hh, Hh^Fms, Hh^Fms, Hh^Fms, Hh^Fms, Hh^Fms, Hh^Fms, Hh^Fms, Hh, Gll, Hh, Hh, Hh, Gll, Gll, Gs^Fms, Gs^Fms, Gs^Fms, Gs^Fms, Gs^Fms, Gg
Hh^Fms, Hh, Gs^Fms, Gs, Gs, Gs, Gg, Rp, Gg, Gs^Vh, Rb^Gvs, Rb^Gvs, Rb^Gvs, Rb^Gvs, Gg, Re, Rb^Gvs, Rb^Gvs, Rb^Gvs, Gg, Re, Rb^Gvs, Gg, Gg, Gs^Es, Gs, Gs^Fms, Gs^Fms, Gs^Fms, Gll, Gll, Gll, Gll, Gs^Fms, Gll, Gs^Fms, Gs^Fms, Hh, Gs^Fms, Hh, Hh^Fms, Hh^Fms, Gs^Fms, Hh^Fms, Hh^Fms, Hh^Fms, Hh^Fms, Hh, Hh, Hh^Fms, Hh^Fms, Hh^Fms, Hh, Hh^Fms, Hh, Hh^Fms, Hh, Hh, Gll, Hh, Gs^Fms, Gs^Fms, Gs^Fms, Gs^Fms, Gll, Gll, Gs^Fms, Gs^Fms, Gs^Fms, Gs^Fms, Gll, Gll, Gs^Fms, Gg
Gs^Fms, Gs^Fms, Gs, Gg^Es, Gg, Gg^Es, Rp, Rp, Rp, Gg, Gg, Rb^Gvs, Gg^Es, Gg, Gs^Vh, Rb^Gvs, Rb^Gvs, Rb^Gvs, Rb^Gvs, Rb^Wm, Gg, Gg, Gg, Gg^Es, Gs, Gs^Fms, Gll, Gll^Em, Gll, Gs^Fms, Gs^Fms, Gll, Gll, Gll, Gs^Fms, Gll, Gs^Fms, Gll, Gll, Gs^Fms, Gs^Fms, Gll, Gll^Em, Gll, Gs^Fms, Gs^Fms, Gll, Hh, Gll, Hh, Gs^Fms, Hh^Fms, Gll, Gll^Em, Gll, Gll, Gll, Gs^Fms, Gs^Fms, Gs^Fms, Gs^Fms, Gll, Gs^Fms, Gs^Fms, Gll^Em, Gs^Fms, Gs^Fms, Gll, Gs^Fms, Gll, Gs^Fms, Gll, Gll, Gg
Gs, Gg, Gg, Gg, Rp, Rp, Gs^Fms, Gs, Gs^Fms, Rp, Rp, Gg, Gg, Gg, Gg, Rb^Gvs, Rb^Gvs, Rb^Gvs, Re, Gg, Rb^Gvs, Gs^Vh, Rb^Gvs, Gg, Gs, Gs^Fms, Gs^Fms, Gs^Fms, Gs^Fms, Gll^Em, Gs^Fms, Gs^Fms, Gs^Fms, Gs^Fms, Gs, Gll, Gs, Gll, Gs^Fms, Gll, Gll, Gll, Gll, Gll, Gll, Gll, Gll, Gll, Gll, Gs^Fms, Gll, Gs^Fms, Gll, Gs, Gs^Fms, Gs^Fms, Gs^Fms, Gs^Fms, Gll, Gs^Fms, Gll, Gs^Fms, Gll, Gll, Gs^Fms, Gs^Fms, Gll, Gs^Fms, Gll, Gll, Gs^Fms, Gs^Fms, Gs, Gg
Gg, Gg, Gg, Rp, Gg, Gs, Gs^Fms, Gs^Fms, Gs^Fms, Gs, Gg, Rp, Rp, Gg, Gg, Gg, Gg, Gg, Rb^Gvs, Rb^Gvs, Rb^Gvs, Rb^Gvs, Rb^Gvs, Rb^Gvs, Gs^Fms, Gs^Fms, Gll, Gll, Gs^Fms, Gs^Fms, Gll, Gs^Fms, Gll, Gs^Fms, Gs, Gll, Gs^Fms, Gll, Gll, Gll, Gs^Fms, Gll, Gs^Fms, Gll, Gll, Gll, Gll, Gll, Gs^Fms, Gs^Fms, Gs^Fms, Gs^Fms, Gs^Fms, Gs^Fms, Gll, Gll, Gs^Fms, Gll, Gs^Fms, Gs^Fms, Gs^Fms, Gs^Fms, Gs^Fms, Gs^Fms, Gll, Gs^Fms, Gll, Gs^Fms, Gs^Fms, Gll, Gll, Gs^Fms, Gs, Gg
