Ur, Xoa, Xoa, Xoa, Xoa, Xoa, Xoa, Xoa, Xoa, Xoa, Xoa, Xoa, Ur
Ur, Xoa, Xoa, Xoa, Ur^Eb, Xoa, Ur, Xoa, Ur^Eb, Xoa, Xoa, Xoa, Ur
Ur, Xoa, Xoa, Xoa, Xoa, Ur, Ur, Ur, Xoa, Xoa, Xoa, Xoa, Ur
Ur, Xoa, Xoa, Xoa, Xoa, Xoa, Ur, Xoa, Xoa, Xoa, Xoa, Xoa, Ur
Ur, Xoa, Ur, Ur, Ur, Ur, Urc, Ur, Ur, Ur, Ur, Xoa, Ur
Ur, Xoa, Xoa, Ur, Xoa, Ur, Urc, Ur, Xoa, Ur, Xoa, Xoa, Ur
Ur, Xoa, Xoa, Xoa, Xoa, Ur, Urc, Ur, Xoa, Xoa, Xoa, Xoa, Ur
Ur, Xoa, Ur, Ur, Ur, Ur, Urc, Ur, Ur, Ur, Ur, Xoa, Ur
Ur, Xoa, Xoa, Ur, Xoa, Ur, Urc, Ur, Xoa, Ur, Xoa, Xoa, Ur
Ur, Xoa, Xoa, Xoa, Xoa, Ur, Urc, Ur, Xoa, Xoa, Xoa, Xoa, Ur
Ur, Xoa, Ur, Ur, Ur, Ur, Urc, Ur, Ur, Ur, Ur, Xoa, Ur
Ur, Xoa, Xoa, Ur, Xoa, Ur, Urc, Ur, Xoa, Ur, Xoa, Xoa, Ur
Ur, Xoa, Xoa, Xoa, Xoa, Ur, Urc, Ur, Xoa, Xoa, Xoa, Xoa, Ur
Ur, Xoa, Ur, Ur, Ur, Ur, Urc, Ur, Ur, Ur, Ur, Xoa, Ur
Ur, Xoa, Xoa, Ur, Xoa, Ur, Urc, Ur, Xoa, Ur, Xoa, Xoa, Ur
Ur, Xoa, Ur, Xoa, Xoa, Ur, Urc, Ur, Xoa, Xoa, Ur, Xoa, Ur
Ur, Xoa, Xoa, Ur, Xoa, Ur, Urc, 1 Ur, Xoa, Ur, Xoa, Xoa, Ur
Ur, Xoa, Ur, Xoa, Xoa, Ur, Urc, Ur, Xoa, Xoa, Ur, Xoa, Ur
