Xos, Xos, Xos, Xos, Xos, Xos, Xos, Xos, Xos, Xos, Xos, Xos, Xos, Xos, Xos, Xos, Xos, Xos, Xos, Xos, Xos, Xos, Xos, Uu^Ii, Urb^Ii, Urb^Ii, Uu^Ii, Uu^Ii, Urb^Ii, Ur^Ii, Xos, Xos, Xos, Xos, Xos, Xos, Xos, Xos, Xos, Xos, Xos, Xos, Xos, Xos, Xos, Xos, Xos, Xos, Xos, Xos
Xos, Xos, Xos, Xos, Xos, Xos, Xos, Xos, Xos, Xos, Xos, Xos, Xos, Xos, Xos, Xos, Xos, Xos, Xos, Xos, Xos, Xos, Xos, Uu^Ii, Urb, Urb, Uu, Urb, Urb, Ur^Ii, Xos, Xos, Xos, Xos, Xos, Xos, Xos, Xos, Xos, Xos, Xos, Xos, Xos, Xos, Xos, Xos, Xos, Xos, Xos, Xos
Xos, Xos, Xos, Xos, Xos, Xos, Xos, Xos, Xos, Xos, Xos, Xos, Xos, Xos, Xos, Xos, Xos, Xos, Xos, Xos, Xos, Xos, Xos, Ur, Urb, Urb, Uu, Urb, Urb, Uu, Xos, Xos, Xos, Xos, Xos, Xos, Xos, Xos, Xos, Xos, Xos, Xos, Xos, Xos, Xos, Xos, Xos, Xos, Xos, Xos
Xos, Xos, Xos, Xos, Xos, Xos, Xos, Xos, Xos, Xos, Xos, Xos, Xos, Xos, Xos, Xos, Xos, Xos, Xos, Xos, Xos, Xos, Xos, Uu^Vud, Urb, Urb, Cud, Urb, Urb, Uu^Vud, Xos, Xos, Xos, Xos, Xos, Xos, Xos, Xos, Xos, Xos, Xos, Xos, Xos, Xos, Xos, Xos, Xos, Xos, Xos, Xos
Xos, Xos, Xos, Xos, Xos, Xos, Xos, Xos, Xos, Xos, Xos, Xos, Xos, Xos, Xos, Xos, Xos, Xos, Xos, Xos, Xos, Xos, Xos, Cud, Urb, Urb, Kud, Urb, Urb, Cud, Xos, Xos, Xos, Xos, Xos, Xos, Xos, Xos, Xos, Xos, Xos, Xos, Xos, Xos, Xos, Xos, Xos, Xos, Xos, Xos
Xos, Xos, Xos, Xos, Xos, Xos, Xos, Xos, Xos, Xos, Xos, Xos, Xos, Xos, Xos, Xos, Xos, Xos, Xos, Xos, Xos, Xos, Cud, Cud, Urb^Cov, Urb, Cud, Urb, Urb^Cov, Cud, Cud, Xos, Xos, Xos, Xos, Xos, Xos, Xos, Xos, Xos, Xos, Xos, Xos, Xos, Xos, Xos, Xos, Xos, Uu^Br/, Uu^Br/
Xos, Xos, Xos, Xos, Xos, Xos, Xos, Xos, Xos, Xos, Xos, Xos, Xos, Xos, Xos, Xos, Xos, Xos, Xos, Xos, Kud^Ii, Tb^Tf, Uu, Uu, Urb, Urb^Cov, Uu, Urb^Cov, Urb, Uu, Uu, Tb^Tf, Kud^Ii, Xos, Xos, Xos, Xos, Xos, Xos, Xos, Xos, Xos, Xos, Xos, Xos, Xos, Uu^Br/, Uu^Br/, Xos, Xos
Xos, Xos, Xos, Xos, Xos, Xos, Xos, Xos, Xos, Xos, Xos, Xos, Xos, Xos, Xos, Xos, Xos, Xos, Xos, Xos, Uh, Uu, Uu, Ur^Efs, Uu, Urb, Uu, Urb, Ur, Uu^Efs, Ur, Uu, Uh, Xos, Xos, Xos, Xos, Xos, Xos, Xos, Xos, Xos, Xos, Xos, Uu^Br/, Uu^Br/, Xos, Xos, Xos, Xos
Uu^Br\, Xos, Xos, Xos, Xos, Xos, Xos, Xos, Xos, Xos, Xos, Xos, Xos, Xos, Xos, Xos, Xos, Xos, Xos, Xos, Uh, Ur, Ur, Uu, Uu, Urb, Uu, Urb, Uu, Ur, Uu, Ur, Tb^Tf, Xos, Xos, Xos, Xos, Xos, Xos, Xos, Xos, Xos, Uu^Br/, Uu^Br/, Xos, Xos, Xos, Xos, Xos, Xos
Xos, Uu^Br\, Uu^Br\, Xos, Xos, Xos, Xos, Xos, Xos, Xos, Xos, Xos, Xos, Xos, Uh, Uh, Uh, Uu, Uu, Uh, Kud, Uu, Uu^Vud, Ur, Ur^Efs, Urb, Uu, Urb, Uu^Efs, Uu, Kud, Cud, Qxu, Uh, Uu, Uu^Vud, Uu, Uh, Uh, Xos, Uu^Br/, Uu^Br/, Xos, Xos, Xos, Xos, Xos, Xos, Xos, Xos
Xos, Xos, Xos, Uu^Br\, Uu^Br\, Xos, Xos, Xos, Xos, Xos, Xos, Xos, Uh, Uu^Vud, Uu, Uh, Uu, Uu, Uu, Cud, Uh, Cud, Uu, Ur, Uu, Urb, Uh, Urb, Uu, Ur, Cud, Qxu, Qxu, Qxu, Tb^Tf, Ur, Ur, Ur, Uu^Br/, Uu^Br/, Xos, Xos, Xos, Xos, Xos, Xos, Xos, Xos, Xos, Xos
Xos, Xos, Xos, Xos, Xos, Uu^Br\, Uu^Br\, Xos, Xos, Xos, Xos, Uh, Uh, Ur, Uu, Uu^Es, Uu, Ur, Uu, Cud, Uu, Cud, Uu, Tb^Tf, Uu, Urb, Tb^Tf, Urb, Uu, Ur, Uu, Qxu, Qxu, Qxu, Tb^Tf, Ur, Uu^Br/, Uu^Br/, Uu, Uh, Xos, Xos, Xos, Xos, Xos, Xos, Xos, Xos, Xos, Xos
Xos, Xos, Xos, Xos, Xos, Xos, Xos, Uu^Br\, Uu^Br\, Xos, Xos, Xos, Ur, Ur, Ur, Uu^Es, Ur^Es, Ur, Ur, Uu, Ur, Uu, Uu, Ur, Uu^Efs, Urb, Uu^Vud, Urb, Ur^Efs, Ur, Ur, Ur, Uu, Tb^Tf, Ur, Uu, Uu^Br|, Uu, Ur, Uh, Uh, Xos, Xos, Xos, Xos, Xos, Xos, Xos, Xos, Xos
Xos, Xos, Xos, Xos, Xos, Xos, Xos, Xos, Xos, Uu^Br\, Uu^Br\, Xos, Uu, Uu, Uu, Uu^Es, Uh, Uh, Uu, Uu, Ur, Uu, Ur, Uu, Uu, Urb, Uu, Urb, Ur, Uu, Uh, Uh, Uh^Vud, Ur, Uu, Uu, Qxu^Br|, Uu, Tb^Tf, Ur, Uu, Ur, Uu, Xos, Xos, Xos, Xos, Xos, Xos, Xos
Xos, Xos, Xos, Xos, Xos, Xos, Xos, Xos, Xos, Xos, Xos, Uu^Br\, Uu^Br\, Uu, Uu, Uu, Ur, Uh^Vud, Ur, Uu, Ur, Ur, Uu, Uu, Ur^Efs, Urb, Tb^Tf, Urb, Uu^Efs, Uu, Ur, Ur, Uu, Uu, Qxu, Qxu, Qxu^Br|, Qxu, Qxu, Uu, Uu, Uu, Ur, Uu, Xos, Xos, Xos, Xos, Xos, Xos
Xos, Xos, Xos, Xos, Xos, Xos, Xos, Xos, Xos, Xos, Xos, Uu, Uu, Uu^Br\, Uu^Br\, Uu, Uu, Ur, Uu, Ur, Uu, Uu, Ur, Uu, Urb, Urb, Urb, Urb, Urb, Uu, Ur, Tb^Tf, Uu, Ur, Uu, Tb^Tf, Uu^Br|, Qxu, Qxu, Ur, Uu, Ur, Ur, Uu, Uh, Xos, Xos, Xos, Xos, Xos
Xos, Xos, Xos, Xos, Xos, Xos, Xos, Xos, Xos, Xos, Uu, Uu, Ur, Uu, Uh, Uu^Br\, Uu^Br\, Uu, Ur, Uu, Uu^Efs, Ur, Urb, Urb, Tb^Tf, Uu^Efs, Urb, Uu^Efs, Tb^Tf, Urb, Urb, Ur, Uu^Efs, Uu, Ur, Uu, Uu^Br|, Uh, Qxu, Qxu, Uu, Uu, Uh, Uu, Uu, Xos, Xos, Xos, Xos, Xos
Xos, Xos, Xos, Xos, Xos, Xos, Xos, Xos, Xos, Xos, Uu, Ur, Uu^Vud, Ur, Uu, Uh, Uu^Br|, Uu, Ur, Ur, Uu, Urb, Uh, Uh, Urb, Urb, Qxu^Ii, Urb, Urb, Tb^Tf, Uu^Vud, Urb, Uu, Uu, Ur, Uu, Uu^Br|, Uu, Uu, Uu, Ur, Uh^Vud, Uh, Ur, Uu, Xos, Xos, Xos, Xos, Xos
Xos, Xos, Xos, Xos, Xos, Xos, Xos, Xos, Xos, Xos, Uu, Uu, Uu, Ur, Ur, Uh, Uu^Br|, Uu, Ur, Uu, Uu^Efs, Urb, Uu, Urb, Qxu^Ii, Qxu^Ii, Tb^Tf, Qxu^Ii, Qxu^Ii, Urb, Uu, Urb, Uu^Efs, Ur, Uu, Uu^Br/, Kud, Uu^Br\, Uu^Br\, Uu, Ur, Ur, Uu, Uu, Uu, Ur, Uu, Xos, Xos, Xos
Xos, Xos, Xos, Xos, Xos, Xos, Xos, Xos, Xos, Uh, Uh, Uu, Uu, Ur, Tb^Tf, Uu, Uu^Br|, Uu, Ur, Uh^Vud, Ur, Urb, Uu^Efs, Urb, Qxu^Ii, Wwg, Xu, Tb^Tf, Qxu^Ii, Urb, Uu^Efs, Urb, Uu, Uu, Uu, Uu^Br|, Cud, Cud, Uu, Uu^Br\, Uu^Br\, Uu, Tb^Tf, Tb^Tf, Ur, Ur, Uu, Xos, Xos, Xos
Xos, Xos, Xos, Xos, Xos, Xos, Xos, Xos, Uh, Uh, Uu, Uu, Ur, Ur, Tb^Tf, Tb^Tf, Uu^Br|, Uu, Uu, Ur, Uu, Urb, Uu, Urb, Qxu^Ii, Tb^Tf, Wwg, Wwg, Qxu^Ii, Urb, Uh, Urb, Uu, Ur, Uu^Br/, Uu^Br|, Uu, Qxu, Qxu, Uu, Uu^Br|, Uu, Ur, Tb^Tf, Ur, Uu, Uu, Xos, Xos, Xos
Xos, Xos, Xos, Xos, Xos, Xos, Xos, Xos, Uh, Ur, Uu, Uu, Uu, Uu, Uu, Uu, Uu^Br|, Uu, Uu, Ur, Uu, Urb, Uh, Urb, Urb, Qxu^Ii, Qxu^Ii, Qxu^Ii, Urb, Urb, Tb^Tf, Urb, Urb^Br/, Uu^Br/, Uu, Ur, Ur, Qxu, Qxu, Tb^Tf, Uu^Br|, Uu, Uu, Uu, Ur, Uu, Uu, Xos, Xos, Xos
Xos, Xos, Xos, Xos, Xos, Xos, Xos, Xos, Uu, Ur, Ur, Ur, Ur, Uu, Uu, Cud, Uu^Br\, Cud, Uu, Uu, Ur^Efs, Urb, Urb, Tb^Tf, Uu, Urb, Urb, Urb, Uu, Uh, Urb, Urb^Br/, Urb, Urb, Urb, Tb^Tf, Qxu, Qxu, Qxu, Qxu, Uu^Br|, Uu, Uu, Ur, Uh, Uh^Vud, Uh, Uh, Xos, Xos
Xos, Xos, Xos, Xos, Xos, Xos, Xos, Uu, Tb^Tf, Tb^Tf, Ur, Uh, Uu, Uu, Uu^Br/, Uu^Br/, Cud, Uu^Br\, Uu^Br\, Uu, Uu, Ur, Uu^Vud, Urb, Urb, Uu^Efs, Urb, Uu^Efs, Urb, Urb, Uu, Ur^Br|, Tb^Tf, Urb, Qxu^Bcx\, Qxu^Bcx\, Qxu^Bcx\, Qxu, Ur, Ur, Uu^Br|, Cud, Cud, Uu, Uh, Uh, Xos, Xos, Xos, Xos
Xos, Xos, Xos, Xos, Xos, Xos, Xos, Uu, Ur, Tb^Tf, Uu, Uh, Uu^Br/, Uu^Br/, Uu, Uu, Kud, Uu, Uu, Uu^Br\, Uu^Br\, Ur, Uu, Uu, Uu^Efs, Urb, Uu, Urb, Uu^Efs, Uu, Uu, Uu^Br|, Uh, Qxu, Qxu, Qxu^Bcx\, Urb, Urb, Urb, Tb^Tf, Uu^Br\, Cud, Xos, Xos, Xos, Xos, Xos, Xos, Xos, Xos
Xos, Xos, Xos, Xos, Xos, Xos, Tb^Tf, Uh, Uu, Uu, Uu^Br/, Uu^Br/, Uu, Uu, Uh, Uu, Uu, Uu, Uu, Ur, Ur, Uu^Br\, Uu^Br\, Uu, Uu, Urb, Uu, Urb, Uu, Uu, Uu^Vud, Uu^Br|, Uu, Qxu, Qxu, Uu^Efs, Ur, Urb, Urb, Urb, Urb, Uu^Br\, Uu^Br\, Xos, Xos, Xos, Xos, Xos, Xos, Xos
Xos, Xos, Xos, Xos, Xos, Xos, Uh, Uu, Uu^Br/, Uu^Br/, Uu, Uu, Uu^Vud, Uu, Uu, Uh, Uu, Uu, Ur, Uu, Uu, Uu, Uu, Uu^Br\, Uu^Br\, Urb, Uu, Urb, Uu, Uu, Uu^Br/, Uu^Br/, Ur, Ur, Uu, Uu, Uu^Vud, Uu, Uu, Urb, Urb, Urb, Urb, Uu^Br\, Uu^Br\, Xos, Xos, Xos, Xos, Xos
Xos, Xos, Xos, Xos, Xos, Xos, Uu^Br/, Uu^Br/, Cud, Cud, Uu, Uu, Ur, Ur, Ur, Uh, Ur, Uu, Uu, Ur, Uu, Uu, Uu, Uu, Uu^Br|, Urb, Uu, Urb, Uu^Br/, Uu^Br/, Uu, Uu, Uu, Uu, Ur, Uu, Uu, Uu, Uu, Uu, Cud, Urb, Urb, Urb, Urb, Uu^Br\, Uu^Br\, Xos, Xos, Xos
Xos, Xos, Xos, Xos, Uu^Br/, Uu^Br/, Xos, Tb^Tf, Cud, Urb, Urb, Ur, Cud, Ur, Uu, Uu, Ur, Uu, Ur, Uu, Uu, Uu, Cud, Uu, Uu^Br|, Urb, Uu^Br/, Urb^Br/, Uu^Efs, Uu, Uu, Uu, Cud, Ur, Uu, Uu, Ur, Uu, Uu, Cud, Xos, Uu, Uu, Urb, Urb, Urb, Urb, Uu^Br\, Uu^Br\, Xos
Xos, Xos, Uu^Br/, Uu^Br/, Xos, Xos, Xos, Xos, Xos, Kud, Cud, Cud, Uu, Uu, Uu, Uu, Uu, Uu, Ur, Ur, Tb^Tf, Cud, Uu^Vud, Cud, Uu^Br|, Urb^Br/, Uu, Urb, Urb, Uu, Uu, Cud, Uu^Vud, Cud, Uu, Uu, Ur, Uu, Uu, Cud, Xos, Xos, Xos, Uu^Efs, Tb^Tf, Urb, Urb, 1 Urb, Urb, Uu^Br\
Uu^Br/, Uu^Br/, Uu, Xos, Xos, Xos, Xos, Xos, Xos, Xos, Xos, Tb^Tf, Xos, Uu, Uu, Ur, Ur, Ur, Uu, Uu, Cud, Kud, Cud, Cud, Uu^Br|, Urb, Urb, Uu, Uu, Urb, Uu, Cud, Cud, 2 Kud, Cud, Uu, Uu, Ur, Ur, Tb^Tf, Xos, Xos, Xos, Xos, Xos, Tb^Tf, Uu, Urb, Urb, Urb
Xos, Xos, Xos, Xos, Xos, Xos, Xos, Xos, Xos, Xos, Xos, Xos, Xos, Xos, Xos, Ur, Uu, Uu, Uu, Uu, Cud, Uu, Uu, Uu, Uu^Br|, Uu, Uu^Efs, Urb, Uu, Urb, Uu, Uu, Uu, Uu, Cud, Tb^Tf, Uu, Uu, Tb^Tf, Tb^Tf, Xos, Xos, Xos, Xos, Xos, Xos, Xos, Uu^Efs, Uu, Urb
Xos, Xos, Xos, Xos, Xos, Xos, Xos, Xos, Xos, Xos, Xos, Xos, Xos, Xos, Xos, Xos, Xos, Uu, Xos, Uu, Xos, Uu, Ur, Uu, Uu, Uu^Br\, Uu^Br|, Urb, Uu, Urb, Uu, Uu, Ur, Uu, Uu, Cud, Uu, Uu, Xos, Xos, Xos, Xos, Xos, Xos, Xos, Xos, Xos, Xos, Xos, Uu
Xos, Xos, Xos, Xos, Xos, Xos, Xos, Xos, Xos, Xos, Xos, Xos, Xos, Xos, Xos, Xos, Xos, Xos, Xos, Xos, Xos, Xos, Xos, Uu^Vud, Xos, Uu, Uu^Br|, Urb, Uu, Urb, Uu^Efs, Ur, Xos, Uu^Vud, Xos, Xos, Xos, Xos, Xos, Xos, Xos, Xos, Xos, Xos, Xos, Xos, Xos, Xos, Xos, Xos
Xos, Xos, Xos, Xos, Xos, Xos, Xos, Xos, Xos, Xos, Xos, Xos, Xos, Xos, Xos, Xos, Xos, Xos, Xos, Xos, Xos, Xos, Xos, Xos, Xos, Ur, Uu^Br|, Urb, Uu, Urb, Uu, Uu, Xos, Xos, Xos, Xos, Xos, Xos, Xos, Xos, Xos, Xos, Xos, Xos, Xos, Xos, Xos, Xos, Xos, Xos
Xos, Xos, Xos, Xos, Xos, Xos, Xos, Xos, Xos, Xos, Xos, Xos, Xos, Xos, Xos, Xos, Xos, Xos, Xos, Xos, Xos, Xos, Xos, Xos, Xos, Uu, Uu^Br|, Urb, Uu, Urb, Uu, Uu, Xos, Xos, Xos, Xos, Xos, Xos, Xos, Xos, Xos, Xos, Xos, Xos, Xos, Xos, Xos, Xos, Xos, Xos
Xos, Xos, Xos, Xos, Xos, Xos, Xos, Xos, Xos, Xos, Xos, Xos, Xos, Xos, Xos, Xos, Xos, Xos, Xos, Xos, Xos, Xos, Xos, Xos, Xos, Uu, Uu^Br|, Urb, Uu, Urb, Ur, Ur, Xos, Xos, Xos, Xos, Xos, Xos, Xos, Xos, Xos, Xos, Xos, Xos, Xos, Xos, Xos, Xos, Xos, Xos
Xos, Uu, Uu, Xos, Xos, Xos, Xos, Xos, Xos, Xos, Xos, Xos, Xos, Xos, Xos, Xos, Xos, Xos, Xos, Xos, Xos, Xos, Xos, Xos, Xos, Uu, Uu^Br|, Urb, Uu, Urb, Uu, Uu, Xos, Xos, Xos, Xos, Xos, Xos, Xos, Xos, Xos, Xos, Xos, Xos, Xos, Xos, Xos, Xos, Xos, Xos
