Gg, Gs, Gg, Gs, Gg, Gg, Gs, Gs, Gg, Gg, Gs, Gg, Gg, Gg, Gg, Gg, Gs, Gg, Gs, Gs, Gg, Gg, Gs, Gs^Fms, Gs^Fms, Gs^Fms, Gs^Fms, Hh, Hh, Hh, Gs^Fms, Gs^Fms, Gs^Fms, Gs^Fms, Rp, Rp, Rp, Gg, Gg, Gg, Gg, Gg, Gg, Gg, Gg, Gg, Gg, Gs, Gg, Gg, Gg, Gs, Gg, Gg, Gs, Gs^Fms, Gs^Fms, Gg, Gll, Hh, Hh, Hh, Hh, Hh, Hh^Fms, Hh, Hh
Gs, Gg, Gg, Gg, Gg, Gg, Gg, Gs, Gg, Gs, Gs, Gg, Gg, Gs, Gg, Gg, Gs, Gg, Gg, Gs, Gs, Gg, Gg, Gs, Gs, Gll, Gll, Gs^Fms, Gs^Fms, Gs^Fms, Gs^Fms, Gs^Fms, Rp, Rp, Rp, Rp, Rp, Gg, Gg, Gg, Gs, Gs, Gs, Gg, Gs, Gg, Gg, Gg, Gs, Gg, Gg, Gg, Gg, Gs, Gs, Gs, Gs^Fms, Gs^Fms, Gs^Fms, Gs^Fms, Gs^Fms, Hh^Fms, Hh, Hh, Hh^Fms, Hh, Hh^Fms
Gs, Gg, Gg, Gg, Gg, Gg, Gg, Gg, Gs, Gg, Gs, Gg, Gs, Gg, Gs, Gg, Gs, Gs, Gg, Gs, Gs, Gg, Gg, Gg, Gg, Gs, Gs, Gs^Fms, Gs^Fms, Gs^Fms, Gs, Rp, Rp, Rp, Rp, Rp, Gg, Gg, Gs, Gs, Gs, Gg, Gg, Gg, Ce, Ce, Ce, Ce, Ce, Gs, Gg, Gg, Gg, Gg, Gg, Gs, Gs^Fms, Gll, Gs^Fms, Gs^Fms, Gll, Hh^Fms, Hh, Hh^Fms, Hh, Hh^Fms, Hh
Gs, Gs, Gs, Gs, Gg, Gs, Gs, Gg, Gs, Gg, Gs, Gs, Gs, Gs, Gg, Gs, Gs, Gg, Gg, Gg, Gg, Gg, Gg, Gg, Gg, Gg, Gg, Gs, Gs, Gs, Gg, Rp, Rp, Rp, Gg, Gg, Gg, Gs, Gg, Gg, Gg, Gs, Gs, Gg, Ce, Re^Vct, Ce, 3 Ke, Ce, Gg, Gs, Gg, Gg, Gg, Gg, Gs, Gs^Fms, Gll, Gll, Gs^Fms, Gs^Fms, Gll, Gll, Hh, Gs^Fms, Gll, Gg
Gs, Gs, Gs, Gs, Gg, Gg, Gg, Gg, Gs, Gg, Gg, Gg, Gs, Gg, Gg, Gg, Gs, Gs, Gg, Gg, Gg, Gg, Gs, Gg, Gs, Gg, Gg, Gg, Gs, Gg, Gg, Rp, Rp, Rp, Gg, Gg, Gs, Gg, Gg, Gg, Gg, Gs, Gg, Gg, Gs, Ce, Re^Vct, Ce, Re^Vct, Ce, Gg, Gs, Gs, Gg, Gs, Gs, Gs, Gs^Fms, Gs^Fms, Gll, Gs^Fms, Gs^Fms, Gs^Fms, Gs^Fms, Gs^Fms, Gs^Fms, Gs^Fms
Gg, Gs, Gs, Gg, Gs, Gs, Gs, Gg, Gg, Gs, Gs, Gs, Hh, Hh, Hh, Gg, Gg, Gs, Gg, Gs, Gg, Gg, Gg, Gg, Gs, Gs, Gg, Gs, Gg, Gs, Gg, Rp, Rp, Rp, Gg, Gg, Gs, Gg, Gg, Gs, Gs, Gs, Gs, Gg, Gs, Ce, Ce, Ce, Ce, Ce, Gg, Gg, Gg, Gs, Gs, Gg, Gg, Gs, Gs, Gs, Gs, Gs, Gs, Gll, Gs, Gll, Gs^Fms
Gg, Gg, Gg, Gg, Gs, Gg, Gs, Gg, Hh, Hh, Hh, Hh, Hh^Fms, Hh^Fms, Hh^Fms, Hh, Hh, Gs, Gs, Gg, Gg, Gg, Gg, Gs, Gg, Gs, Gs, Gg, Gg, Gs, Gg, Rp, Rp, Rp, Gg, Gg, Gg, Gs, Gg, Gs, Gs, Gg, Gg, Gg, Gg, Gg, Gg, Gs, Gs, Gs, Gs, Gs, Gs, Gg, Gs, Gs, Gs, Gs, Gs, Gg, Gg, Gg, Gg, Gg, Gg, Gg, Gg
Gg, Gs, Gg, Gs, Gs, Gg, Gs, Gg, Hh, Hh, Hh, Hh, Hh^Fms, Hh^Fms, Hh^Fms, Hh^Fms, Hh^Fms, Hh, Gg, Gs, Gs, Gg, Gs, Gg, Gg, Gg, Gs, Gs, Gs, Gs, Gg, Rp, Rp, Rp, Gg, Gg, Gg, Gs, Gg, Gg, Gg, Gg, Gs, Gs, Gs, Gg, Gs, Gg, Gs, Gg, Gs, Gg, Gg, Gg, Gg, Gg, Gs, Gg, Gg, Gg, Gg, Gg, Gs, Gg, Gg, Gg, Gg
Gg, Gg, Gs, Gg, Gg, Gs, Gs, Gs, Hh, Hh, Hh^Fms, Hh^Fms, Hh^Fms, Hh^Fms, Hh^Fms, Hh^Fms, Hh^Fms, Hh, Hh, Gs, Gg, Gg, Gg, Gg, Gs, Gs, Gs, Gs, Gs, Gg, Gg, Rp, Rp, Rp, Gg, Gg, Gg, Gg, Gs, Gs, Gg, Gg, Gg, Gg, Gg, Gs, Gs, Gg, Gg, Gg, Gg, Gs, Gg, Gg, Gg, Gs, Gs, Gs, Gs, Gg, Gs, Gs, Gs^Fms, Gll, Gs^Fms, Gg, Gg
Gg, Gs, Gs, Gs, Gg, Gg, Hh, Hh, Hh, Hh, Hh^Fms, Hh^Fms, Hh^Fms, Hh^Fms, Hh^Fms, Hh^Fms, Hh^Fms, Hh, Hh, Hh, Gg, Gg, Gg, Gg, Gg, Gs, Gd, Gs, Gs, Gs, Gs, Rp, Rp, Rp, Gg, Gg, Gg, Gg, Gg, Gs, Gs, Gs, Gs, Gg, Gs, Gs, Gg, Gg, Gs, Gg, Gg, Gg, Gg, Gs, Gg, Gg, Gg, Gs, Gg, Gs, Gs^Fms, Gs^Fms, Gs^Fms, Gs^Fms, Gs^Fms, Gg, Gll
Gs, Gs, Gs, Gs, Gg, Gg, Gg, Hh, Hh, Hh^Fms, Hh^Fms, Hh^Fms, Hh^Fms, Hh^Fms, Hh^Fms, Hh^Fms, Hh^Fms, Hh, Hh, Gs, Gg, Gg, Gs, Gg, Gs, Gg, Gd, Gg, Gd, Gs, Gg, Rp, Rp, Rp, Gg, Gg, Gg, Gg, Gs, Gg, Gg, Gs, Gs, Gs, Gs, Gg, Gg, Gg, Gg, Gs, Gg, Gg, Gs, Gg, Gs, Gs, Gg, Gs, Gg, Gll, Gll, Gs^Fms, Gs^Fms, Gll, Gll, Gll, Gg
Gs, Gs, Gg, Gg, Gg, Gg, Gs, Gg, Hh, Hh^Fms, Hh^Fms, Hh^Fms, Hh^Fms, Hh^Fms, Hh^Fms, Hh^Fms, Hh, Hh, Gg, Gs, Gs, Gs, Gg, Gs, Gs, Gs, Gd, Gd^Fetd, Gd, Gg, Gs, Rp, Rp, Rp, Gg, Gg, Gg, Gg, Gs, Gs, Gg, Gs, Gg, Gg, Gs, Gg, Gs, Gs, Gg, Gs, Gs, Gs, Gs, Gg, Gs, Gg, Gs, Gs, Gg, Gg, Gs^Fms, Gll, Gs^Fms, Gll, Gs^Fms, Gs^Fms, Gg
Gg, Gs, Gs, Gg, Gg, Gs, Gg, Gg, Gg, Hh, Hh, Hh^Fms, Hh, Hh^Fms, Hh, Hh^Fms, Hh, Hh, Gg, Gg, Gd, Gg, Gs, Gg, Gs, Gs, Gd^Xff, Gd^Xff, Gd^Xff, Gd, Gd, Rp, Rp, Rp, Gg, Gg, Gd, Gs, Gs, Gs, Gs, Gg, Gg, Gs, Gg, Gg, Gg, Gs, Gs, Gg, Gg, Gg, Gg, Gg, Gg, Gg, Gg, Gs, Gg, Gs, Gs^Fms, Gs^Fms, Gll, Gs^Fms, Gs, Gs, Gg
Gg, Gs, Gs, Gs, Gg, Gg, Gg, Gs, Gs, Gg, Gg, Hh, Ce, Hh, Gs, Hh, Gg, Gg, Gs, Gg, Gd, Gg, Gd, Gs, Gs, Gs, Gd^Xff, Gd^Fetd, Gd^Xff, Gd^Xff, Gd, Rp, Rp, Rp, Gg, Gd, Gd^Fetd, Gd, Gd^Xff, Gs, Gd, Gs, Gs, Gs, Gg, Gg, Gg, Gg, Gg, Gg, Gg, Gs, Gg, Gg, Gg, Gs, Gs, Gg, Gg, Gs, Gs, Gg, Gs, Gs, Gg, Gs, Gg
Gg, Gs, Gs, Gs, Gs, Gg, Gg, Gg, Gg, Gs, Gg, Ce, 5 Ke, Ce, Gg, Gs, Gs, Gs, Gg, Gd, Gg, Rrc^Xfv, Gs, Gd, Gs, Gd, Gd^Fetd, Gd^Fetd, Gd^Xff, Gd^Fetd, Gd, Rp, Rp, Rp, Gd, Gd, Gd^Xff, Gd^Xff, Gd^Fetd, Gd^Fetd, Gd, Gs, Gg, Gs, Gs, Gs, Gd, Gs, Gg, Gg, Gg, Gg, Gs, Gg, Gg, Gg, Gs, Gg, Gs, Gs, Gg, Gs, Gg, Gg, Gs, Gg, Gg
Gg, Gs, Gs, Gs, Gs, Gs, Gs, Gs, Gs, Gg, Ce, Ce, Ce, Ce, Ce, Gs, Gg, Gs, Gd, Gd, Gd, Gs, Gd, Gs, Gs, Gd, Gd, Gd, Gd, Gs, Gd, Rp, Rp, Rp, Gg, Gd, Gd^Xff, Gd^Fetd, Gd^Xff, Gd^Xff, Gd, Gd, Gs, Gd, Gd, Rrc^Xfv, Gg, Gd, Gs, Gg, Gg, Gg, Gs, Gg, Gg, Gs, Gs, Gg, Gg, Gs, Gs, Gg, Gs, Gs, Gg, Gg, Gg
Gg, Gg, Gs, Gs, Gg, Gs, Gs, Gs, Gg, Gg, Ce, Re^Vct, Ce, Re^Vct, Ce, Gs, Gs, Gd, Gd, Gd, Gll, Gd, Gd^Xff, Gd^Fetd, Gd, Gs, Gs, Gs, Gg, Gg, Gs, Rp, Rp, Rp, Gs, Gd, Gd, Gd^Xff, Gd^Xff, Gd^Fetd, Gd, Gd, Gd, Gs, Gd, Gd, Gd, Gd, Gg, Gs, Gg, Gg, Gg, Gs, Gs, Gg, Gs, Gg, Gs, Gg, Gg, Gs, Gg, Gs, Gg, Gs, Gg
Gg, Gg, Gs, Gs, Gs, Gs, Gg, Gs, Gs, Gg, Gs, Ce, Gs, Ce, Gd, Gd, Gd, Gd, Gd, Gd^Fetd, Gll, Gd^Fetd, Gd^Xff, Gd, Gd^Xff, Gd^Xff, Gd^Fetd, Gs, Gs, Gs, Gg, Rp, Rp, Rp, Gs, Gd, Gd, Gd^Fetd, Gs, Gd, Gd, Gs, Gd^Fetd, Gd, Gd, Gs, Gs, Gd, Gs, Gd, Gd, Gg, Gg, Gg, Gg, Gg, Gs, Gg, Gg, Gs, Gg, Gs, Gg, Gg, Gg, Gg, Gg
Gs, Gs, Gs, Gs, Gs, Gs, Gs, Gg, Gs, Gs, Gs, Gs, Gd, Gd, Gd, Gd, Gd^Fetd, Gd, Gs, Gll, Gd^Fetd, Gd^Xff, Gd^Fetd, Gd, Gd, Gd, Gd^Fetd, Gs, Gs, Gs, Gg, Rp, Rp, Rp, Gg, Gg, Gs, Gd, Gg, Gd, Gd, Gd^Fetd, Gd^Xff, Gd^Xff, Gd^Xff, Gd^Fetd, Gd^Xff, Gd, Gd^Fetd, Gs, Gs, Gd, Gd, Gg, Gg, Gg, Gg, Gg, Gg, Gg, Ce, Ce, Ce, Ce, Ce, Gs, Gg
Gs, Gg, Gs, Gg, Gs, Gs, Gs, Gs, Gs, Gs, Gg, Gs, Gd^Fetd, Gd, Gd, Gd^Fetd, Gd, Gd, Gd^Xff, Gd^Xff, Gd^Fetd, Gd^Xff, Gd^Fetd, Gd^Fetd, Gd^Xff, Gd^Xff, Gg, Gs, Qxe, Gs, Cvr, Rp, Gg^Bsb|, Rp, Cvr, Gg, Qxe, Gs, Gs, Gs, Gd, Gd^Xff, Gd^Xff, Gd^Fetd, Gd, Gd^Xff, Gd^Fetd, Gd^Xff, Gd, Gd, Gd^Fetd, Gs, Gd, Gg, Gs, Gs, Gs, Gg, Gg, Gg, Ce, Gs, Ce, 8 Ke, Ce, Gs, Gg
Gs, Gs, Gs, Gg, Gg, Gs, Gg, Gs, Gg, Gs, Gs, Gs, Gd^Fetd, Gd^Fetd, Gd^Xff, Gd^Xff, Gd^Fetd, Gd^Fetd, Gd, Gd, Gd^Xff, Gd^Xff, Gd^Fetd, Gd, Gg, Gll, Qxe, Qxe, Cvr^Xfw, Qxe, Cvr^Xfw, Ww^Bsb|, Ww^Bsb|, Ww^Bsb|, Cvr, Qxe, Cvr, Qxe, Qxe, Gs, Gg, Gd, Gd^Fetd, Gd, Gd^Xff, Gd^Fetd, Gd^Xff, Gd^Fetd, Gd, Gd^Xff, Gd^Xff, Gd, Gd, Gd, Gs, Gg, Gs, Gg, Gg, Gs, Gs, Ce, Gg, Ce, Gg, Gg, Gg
Gg, Gs, Gg, Gg, Gg, Gg, Gg, Gg, Gg, Gg, Gs, Gd, Gd^Fetd, Gd^Xff, Gd^Xff, Gd^Fetd, Gd^Xff, Gd, Gd^Xff, Gd^Fetd, Gd^Fetd, Gd, Gd^Fetd, Gd^Xff, Qxe, Qxe, Cvr, Cvr, Wwf, Cvr^Xfw, Wwf, Ww^Bsb|, Cvr, Ww^Bsb|, Wwf, Cvr^Xfw, Wwf, Cvr, Cvr, Qxe, Qxe, Gd, Gd^Fetd, Gd, Gd^Xff, Gd, Gd^Fetd, Gd^Xff, Gd^Xff, Gd^Fetd, Gd^Xff, Gd^Fetd, Gd, Gs, Gs, Gg, Gs, Gg, Gg, Gg, Gs, Ce, Ce, Ce, Gs, Gg, Gs
Gg, Gg, Gg, Gg, Gg, Gs, Gg, Gs, Gs, Gs, Gs, Gd, Gd, Gd^Xff, Gd^Fetd, Gd^Fetd, Gd^Fetd, Gd^Xff, Gd^Fetd, Gd^Fetd, Gd, Gd^Fetd, Qxe, Qxe, Cvr, Cvr, Wwf, Wwf, Cvr, Wwf, Wwf, Cvr, 4 Kvr, Cvr, Wwf, Wwf, Cvr, Wwf, Wwf, Cvr, Cvr^Xfw, Qxe, Qxe, Gd^Fetd, Gd^Xff, Gd^Fetd, Gd^Xff, Gd^Xff, Gd, Gd^Xff, Gs, Gs, Gd, Gs, Gs, Gg, Gg, Gg, Gg, Gg, Gs, Gs, Gs, Gs, Gs^Fms, Gs, Gg
Gg, Gg, Gs, Gs, Gs, Gg, Gg, Gg, Gg, Gg, Gs, Gs, Gg, Gd, Gd, Gd^Fetd, Gd^Xff, Gd^Fetd, Gd^Xff, Gd, Qxe, Qxe, Cvr^Xfw, Cvr, Wwf, Wwf, Cvr, Kvr^Xfw, Rr, Kvr, Rr, Cvr, Cvr, Cvr, Rr, Kvr, Rr, Kvr^Xfw, Cvr, Wwf, Wwf, Cvr^Xfw, Cvr, Qxe, Qxe, Gd^Xff, Gd, Gd^Xff, Gd, Gs, Gd, Gd, Gs, Gs, Gg, Gs, Gs, Gg, Gs, Gs, Gs^Fms, Gs^Fms, Gs^Fms, Gs^Fms, Gll, Gs^Fms, Gs^Fms
Gs, Gs, Gg, Gg, Gs, Gs, Gs, Gg, Gs, Gg, Gg, Gg, Rrc^Xfv, Gs, Gs, Gd, Gd, Gd^Xff, Gd, Qxe, Qxe, Cvr^Xfw, Wwf, Wwf, Cvr, Kvr, Rr, Rr, Rr, Rr, Rr, Cvr, Rr, Cvr, Rr, Rr, Re^Vct, Rr, Rr, Kvr, Cvr, Wwf, Wwf, Cvr, Qxe, Qxe, Gd, Gd, Gg, Gd, Gs, Gd^Xff, Gd^Xff, Gs, Gs, Gs, Gs, Gs, Gll, Gs^Fms, Gs^Fms, Gs^Fms, Gll, Gll, Hh, Gll, Gs^Fms
Gg, Gs, Gs, Gg, Gg, Gs, Gg, Gs, Gs, Gs, Gs, Gg, Gs, Gg, Gs, Gs, Gs, Gd, Rp, Qxe, Cvr, Cvr^Xfw, Wwf, Kvr^Xfw, Rr, Rr, Rr, Rr, Kvr, Cvr, Kvr, Rr, Rrc^Xfv, Rr, Kvr, Cvr, Kvr, Rr, Rr, Rr, Rr, Kvr^Xfw, Wwf, Cvr, Cvr^Xfw, Qxe, Rp, Gs, Gs, Gs, Gg, Gd^Xff, Gs, Gs, Gg, Gs, Gs^Fms, Gll, Gs^Fms, Gs^Fms, Gs^Fms, Gs^Fms, Hh^Fms, Hh, Hh^Fms, Hh^Fms, Gg
Rp, Gg, Gg, Gs, Gg, Gs, Gg, Gg, Gs, Gg, Gs, Gg, Gg, Gs, Gs, Gs, Gg, Rp, Rp, Rp, Cvr, Wwf, Kvr, Cvr, Rr, Rr, Cvr, Kvr, Rr, Rr, Rr, Rr, Rr, Rr, Rr, Rr, Rr, Kvr, Cvr, Rr, Rr, Cvr, Kvr, Wwf, Cvr^Xfw, Rp, Rp, Rp, Rp, Gg, Gg, Gs, Gs, Gg, Gg, Gs, Gs^Fms, Gs^Fms, Gs^Fms, Gll, Gll, Gll, Hh^Fms, Hh^Fms, Hh, Hh^Fms, Hh
Rp, Rp, Rp, Gg, Gg, Gg, Gg, Gs, Gg, Gg, Gg, Gs, Gg, Gs, Gg, Gs, Gg, Rp, Rp, Gg^Bsb\, Ww^Bsb\, Wwf, Rr, Rr, Rr, Rr, Kvr, Rr, Rrc^Xfv, Rr, Kvr, Rr, Cvr, Rr, Kvr, Rr, Rrc^Xfv, Rr, Kvr, Rr, Rr, Rr, Rr, Wwf, Ww^Bsb/, Gg^Bsb/, Rp, Rp, Rp, Rp, Rp, Gs, Rp, Gg, Gg, Gs, Gs^Fms, Gll, Gs^Fms, Gs^Fms, Gs^Fms, Gs^Fms, Gs^Fms, Gll, Gll, Hh^Fms, Gll
Rp, Rp, Rp, Rp, Rp, Rp, Rp, Rp, Rp, Rp, Rp, Rp, Rp, Rp, Rp, Rp, Rp, Rp, Cvr, Cvr, Wwf, Ww^Bsb\, Cvr, Cvr, Kvr, Rr, Rr, Rr, Rr, Rr, Cvr, Cvr, 2 Kvr, Cvr, Cvr, Rr, Rrc^Xfv, Rr, Rr, Rr, Kvr, Cvr, Cvr, Ww^Bsb/, Wwf, Cvr, Cvr^Xfw, Rp, Gd, Rp, Rp, Rp, Rp, Rp, Rp, Gs, Gs, Gg, Gll, Gll, Gs^Fms, Gs^Fms, Gs^Fms, Gll, Gs^Fms, Gs^Fms, Gg
Gs^Fms, Rp, Rp, Rp, Rp, Rp, Rp, Rp, Rp, Rp, Rp, Rp, Rp, Rp, Rp, Rp, Rp, Rp, Cvr, Wwf, Wwf, Cvr, Cvr, Cvr, Cvr, Rr, Rr, Rr, Rrc^Xfv, Rr, Cvr, Cvr, Kvr, Cvr, Cvr, Rr, Rr, Rrc^Xfv, Rr, Rr, Cvr, Cvr, Cvr, Cvr, Wwf, Wwf, Cvr^Xfw, Rp, Gd, Rp, Rp, Rp, Rp, Rp, Rp, Rp, Rp, Gg, Gs, Gs^Fms, Gs, Gs, Gg, Gs, Gs, Gs, Gg
Rp, Rp, Rp, Rp, Gg, Rp, Gg, Rp, Gg, Rp, Gd, Rp, Gg, Rp, Gg, Rp, Gg, Rp, Rp, Cvr, Ww^Bsb/, Ww^Bsb/, Rr, Cvr, Rr, Rr, Kvr, Rr, Rrc^Xfv, Rr, Kvr, Cvr, Cvr, Cvr, Kvr, Rr, Rrc^Xfv, Rr, Kvr, Rr, Rr, Cvr, Rr, Ww^Bsb\, Ww^Bsb\, Cvr, Rp, Rp, Rp, Rp, Rp, Rp, Rp, Rp, Rp, Rp, Rp, Rp, Rp, Gs, Rp, Gg, Rp, Gg, Rp, Gg, Rp
Rp, Rp, Rp, Gg, Gg, Gg, Gs, Gs, Gd, Gd, Gd^Fetd, Gd, Gd, Gs, Gd, Gd, Gd, Rp, Rp, Gg^Bsb/, Cvr, Wwf, Kvr, Rr, Rr, Rr, Cvr, Rr, Rr, Rr, Rr, Rr, Rr, Rr, Rr, Rr, Rr, Rr, Cvr, Rr, Rr, Rr, Kvr, Wwf, Cvr, Gg^Bsb\, Rp, Rp, Rp, Rp, Gg, Gg, Gs, Gg, Gg, Rp, Rp, Rp, Rp, Rp, Rp, Rp, Rp, Rp, Rp, Rp, Rp
Rp, Rp, Gs, Gg, Gg, Gs, Gs, Gd, Gd^Xff, Gd^Xff, Gd, Gd^Xff, Gd, Gs, Gs, Rrc^Xfv, Gg, Rp, Rp, Rp, Cvr, Wwf, Wwf, Cvr^Xfw, Rr, Rr, Rr, Kvr, Kvr, Rr, Kvr, Rr, Rrc^Xfv, Rr, Kvr, Rr, Kvr^Xfw, Kvr, Rr, Rr, Rr, Cvr, Wwf, Wwf, Cvr^Xfw, Rp, Rp, Rp, Gg, Gs, Gs, Gs, Gg, Gg, Gg, Gs, Gd^Fetd, Rp, Rp, Rp, Rp, Rp, Rp, Rp, Rp, Rp, Rp
Rp, Rp, Gs, Gs, Gg, Gg, Gs, Gd, Gd, Gd^Fetd, Gd^Fetd, Gd^Xff, Gd, Gs, Gs, Gs, Gd, Gs, Gs, Qxe, Qxe, Cvr^Xfw, Wwf, Kvr, Cvr, Rr, Rr, Rr, Rr, Cvr, Rr, Rr, Rr, Rr, Rr, Cvr, Rr, Rr, Rr, Rr, Cvr, Kvr, Wwf, Cvr, Qxe, Qxe, Gg, Gg, Gs, Gs, Gg, Gs, Gs, Gg, Gg, Gll, Gd^Xff, Gd^Fetd, Gll, Gs, Gs^Fms, Gg, Gs^Fms, Gg, Gs^Fms, Gg, Gg
Rp, Rp, Gg, Gs, Gs, Gs, Gg, Gs, Gs, Gd, Gd, Gs, Gs, Gs, Gd, Gd, Gd^Xff, Gd, Gd, Qxe, Qxe, Cvr, Cvr, Wwf, Wwf, Kvr, Cvr, Rr, Rr, Rr, Rr, Cvr, Cvr, Cvr, Rr, Rr, Rr, Rr, Cvr, Kvr^Xfw, Wwf, Wwf, Cvr, Cvr, Qxe, Qxe, Gs, Gs, Gg, Gs, Gg, Gs, Gs, Gs, Gs, Gd^Fetd, Gd^Xff, Gs^Fms, Gd^Fetd, Gs^Fms, Gs^Fms, Gll, Gs^Fms, Gll, Gll, Gs^Fms, Gg
Rp, Rp, Gg, Gs, Gs, Gg, Gs, Gg, Gg, Gs, Gs, Gg, Gs, Gd, Gd, Gd^Xff, Gd, Gd, Gd^Fetd, Gs, Gs, Qxe, Qxe, Cvr^Xfw, Cvr, Wwf, Wwf, Kvr^Xfw, Cvr, Kvr, Wwf, Cvr, 6 Kvr, Cvr, Wwf, Kvr, Cvr, Kvr, Wwf, Wwf, Cvr^Xfw, Cvr^Xfw, Qxe, Qxe, Gg, Gg, Gs, Gg, Rrc^Xfv, Gd, Gs, Gg, Gs, Gg, Gs, Gd^Fetd, Gd^Fetd, Gd^Xff, Gd, Gs^Fms, Gs^Fms, Gll, Gs^Fms, Gs^Fms, Gll, Gs^Fms, Gg
Rp, Rp, Gg, Gg, Gs, Gs, Gg, Gg, Gs, Gs, Gs, Gs, Gd, Gd, Gd^Fetd, Gd, Gd^Fetd, Gd^Xff, Gd^Xff, Gd^Fetd, Gd, Gd, Gd, Qxe, Qxe, Cvr, Cvr, Wwf, Wwf, Wwf, Wwf, Cvr, Cvr, Cvr, Wwf, Wwf, Wwf, Wwf, Cvr, Cvr, Qxe, Qxe, Gg, Gg, Gg, Gs, Gg, Gg, Gs, Gd, Gg, Gs, Gs, Gs, Gs, Gll, Gd^Xff, Gd^Xff, Gs^Fms, Gs^Fms, Gs^Fms, Gll, Gll, Gll, Gs^Fms, Gs^Fms, Gg
Gg, Gs, Gs, Gg, Gs, Gg, Gs, Gg, Gs, Gg, Gs, Gs, Gd, Gd, Gd^Fetd, Gd^Xff, Gd^Xff, Gd, Gd^Fetd, Gd^Xff, Gd, Gd^Xff, Gd^Fetd, Gd, Gg, Qxe, Qxe, Cvr^Xfw, Cvr^Xfw, Cvr, Cvr^Xfw, Ww^Bsb|, Ww^Bsb|, Ww^Bsb|, Cvr^Xfw, Cvr, Cvr^Xfw, Cvr^Xfw, Qxe, Qxe, Gg, Gg, Gg, Gs, Gg, Gg, Gs, Gd, Gs, Gg, Gs, Gs, Gg, Gg, Gs, Gd^Xff, Gd^Fetd, Gd^Fetd, Gd, Gd, Gs^Fms, Gs^Fms, Hh, Gs^Fms, Gs^Fms, Gs^Fms, Gg
Gg, Gg, Gg, Gs, Gs, Gs, Gs, Gs, Gg, Gg, Gs, Gs, Gd, Gd^Fetd, Gd^Xff, Gd^Fetd, Gd^Xff, Gd^Xff, Gd^Fetd, Gd, Gd^Fetd, Gd, Gd^Xff, Gd^Xff, Gd^Fetd, Gs, Gs, Qxe, Qxe, Qxe, Cvr^Xfw, Ww^Bsb|, Gg^Bsb|, Ww^Bsb|, Cvr^Xfw, Qxe, Qxe, Qxe, Gd, Gd, Gd, Gd, Gs, Gs, Gd, Gd, Rrc^Xfv, Gd, Gg, Gs, Gg, Gs, Gg, Gg, Gd^Xff, Gd^Fetd, Gs^Fms, Gs^Fms, Gs^Fms, Hh, Hh^Fms, Hh^Fms, Hh^Fms, Hh^Fms, Hh^Fms, Gg, Gg
Gs, Gg, Gs, Gs, Gs, Gs, Gg, Gs, Gg, Gg, Gs, Gg, Gd, Gd, Gd, Gd^Xff, Gd, Gd, Gd^Fetd, Gd^Xff, Gd^Fetd, Gd^Xff, Gd^Xff, Gd^Fetd, Gd, Gd, Gd, Gs, Gg, Gg, Gg, Gg^Bsb|, Rp, Gg^Bsb|, Gd, Gg, Gd, Gs, Gs^Fms, Gs^Fms, Gd^Fetd, Gd, Gd, Gs, Gs, Gg, Gd, Gg, Gg, Gs, Gs, Gs, Gs, Gs, Gd^Fetd, Gll, Gll, Gll, Gll, Hh, Gll, Hh, Hh, Hh^Fms, Hh, Gs^Fms, Gs^Fms
Gg, Gs, Gs, Gg, Gs, Gg, Gs, Gg, Gs, Gg, Gg, Gs, Gs, Gg, Gs, Gd, Gd, Gd, Gs, Gd, Gd, Gs, Gd, Gd, Gs, Gd, Gd, Gg, Gd, Gg, Gg, Rp, Rp, Rp, Gd, Gd, Gd^Fetd, Gd^Xff, Gs^Fms, Gd^Xff, Gd^Fetd, Gs^Fms, Gd^Fetd, Gd, Gs, Gs, Gg, Gs, Gs, Gg, Gg, Gg, Gd^Xff, Gd^Fetd, Gd^Xff, Gd^Xff, Gs^Fms, Gll, Gs, Gll, Gs^Fms, Gs^Fms, Gll, Hh^Fms, Hh, Gs^Fms, Gg
Gg, Gg, Gg, Gg, Gs, Gs, Gs, Gg, Gg, Gg, Gg, Gs, Gg, Gs, Gg, Gs, Gs, Gg, Gs, Gs, Gg, Gd, Gg, Gd, Gd^Fetd, Gd^Fetd, Gd^Fetd, Gd, Gs, Gd, Gs, Rp, Rp, Rp, Gs, Gd^Fetd, Gd^Xff, Gd^Fetd, Gd, Gs^Fms, Gd, Gd^Xff, Gd^Fetd, Gd, Gg, Gg, Gs, Gs, Gg, Gg, Gs, Gs, Gd^Fetd, Gd^Fetd, Gs^Fms, Gd^Fetd, Gs^Fms, Gll, Gs^Fms, Gll, Gll, Gs^Fms, Gs^Fms, Gs^Fms, Gs, Gs, Gg
Gg, 1 Gg, Gg, Gs, Gg, Gs, Gg, Gg, Gg, Gs, Gg, Gg, Gg, Gg, Gg, Gg, Gg, Gs, Gd, Rrc^Xfv, Gd, Gd, Gs, Gd, Gd^Fetd, Gd^Xff, Gd^Fetd, Gd^Fetd, Gd^Xff, Gd, Gs, Rp, Rp, Rp, Gd, Gs^Fms, Gd^Fetd, Gs^Fms, Gd^Fetd, Gd^Fetd, Gd^Xff, Gd^Xff, Gd, Gd, Gs, Gg, Gs, Gs, Gg, Gs, Gd^Fetd, Gd^Xff, Gs^Fms, Gs^Fms, Hh, Gs^Fms, Hh, Gs^Fms, Hh, Gs^Fms, Gg, Gll, Gs, Gg, Gs, Gg, Gg
Gg, Gg, Gg, Gs, Gs, Gg, Gs, Gg, Gs, Gs, Gg, Gs, Gg, Gg, Gs, Gs, Gg, Gs, Gs, Gd, Gs, Gs, Gd, Gd, Gd^Xff, Gd^Fetd, Gd^Xff, Gd^Xff, Gd^Fetd, Gd^Xff, Gd^Fetd, Rp, Rp, Rp, Gs^Fms, Gd^Fetd, Gd^Xff, Gd^Xff, Gs^Fms, Gd^Xff, Gd^Fetd, Gd^Fetd, Gs, Gs, Gs, Gs, Gs, Gg, Gg, Gd^Xff, Gd^Fetd, Gd^Fetd, Gs^Fms, Gs^Fms, Hh, Hh, Hh^Fms, Hh, Hh, Gs^Fms, Hh, Gs, Gs, Gs, Gg, Gg, Gg
Gg, Gg, Gg, Gg, Gg, Gg, Gs, Gg, Ce, Ce, Ce, Gs, Gs, Gg, Gs, Gg, Gg, Gs, Gg, Gs, Gs, Gs, Gd, Gs, Gd^Xff, Gd^Fetd, Gd^Xff, Gd^Fetd, Gd^Fetd, Gd^Xff, Gd, Rp, Rp, Rp, Gs^Fms, Gd^Fetd, Gd^Xff, Gd^Xff, Gd^Xff, Gd, Gd, Gd, Gs, Gs, Gg, Gg, Gs, Gg, Gg, Gd^Xff, Gd^Xff, Gs^Fms, Gs^Fms, Gs^Fms, Gs^Fms, Hh, Hh^Fms, Hh^Fms, Hh^Fms, Hh^Fms, Hh, Gs^Fms, Gs^Fms, Gs, Gg, Gg, Gg
Gs, Gg, Gs, Gg, Gs, Gs, Gg, Gg, Ce, Re^Vct, Ce, Gg, Gg, Gg, Gg, Gg, Gg, Gg, Gs, Gs, Gg, Gs, Gd, Gd^Fetd, Gd^Fetd, Gd, Gd^Fetd, Gd, Gd^Fetd, Gd^Xff, Gd^Fetd, Rp, Rp, Rp, Gd^Fetd, Gd^Xff, Gd^Xff, Gd^Xff, Gd^Fetd, Gd, Gg, Gs, Gs, Gg, Gg, Gg, Gs, Gg, Gg, Gs, Gs, Gs^Fms, Gs^Fms, Gs^Fms, Gs^Fms, Gs^Fms, Gs^Fms, Hh, Gs^Fms, Hh, Gll, Gll, Gg, Gs, Gs, Gs, Gg
Gs, Gg, Gg, Gg, Gg, Gs, Gg, Ce, Ke, Ce, Re^Vct, Ce, Gg, Gs, Gs, Gs, Gs, Gg, Gg, Gs, Gs, Gs, Gd^Xff, Gd^Xff, Gd^Fetd, Gd^Xff, Gd^Xff, Gd^Xff, Gd^Fetd, Gd^Fetd, Gd, Rp, Rp, Rp, Gs^Fms, Gd^Fetd, Gs^Fms, Gd^Fetd, Gd, Gd, Gs, Gs, Gg, Gs, Gg, Gg, Gg, Gs, Gs, Gs, Gg, Gs, Gs, Gs^Fms, Gs^Fms, Gs^Fms, Gs^Fms, Gs^Fms, Gs^Fms, Gs^Fms, Gs^Fms, Gs^Fms, Gs, Gs, Gs, Gg, Gg
Gs, Gs, Gs, Gg, Gs, Gg, Ce, Ce, Ce, Ce, Ce, Ce, Gg, Gg, Gs, Gs, Gg, Gs, Gs, Gs, Gs, Gd, Gd, Gd^Xff, Gd^Xff, Gd^Fetd, Gs, Gd^Fetd, Gd, Gd, Gg, Rp, Rp, Rp, Gd, Gs^Fms, Gs, Gd, Gd, Gg, Gs, Gs, Gg, Gs, Gs, Gg, Gg, Gs, Gg, Gg, Ce, Ce, Ce, Gs, Gs, Gs^Fms, Gs, Gll, Gs^Fms, Gll, Gs^Fms, Gll, Gg, Gg, Gs, Gg, Gg
Gg, Gg, Gg, Gs, Gg, Gs, Gs, Gs, Gs, Gs, Gg, Gs, Gs, Gs, Gg, Gg, Gg, Gg, Gs, Gs, Gs, Gd, Gd, Gd, Gd, Gd, Gg, Gd, Gs, Gs, Rp, Rp, Rp, Rp, Gs, Gd, Gd, Gd, Gs, Gs, Gg, Gg, Gg, Gg, Gg, Gg, Gg, Gg, Gs, Gs, Ce, Re^Vct, Ce, Gs, Gs, Gs, Gs, Gg, Gs, Gs^Fms, Gs, Gg, Gs, Gg, Gg, Gg, Gg
Rp, Gg, Gg, Gs, Gg, Gg, Gs, Gg, Gs, Gg, Gg, Gg, Gg, Gg, Gg, Gg, Gs, Gs, Gg, Gg, Gs, Gs, Gs, Gs, Gs, Gs, Gs, Gg, Rp, Rp, Rp, Rp, Rp, Rp, Gs, Gd, Gg, Gg, Gs, Gg, Gs, Gg, Gs, Gs, Gs, Gs, Gg, Gg, Gs, Ce, Re^Vct, Ce, 7 Ke, Ce, Gs, Gg, Gg, Gg, Gg, Gs, Gg, Gs, Gg, Gs, Gs, Gg, Gg
Rp, Rp, Rp, Gg, Gg, Gs, Gs, Gg, Gg, Gg, Gg, Gg, Gs, Gg, Gs, Gs, Gg, Gg, Gg, Gg, Gg, Gs, Gg, Gs, Gg, Gs, Rp, Rp, Rp, Rp, Rp, Rp, Rp, Rp, Gg, Gs, Gs, Gg, Gs, Gs, Gg, Gs, Gs, Gg, Gg, Gg, Gs, Gs, Gg, Ce, Ce, Ce, Ce, Ce, Gg, Gg, Gg, Gs, Gs, Gs, Gg, Gg, Gs, Gs, Gg, Gg, Gg
Rp, Rp, Rp, Rp, Rp, Gg, Gg, Gs, Gg, Gg, Gs, Gs, Gs, Gs, Gg, Gg, Rp, Rp, Rp, Gg, Gg, Gg, Gg, Gg, Rp, Rp, Rp, Rp, Rp, Rp, Rp, Rp, Rp, Rp, Gg, Gg, Gg, Gs, Gg, Gs, Gg, Gg, Gs, Gg, Gs, Gg, Gg, Gs, Gs, Gs, Gg, Gg, Gs, Gs, Gg, Gg, Gg, Gs, Gg, Gg, Gs, Gs, Gs, Gs, Gs, Gg, Gs
Gs^Fms, Rp, Rp, Rp, Rp, Rp, Rp, Gg, Gg, Gg, Gg, Gg, Gg, Gg, Rp, Rp, Rp, Rp, Rp, Rp, Rp, Gg, Rp, Rp, Rp, Rp, Rp, Rp, Hh, Hh, Hh, Rp, Rp, Rp, Gg, Gg, Gs, Gs, Gg, Gg, Gg, Gg, Gg, Gg, Gs, Gg, Gg, Gg, Gs, Gs, Gg, Gs, Gg, Gs, Gs, Gs, Gg, Gs, Gs, Gs, Gs, Gg, Gg, Gg, Gs, Gs, Hh
Md, Gs^Fms, Gs^Fms, Rp, Rp, Rp, Rp, Rp, Rp, Gg, Gg, Gg, Rp, Rp, Rp, Rp, Rp, Rp, Rp, Rp, Rp, Rp, Rp, Rp, Rp, Rp, Hh, Hh, Hh, Hh, Hh, Rp, Rp, Rp, Gg, Gs, Gg, Gg, Gs, Gs, Gs, Gg, Gg, Gs, Gg, Gg, Gg, Gg, Gs, Gg, Gs, Gs, Gg, Gs, Gg, Gg, Gs, Gs, Gs, Gs, Gs^Fms, Gs^Fms, Gs, Gs, Gs^Fms, Hh^Fms, Hh
Md, Md, Md, Hh^Fms, Hh^Fms, Rp, Rp, Rp, Rp, Rp, Rp, Rp, Rp, Rp, Rp, Rp, Gg, Gg, Gg, Rp, Rp, Rp, Rp, Rp, Gg, Gg, Hh, Hh, Hh, Hh, Hh, Rp, Rp, Rp, Gs, Gs, Gg, Gg, Gg, Gg, Gg, Gs, Gg, Gg, Gs, Gg, Gg, Gs, Gg, Gs, Gg, Gg, Gg, Gg, Gg, Gs, Gg, Gg, Gs, Gs, Gs^Fms, Gs, Hh, Gs^Fms, Gs^Fms, Hh, Hh
Md, Md, Md, Md, Md, Hh^Fms, Hh^Fms, Rp, Rp, Rp, Rp, Rp, Rp, Rp, Gg, Gg, Gg, Gg, Gs, Gg, Gg, Rp, Gg, Gg, Gg, Gg, Gg, Hh, Hh, Hh, Hh, Rp, Rp, Rp, Gs, Gg, Gg, Gg, Gg, Gg, Gs, Gg, Gg, Gs, Gs, Gg, Gg, Gs, Gg, Gs, Gg, Gg, Gg, Gg, Gg, Gs, Gg, Gg, Gs, Gs^Fms, Gs^Fms, Hh, Hh^Fms, Hh^Fms, Hh^Fms, Hh^Fms, Hh
Md, Md, Md, Md, Md, Hh^Fms, Md, Hh^Fms, Rp, Rp, Rp, Rp, Gg, Gg, Gg, Gg, Gs, Gs, Gg, Gg, Gs, Gg, Gs, Gg, Gg, Gg, Gg, Hh, Hh, Hh, Gg, Rp, Rp, Rp, Gg, Gs, Gs, Gs, Gs, Gg, Gg, Gg, Gs, Gs, Gg, Gg, Gg, Gg, Gg, Gg, Gs, Gs, Gs, Gs, Gg, Gg, Gs, Gg, Gg, Gg, Hh, Hh^Fms, Gg, Hh^Fms, Hh, Hh, Gg
