Mm, Mm, Mm, Mm, Mm, Mm, Mm, Mm, Mm, Mm, Mm, Mm, Mm, Mm, Mm, Mm, Mm, Mm, Mm, Hh^Fmf, Hh^Fmf, Mm, Mm, Mm, Mm, Mm, Mm, Mm, Mm, Mm, Hh^Fmf, Gll^Fmf, Gll^Fmf, Gll^Fmf, Gll^Fmf, Gll^Fmf, Hh^Fmf, Mm, Mm, Mm, Ww, Ww, Mm, Mm, Mm, Mm, Mm, Mm, Mm, Mm, Mm, Mm, Mm, Mm, Mm, Mm, Mm
Mm, Mm, Mm, Mm, Mm, Mm, Mm, Mm, Mm, Mm, Mm, Mm^Xm, Mm, Mm, Mm^Xm, Mm^Xm, Mm, Mm, Hh^Fmf, Hh^Fmf, Hh^Fmf, Mm, Mm, Mm, Mm, Mm, Mm, Mm, Mm, Mm, Hh^Fmf, Gll^Fmf, Gll^Fmf, Gll^Fmf, Gll^Fmf, Gll^Fmf, Hh^Fmf, Mm, Mm^Xm, Mm, Ww, Ww, Mm, Mm, Mm, Mm, Mm, Mm, Mm, Mm, Mm, Mm, Mm, Mm, Mm, Mm, Mm
Mm, Mm, Mm, Mm, Mm, Mm, Mm, Mm, Mm, Mm, Mm, Mm, Mm, Mm, Mm, Mm, Hh^Fmf, Hh^Fmf, Hh^Fmf, Gll^Fmf, Gll^Fmf, Hh^Fmf, Hh^Fmf, Mm, Mm, Mm, Hh^Fmf, Hh^Fmf, Hh^Fmf, Hh^Fmf, Gll^Fmf, Gll^Fmf, Gll, Gll, Gll^Fmf, Gll^Fmf, Hh^Fmf, Mm, Mm, Mm^Xm, Mm^Xm, Ww, Ww, Mm, Mm, Mm, Mm^Xm, Mm, Mm, Mm, Mm, Mm, Mm, Mm, Mm, Mm, Mm
Mm, Mm, Mm, Mm, Mm, Mm, Mm, Mm, Mm, Mm, Mm, Mm, Mm, Mm, Hh^Fmf, Hh^Fmf, Hh^Fmf, Hh^Fmf, Gll, Gll, Gg^Vws, Gll^Fmf, Gll^Fmf, Hh^Fmf, Hh^Fmf, Hh^Fmf, Gll^Fmf, Gll^Fmf, Gll^Fmf, Gll^Fmf, Gll^Fmf, Gll, Gg, Gll, Gll, Gll^Fmf, Hh^Fmf, Mm, Mm, Mm, Mm, Mm, Ww, Ww, Hh^Fmf, Mm, Mm, Mm, Mm, Mm, Mm, Mm, Mm, Mm, Mm, Mm, Mm
Mm, Mm, Mm, Mm, Mm, Mm, Mm, Mm, Mm, Mm, Mm, Mm, Mm, Hh^Fmf, Hh^Fmf, Hh^Fmf, Gll^Fmf, Gll, Gll^Fmf, Gs, Gs, Gll^Fmf, Gg, Gll, Gg, Gll^Fmf, Gg, Gg, Gg, Gll, Gll, Gll, Gg, Gg, Gll^Fmf, Gll, Gll^Fmf, Hh^Fmf, Hh^Fmf, Mm, Mm, Mm, Ww, Ww, Mm, Mm, Mm, Mm, Mm, Mm, Mm, Mm, Mm, Mm, Mm, Mm, Mm
Mm, Mm, Mm, Mm, Mm, Mm, Mm, Mm, Mm, Mm, Mm, Mm, Hh^Fmf, Hh^Fmf, Hh^Fmf, Gll^Fmf, Gll, Gll^Fmf, Gs, Gg, Gs, Gg, Gg, Gg, Gg, Gs, Gs, Gg, Gg, Gs, Gs, Gs, Gg, Gll, Gll^Fmf, Gll, Gll, Gll^Fmf, Gll^Fmf, Hh^Fmf, Hh^Vws, Ww, Ww, Mm, Mm, Mm, Mm, Mm, Mm, Mm, Mm, Mm, Mm, Mm, Mm, Mm, Mm
Mm, Mm, Mm, Mm, Hh^Fmf, Mm, Mm, Mm, Mm, Mm, Hh^Fmf, Hh^Fmf, Hh^Fmf, Gll^Fmf, Gll, Gll^Fmf, Gll, Gs, Gg, Gs, Gg, Gs, Gs, Gs, Hh, Gll, Hh, Gg, Gd, Gs, Gs, Gg, Gll^Fmf, Gll^Fmf, Hh^Fmf, Hh^Fmf, Hh^Fmf, Gll^Fmf, Gll^Fmf, Gll, Ww, Ww, Hh^Fmf, Mm, Mm, Mm, Mm, Mm, Mm, Mm, Mm, Mm, Mm, Mm, Mm, Mm, Mm
Mm, Mm, Mm, Hh^Fmf, Ww, Hh^Fmf, Hh^Fmf, Mm, Hh^Fmf, Hh^Fmf, Hh^Fmf, Hh^Fmf, Hh^Vws, Gll^Fmf, Gll, Gll, Gll^Fmf, Gll, Hh^Vws, Gg, Gs, Gs, Gg^Fmf, Hh, Hh^Fmf, Hh^Fmf, Hh^Fmf, Gg^Fmf, Gd^Xff, Gd, Gd, Gll, Gll^Fmf, Gll, Hh^Fmf, Hh, Hh^Fmf, Hh^Fmf, Gll, Gs, Ww, Ww, Hh^Fmf, Mm, Mm, Mm, Hh^Fmf, Hh^Fmf, Hh^Fmf, Mm, Mm, Mm, Mm, Mm, Mm, Mm, Mm
Mm, Mm, Ww, Ww, Ww, Ww, Ww, Hh^Fmf, Hh^Fmf, Hh^Fmf, Hh^Fmf, Gll^Fmf, Gll^Fmf, Gll, Gll^Fmf, Gll^Fmf, Hh, Hh, Hh^Fmf, Hh, Gg, Gs, Gg^Fmf, Hh, Hh^Fmf, Hh^Fmf, Hh, Gd^Xff, Gd, Rrc^Xfv, Gd, Gd, Gll, Gd^Xff, Hh^Xfv, Hh^Xff, Hh^Fmf, Hh^Fmf, Gg, Wwg, Gll, Gs, Gll, Hh^Fmf, Hh^Fmf, Hh^Fmf, Gll^Fmf, Gll^Fmf, Gll, Hh^Fmf, Mm, Mm, Mm, Mm, Mm, Mm, Mm
Ww, Ww, Ww, Ww, Hh^Fmf, Ww, Ww, Ww, Ww, Hh^Fmf, Ww, Ww, Ww, Gll, Gll^Fmf, Hh, Hh, Hh^Fmf, Gs, Gg, Gs, Gs, Gg, Gg^Fmf, Gll, Gd, Hh^Xff, Gd, Gd, Gd, Gs, Gg, Gs, Gd, Gd^Xff, Hh^Xff, Gll^Fmf, Gll^Fmf, Rr, Wwg, Gg, Gll^Fmf, Gll^Fmf, Gll^Fmf, Gll^Fmf, Gll, Gll, Gll^Fmf, Gll, Hh^Fmf, Hh^Fmf, Mm, Mm, Mm, Mm, Mm, Mm
Ww, Ww, Mm, Hh^Fmf, Mm, Hh^Fmf, Hh^Fmf, Ww, Gll^Fmf, Ww, Gll^Fmf, Gll^Fmf, Gll^Fmf, Ww, Ww, Hh^Fmf, Hh^Fmf, Hh, Gs, Gs, Gs, Gd, Gs, Gg, Gg, Gd, Gd, Gd, Gg, Gs, Gs, Gs, Gg, Gd, Rr, Gd^Xff, Rr, Rr, Wwg, Ww^Bw\r, Rr, Gll, Gll^Fmf, Gll^Fmf, Gll^Fmf, Gll, Gg, Gg, Hh^Fmf, Hh^Fmf, Mm, Mm, Mm, Mm, Mm, Mm, Mm
Mm, Mm, Mm, Mm, Mm, Mm, Mm, Hh^Fmf, Hh^Fmf, Gll^Fmf, Gll^Fmf, Gll^Fmf, Gll, Gs, Ww, Gs, Gg, Gg, Gs, Gg, Gs, Gg, Gd, Gd, Gs, Gd, Gd, Gg, Kwr, Gg, Rr, Rr, Kwr, Rr, Gd, Rr, Wwg, Wwg, Wwg, Gg, Rr, Gll^Fmf, Gll^Fmf, Gll^Fmf, Gll^Fmf, Gll^Fmf, Gg, Gs, Hh^Fmf, Mm, Mm, Mm, Mm, Mm, Mm, Mm, Mm
Mm, Mm, Mm, Mm, Mm, Mm, Mm, Mm, Mm, Hh^Fmf, Hh^Fmf, Gll^Fmf, Gll, Gg, Ww, Ww, Gg^Vws, Gg, Gg, Gd, Gs, Gg, Gs, Gs, Gd, Gd, Gd^Xff, Cwr, Gd^Xff, Cwr, Gg^Bsb|, Cwr, Gd^Xff, Cwr, Ww, Wwg, Wog, Wog, Wwg, Gs, Rr, Gll, Gll^Fmf, Gll, Gll^Fmf, Gll, Gs, Gg, Gg, Hh^Fmf, Hh^Fmf, Mm, Mm, Mm, Mm, Mm, Mm
Mm, Mm, Mm, Mm, Mm, Mm, Mm, Mm, Mm, Mm, Mm, Hh^Fmf, Gll^Fmf, Gg, Gs, Ww, Ww, Ww, Ww, Gs, Gg, Gs, Gs, Gs, Ww, Ww, Ww, Ww, Ww, Gd^Xff, Ww^Bsb|, Gd^Xff, Ww, Ww, Mm, Wwg, Wog, Wog, Wwg, Gs, Rr, Gll, Gll^Fmf, Gll^Fmf, Gs, Gg, Rr, Gs, Gs, Gg, Gg, Hh^Fmf, Mm, Mm, Mm, Mm, Mm
Mm, Mm, Mm, Mm, Mm, Mm, Mm, Mm, Mm, Mm^Xm, Mm, Hh^Fmf, Hh^Fmf, Gll^Fmf, Gs, Gg, Gs, Gs, Ww, Gd, Ww, Cwr, Kwr, Cwr, Wwg, Ww, Mm^Xm, Kwr, Ww, Ww, Rrc, Ww, Ww, Kwr, Mm, Wwg, Wwg, Wog, Wwg, Gg, Rr, Gs, Rr, Gs, Rr, Rr, Gll, Rr, Rr, Gg, Gg, Hh^Fmf, Hh^Fmf, Hh^Fmf, Hh^Fmf, Hh^Fmf, Hh^Fmf
Mm, Mm, Mm, Mm, Mm, Mm, Mm, Mm, Mm, Mm, Mm, Mm, Mm, Hh^Fmf, Gll^Fmf, Gg, Gs, Gg, Gs, Ww, Cwr, Ww^Bsb|, Ww, Wwg, Wwg, Mm^Xm, Mm, Mm^Xm, Mm, Kwr, Rrc, Kwr, Mm, Mm, Mm, Mm, Kwr, Wwg, Ww, Gs, Gg, Rr, Gll^Fmf, Rr, Hh^Fmf, Hh^Fmf, Hh^Fmf, Gll, Hh^Fmf, Rr, Rr, Rr, Rr, Gll, Rr, Gs, Gg
Mm, Mm, Mm, Mm, Mm, Mm, Mm, Mm, Mm, Mm, Mm, Mm^Xm, Mm^Xm, Hh^Fmf, Hh^Fmf, Gs, Gs, Gg^Vws, Gg, Gg, Gg, Kwr, Wwg, Wwg, Mm^Xm, Mm, Cwr, Kwr, Rrc^Xfv, Rrc, Rrc, Rrc, Rrc^Xfv, Kwr, Cwr, Mm, Mm^Xm, Wwg, Wwg, Gs, Gs, Gll, Gll^Fmf, Hh^Fmf, Mm, Mm^Xm, Mm, Hh^Fmf, Mm, Hh^Fmf, Hh^Fmf, Hh^Fmf, Hh^Fmf, Rr, Gs, Rr, Rr
Mm, Mm, Mm, Mm, Mm, Mm, Mm, Mm, Mm, Mm^Xm, Mm^Xm, Mm, Mm, Mm, Hh^Fmf, Gg, Gs, Gs, Gs, Gs, Gd, Cwr, Wwg, Wwg, Wwg, Kwr, Cwr, Rrc, Rrc^Xfv, Rrc, Cwr, Rrc, Rrc^Xfv, Rrc, Cwr, Kwr, Mm, Mm^Xm, Wwg, Wwg, Gd^Xff, Gd^Xff, Gll, Hh^Fmf, Mm, Mm, Mm, Mm, Mm, Mm, Mm, Mm, Hh^Fmf, Gll, Hh, Gs, Gg
Mm, Mm, Mm, Mm, Mm, Mm, Mm, Mm, Mm, Mm, Mm, Mm^Xm, Mm, Mm, Hh^Fmf, Gll, Gs, Gs, Gs, Gd, Gd^Xff, Gd, Wwg, Wog, Wwg, Cwr, Rrc^Xfv, Kwr, Cwr, Cwr, Skl^Cov, Cwr, Cwr, Kwr, Rrc^Xfv, Cwr, Mm, Mm^Xm, Wwg, Wwg, Gll, Gd^Xff, Gll^Fmf, Hh^Fmf, Hh^Fmf, Mm, Mm, Mm, Mm, Mm, Mm, Mm, Hh^Fmf, Hh^Fmf, Hh^Fmf, Hh^Fmf, Hh^Fmf
Mm, Mm, Mm, Mm, Mm, Mm, Mm, Mm, Mm, Mm, Mm, Mm, Mm, Mm, Hh^Fmf, Gll^Fmf, Gg, Gs, Gs, Gd, Gd^Xff, Gd^Xff, Wwg, Wwg, Mm, Kwr, Rrc^Xfv, Rrc, Cwr, Skl, 2 Kwr, Skl, Cwr, Rrc, Rrc^Xfv, Kwr, Mm, Mm, Wwg, Wwg, Gs, Gs, Gll, Hh^Fmf, Hh^Fmf, Mm, Mm, Mm, Mm, Mm, Mm, Mm, Mm, Hh^Fmf, Hh^Fmf, Hh^Fmf, Hh
Mm, Mm, Mm, Mm, Mm, Mm, Mm, Mm, Mm, Mm, Mm, Mm, Mm, Hh^Fmf, Hh^Fmf, Gll, Gll, Gg, Wwg, Gd, Wwg, Wwg, Wwg, Mm^Xm, Mm, Kwr, Rrc^Xfv, Rrc, Cwr, Skl, Skl^Cov, Skl, Cwr, Rrc, Rrc^Xfv, Kwr, Mm, Mm, Wwg, Wwg, Cwr, Gg, Gd^Xff, Gll^Fmf, Hh^Vws, Hh^Fmf, Mm, Mm, Mm, Mm, Mm, Mm, Mm, Mm, Hh^Fmf, Hh, Gll^Fmf
Mm, Mm, Mm, Mm, Mm, Mm, Mm, Mm, Mm, Mm, Mm^Xm, Mm^Xm, Mm, Hh^Fmf, Ww, Ww, Ww, Gd^Xff, Wwg, Wwg, Mm^Xm, Wwg, Mm, Mm, Mm, Cwr, Cwr, Kwr, Rrc^Xfv, Cwr, Cwr, Cwr, Rrc^Xfv, Kwr, Cwr, Cwr, Mm, Mm, Wwg, Wwg, Kwr, Gg, Gs, Gll, Gll, Hh^Fmf, Hh^Fmf, Mm, Mm, Mm, Mm, Mm, Mm, Mm, Hh^Fmf, Gll^Fmf, Ww
Mm, Mm, Mm, Mm, Mm, Mm, Mm, Mm, Mm, Mm^Xm, Mm, Mm, Ww, Ww, Ww, Gll^Fmf, Gll^Fmf, Ww, Wwg, Kwr, Mm, Mm^Xm, Mm^Xm, Mm, Cwr, Kwr, Cwr, Rrc^Xfv, Rrc^Xfv, Rrc, Rrc, Rrc, Rrc^Xfv, Rrc^Xfv, Cwr, Kwr, Mm^Xm, Kwr, Wwg, Wwg, Wwg, Cwr, Kwr, Gg, Gg, Gll^Fmf, Gll, Hh^Fmf, Hh^Fmf, Hh^Fmf, Hh^Fmf, Mm, Hh^Fmf, Hh^Fmf, Ww, Ww, Ww
Mm, Mm, Mm, Mm, Mm, Mm, Mm, Mm, Mm, Mm, Mm, Ww, Ww, Ww, Mm^Xm, Hh^Vws, Hh^Fmf, Ww, Wwg, Cwr, Cwr, Mm, Cwr, Cwr, Wwg, Mm, Mm, Kwr, Mm, Rrc, Rrc, Rrc, Mm, Kwr, Mm, Mm, Kwr, Wwg, Wwg, Wog, Wo^Bsb/, Ww^Bsb/, Wwg, Wwg, Wwg, Gll, Gll, Gll^Fmf, Gll^Fmf, Gll^Fmf, Gll^Fmf, Hh^Fmf, Ww, Ww, Ww, Ww, Rr
Ww, Mm, Mm, Mm, Mm, Mm, Mm, Hh^Fmf, Ww, Mm, Ww, Ww, Mm, Mm, Mm, Mm, Hh^Fmf, Gll^Fmf, Ss, Wwg, Wwg, Kwr, Wwg, Wwg, Wwg, Wwg, Wwg, Mm, Mm, Kwr, Rrc, Kwr, Mm, Mm, Mm, Mm, Wwg, Wwg, Kwr, Ww^Bsb/, Wwg, Wog, Wwg, Wwg, Wwg, Wwg, Ww, Gll, Gll^Fmf, Gll^Fmf, Ww, Ww, Ww, Ww, Rr, Rr, Hh
Ww, Ww, Ww, Mm, Hh^Fmf, Mm, Ww, Ww, Ww, Ww, Ww, Mm, Mm, Mm, Mm^Xm, Mm, Hh^Fmf, Gll^Fmf, Gll^Fmf, Ss, Wwg, Wwg, Ds, Ds, Ds, Wwg, Wwg, Kwr, Wwg, Wwg, Ww^Bsb|, Wwg, Wwg, Kwr, Wwg, Wwg, Gg, Cwr, Gs, Cwr, Gg, Wwg, Gs, Gs, Gg, Ww, Ww, Ww, Ww, Ww, Ww, Ww, Rr, Rr, Hh^Fmf, Hh^Fmf, Mm
Mm, Ww, Ww, Ww, Ww, Ww, Ww, Ww, Mm, Mm, Mm, Mm, Mm, Mm, Mm, Mm, Hh^Fmf, Gll^Fmf, Gll, Gll, Wwg, Ds, Gd^Xff, Rrc^Xfv, Ds, Wwg, Gd, Ww^Bsb|, Wwg, Wwg, Gg^Bsb|, Wwg, Wwg, Ww^Bsb|, Gg, Gd, Gd, Gd, Gd, Gg, Gs, Gg, Gg, Gs, Gg, Gs, Gg, Ww, Ww, Ww, Rr, Rr, Gg, Hh^Fmf, Mm, Mm, Mm
Mm, Mm, Mm, Ww, Hh^Fmf, Ww, Mm, Mm, Mm, Mm, Mm, Mm, Mm, Mm, Mm, Mm, Hh^Fmf, Gll^Fmf, Gll, Wwg, Ds, Ds, Gd^Xff, Ds, Wwg, Wwg, Gd, Kwr, Cwr, Gd, Rr, Gd, Cwr, Kwr, Gs, Gs, Gs, Gd, Gd, Gs, Gs, Gs, Gs, Gg, Gs, Gg, Rr, Gg^Vws, Rr, Rr, Gs, Gs, Hh^Fmf, Hh^Fmf, Mm, Mm, Mm
Mm, Mm, Mm, Hh^Fmf, Mm, Mm, Mm, Mm, Mm, Mm, Mm, Mm, Mm, Mm, Mm, Mm, Mm, Hh^Fmf, Hh^Fmf, Wwg, Ds, Gll^Fmf, Gll^Fmf, Ds, Wwg, Wwg, Gs, Gd, Gd, Kwr, Rr^Cov, 3 Kwr, Gd, Gd, Gd, Gs, Gg, Rrc^Xfv, Gd, Gg, Rr, Rr, Rr, Gs, Rr, Rr, Gs, Rr, Gg, Gg, Hh^Fmf, Hh^Fmf, Mm, Mm, Mm, Mm, Mm
Mm, Mm, Mm, Mm, Mm, Mm, Mm, Mm, Hh^Fmf, Hh^Fmf, Mm, Mm, Mm, Mm, Mm, Mm, Mm, Mm, Hh^Fmf, Wwg, Wwg, Ds, Ds, Ds, Wwg, Gg, Gs, Gs, Rr, Rr, Hhd, Hhd, Hh^Xff, Hh^Xff, Hh, Gg, Gs, Gs, Rr, Rr, Hh^Fmf, Hh^Fmf, Mm, Rr, Hh^Fmf, Hh^Fmf, Hh^Fmf, Gg, Gll, Gll, Hh^Fmf, Mm, Mm, Mm, Mm, Mm, Mm
Mm, Mm, Mm, Mm, Mm, Mm, Hh^Fmf, Hh^Fmf, Gll^Fmf, Hh^Fmf, Hh^Fmf, Mm, Mm, Mm, Mm, Mm, Mm, Mm, Hh^Fmf, Ww, Ww, Ww, Ww, Wwg, Wwg, Gg, Gs, Gs, Rr, Gs, Gd, Hh^Xff, Hh^Xff, Hh^Xff, Hh^Fmf, Hh^Fmf, Rr, Rr, Hh^Fmf, Hh^Fmf, Mm, Mm, Mm, Mm^Xm, Mm^Xm, Mm, Mm, Hh^Fmf, Hh^Fmf, Hh^Fmf, Mm, Mm, Mm, Mm, Mm, Mm, Mm
Mm, Mm, Mm, Mm, Mm, Mm, Hh^Fmf, Gll^Fmf, Gll^Fmf, Gll^Fmf, Ww, Ww, Ww, Mm, Ww, Mm, Mm, Mm, Ww, Ww, Gs, Gg, Gg, Gg, Gs, Gs, Gg, Gg, Rr, Gs, Gd, Hh^Xff, Hh, Hh, Hh, Gs, Rr, Gs, Hh^Fmf, Mm, Mm, Mm, Mm, Mm, Mm, Mm^Xm, Mm, Mm, Mm, Hh^Fmf, Mm, Mm, Mm, Mm, Mm, Mm, Mm
Mm, Mm, Mm, Mm, Mm, Hh^Fmf, Ww, Gll^Fmf, Ww, Ww, Hh^Fmf, Hh^Fmf, Mm^Xm, Ww, Ww, Ww, Ww, Hh^Vws, Ww, Ww, Gg, Gs, Hh^Vws, Gs, Hh^Fmf, Gs, Gg, Rr, Gll, Rr, Gd, Hh^Xff, Hh, Hh, Gll, Gs, Rr, Gs, Hh^Fmf, Mm, Mm, Mm, Mm, Mm, Mm, Mm, Mm, Mm, Mm, Mm, Mm, Mm, Mm, Mm, Mm, Mm, Mm
Mm, Mm, Hh^Fmf, Hh^Fmf, Hh^Fmf, Hh^Fmf, Ww, Ww, Hh^Fmf, Hh^Fmf, Mm, Mm, Mm, Mm, Mm, Ww, Gll, Ww, Gg, Gg, Gs, Gs, Hh^Fmf, Hh^Fmf, Hh^Fmf, Hh^Fmf, Gs, Rr, Gs, Rr, Rr, Gd, Gs, Gs, Rr, Gg, Rr, Gs, Hh^Fmf, Mm, Cw, Mm, Mm, Mm, Mm, Mm, Mm, Mm, Mm, Mm, Mm, Mm, Mm, Mm, Mm, Mm, Mm
Mm, Mm, Hh^Fmf, Hh^Fmf, Ww, Ww, Ww, Hh^Fmf, Mm, Mm, Mm, Mm, Mm, Mm, Hh^Fmf, Hh^Fmf, Gll^Fmf, Gll, Gs, Gg, Gs, Hh^Fmf, Hh^Fmf, Hh, Hh^Fmf, Hh^Fmf, Gs, Rr, Gg, Gs, Gs, Rr, Rr, Rr, Gg, Rr, Rr, Gg, Gll, Cw, Kw, Cw, Mm, Mm, Mm, Mm, Mm, Mm, Mm, Mm, Mm, Mm, Mm, Mm, Mm, Mm, Mm
Mm, Mm, Hh^Fmf, Ww, Ww, Ww, Hh^Fmf, Hh^Fmf, Mm, Mm, Mm, Mm, Mm, Hh^Fmf, Hh^Vws, Gll^Fmf, Gll^Fmf, Gll, Gll, Gg, Hh^Fmf, Hh^Fmf, Mm, Hh^Fmf, Hh^Fmf, Mm, Rr, Rr, Mm, Hh^Fmf, Hh^Fmf, Gs, Gg, Gg, Gs, Gg, Gg, Rr, Gll, Cw, Cw, Cw, Mm, Mm, Mm, Mm, Mm, Mm, Mm, Mm, Mm, Mm, Mm, Mm, Mm, Mm, Mm
Mm, Mm, Ww, Ww, Mm, Mm, Mm, Mm, Mm, Mm, Mm, Mm, Mm, Hh^Fmf, Hh^Fmf, Gll^Fmf, Gll^Fmf, Gll^Fmf, Gll, Gg, Gs, Hh^Fmf, Mm, Mm^Xm, Mm, Mm, Rr, Gs, Hh^Fmf, Mm^Xm, Hh^Fmf, Gll, Hh^Fmf, Hh^Fmf, Hh^Fmf, Gs, Gs, Rr, Rr, Gll, Hh^Fmf, Mm, Mm, Mm, Mm, Mm, Mm, Mm, Mm, Mm, Mm, Mm, Mm, Mm, Mm, Mm, Mm
Ww, Ww, Mm, Mm, Mm, Mm, Mm, Mm, Hh^Fmf, Hh^Fmf, Mm, Mm, Mm, Mm, Hh^Fmf, Gll^Fmf, Gll, Gll^Fmf, Gll^Fmf, Gll, Hh^Fmf, Gs, Gll, Hh^Fmf, Hh^Fmf, Hh^Fmf, Rr, Gll, Hh^Vc, Mm^Xm, Mm, Hh^Fmf, Mm, Mm, Mm, Hh^Fmf, Hh^Fmf, Gs, Gg, Rr, Rr, Hh^Fmf, Hh^Fmf, Mm, Hh^Fmf, Mm, Mm, Mm, Mm, Mm, Mm, Mm, Mm, Mm, Mm, Mm, Mm
Mm, Mm, Mm, Mm, Mm, Mm, Hh^Fmf, Hh^Fmf, Hh^Fmf, Hh^Fmf, Hh^Fmf, Mm, Hh^Fmf, Hh^Fmf, Hh^Fmf, Gll^Fmf, Gll^Fmf, Gll^Fmf, Hh^Fmf, Hh^Fmf, Mm, Hh^Fmf, Mm, Gll, Gs, Gs, Rr, Gg, Gs, Hh^Fmf, Hh^Fmf, Mm, Mm, Mm^Xm, Mm^Xm, Mm, Mm, Hh^Fmf, Gs^Vc, Gs, Gll, Rr, Rr, Rr, Rr, Hh^Fmf, Hh^Fmf, Mm, Mm, Mm, Mm, Mm, Mm, Mm, Mm, Mm, Mm
Mm, Mm, Mm, Mm, Mm, Hh^Fmf, Hh^Fmf, Hh, Hh^Fmf, Hh^Fmf, Hh^Fmf, Hh^Fmf, Hh^Fmf, Hh, Hh^Fmf, Gll^Fmf, Hh^Vws, Hh^Fmf, Mm, Mm, Mm, Mm, Mm, Mm, Hh^Fmf, Rr, Cud, Rr, Gll, Hh^Fmf, Mm, Mm, Mm, Mm, Mm, Mm^Xm, Mm, Hh^Fmf, Hh^Fmf, Hh^Fmf, Hh^Fmf, Hh^Fmf, Hh^Fmf, Hh^Fmf, Hh^Fmf, Rr, Rr, Hh^Fmf, Hh^Fmf, Mm, Mm, Mm, Mm, Mm, Mm, Mm, Mm
Mm, Mm, Mm, Mm, Mm, Hh^Fmf, Hh^Fmf, Hh, Hh^Fmf, Hh^Fmf, Hh^Fmf, Hh^Fmf, Hh^Fmf, Hh^Fmf, Hh^Fmf, Hh^Fmf, Hh^Fmf, Mm, Mm, Mm^Xm, Mm^Xm, Mm, Mm, Mm, Cud, Rr^Cov, Rr^Cov, Rr^Cov, Cud, Hh^Fmf, Mm, Mm, Mm, Mm, Mm^Xm, Mm, Mm, Mm, Mm, Mm, Mm, Mm^Xm, Mm, Mm, Mm, Hh^Fmf, Gll^Fmf, Rr, Rr, Hh^Fmf, Hh^Fmf, Mm, Mm, Mm, Mm, Mm, Mm
Mm, Mm, Mm, Mm, Mm, Mm, Mm, Hh^Fmf, Mm, Hh^Fmf, Hh^Fmf, Hh^Fmf, Hh^Fmf, Hh^Fmf, Mm, Mm^Xm, Mm^Xm, Mm, Mm, Mm, Mm, Mm^Xm, Mm, Cud, Hh, Rr, Cud, Rr, Hh^Vud, Cud, Mm, Mm, Mm, Mm, Mm^Xm, Mm^Xm, Mm^Xm, Mm, Mm, Mm, Mm, Mm, Mm, Mm^Xm, Mm, Hh^Fmf, Hh^Fmf, Gll^Fmf, Gll^Fmf, Rr, Rr, Hh^Fmf, Hh^Fmf, Hh^Fmf, Mm, Mm, Mm
Mm, Mm, Mm, Mm, Mm, Mm, Mm, Mm, Mm, Mm^Xm, Mm^Xm, Mm, Mm, Mm, Mm, Mm^Xm, Mm^Xm, Mm^Xm, Mm, Mm, Mm, Mm, Mm, Mm, Hh, Cud, 1 Kud, Cud, Hh, Hh, Mm, Mm, Mm, Mm, Mm, Mm^Xm, Mm, Mm, Mm, Mm, Mm, Mm^Xm, Mm^Xm, Mm, Mm, Mm, Hh^Fmf, Gll^Fmf, Gll^Fmf, Gll^Fmf, Gll^Fmf, Rr, Rr, Gll^Fmf, Mm, Mm, Mm
Mm, Mm, Mm, Mm, Mm, Mm, Mm, Mm, Mm, Mm, Mm, Mm^Xm, Mm, Mm, Mm, Mm, Mm, Mm, Mm, Mm, Mm, Mm, Mm, Mm, Mm, Cud, Cud, Cud, Mm, Mm, Mm, Mm, Mm, Mm, Mm, Mm, Mm, Mm, Mm, Mm^Xm, Mm^Xm, Mm, Mm, Mm^Xm, Mm, Mm, Mm^Xm, Hh^Fmf, Hh^Fmf, Hh^Fmf, Hh^Fmf, Gll^Fmf, Gll^Fmf, Rr, Rr, Mm, Mm
Mm, Mm, Mm, Mm, Mm, Mm, Mm, Mm, Mm, Mm, Mm, Mm, Mm, Mm^Xm, Mm^Xm, Mm, Mm, Mm, Mm, Mm, Mm, Mm, Mm, Mm, Mm, Mm, Mm, Mm, Mm, Mm, Mm, Mm, Mm, Mm, Mm, Mm, Mm, Mm, Mm, Mm, Mm, Mm, Mm, Mm, Mm, Mm, Mm, Mm, Mm, Mm, Mm, Hh^Fmf, Gll^Fmf, Gll^Fmf, Rr, Mm, Gll^Fmf
Mm, Mm, Mm, Mm, Mm, Mm, Mm, Mm, Mm, Mm, Mm, Mm, Mm, Mm, Mm, Mm^Xm, Mm, Mm, Mm, Mm, Mm, Mm, Mm, Mm, Mm, Mm, Mm, Mm, Mm, Mm, Mm, Mm, Mm, Mm, Mm, Mm, Mm, Mm, Mm, Mm, Mm, Mm, Mm, Mm, Mm, Mm, Mm, Mm, Mm, Mm, Mm, Mm, Mm, Hh^Fmf, Gll^Fmf, Rr, Rr
Mm, Mm, Mm, Mm, Mm, Mm, Mm, Mm, Mm, Mm, Mm, Mm, Mm, Mm, Mm, Mm, Mm, Mm, Mm, Mm, Mm, Mm, Mm, Mm, Mm, Mm, Mm, Mm, Mm, Mm, Mm, Mm, Mm, Mm, Mm, Mm, Mm, Mm, Mm, Mm, Mm, Mm, Mm, Mm, Mm, Mm, Mm, Mm, Mm, Mm, Mm, Mm, Mm, Hh^Fmf, Hh^Fmf, Gll^Fmf, Gg
