Qraw, Qraw, Qraw, Qraw, Qraw, Qraw, Qraw, Qraw, Qraw, Qraw, Qraw, Qraw, Qraw, Qraw, Qraw, Qraw, Qraw, Qraw, Qraw, Qraw, Qraw, Qraw
Qraw, Qraw, Qraw, Qraw, Qraw, Qraw, Qraw, Qraw, Qraw, Qraw, Qraw, Qraw, Qraw, Qraw, Qraw, Qraw, Qraw, Qraw, Qraw, Qraw, Qraw, Qraw
Qraw, Qraw, Qraw, Qraw, Qraw, Qraw, Qraw, Qraw, Qraw, Qraw, Qraw, Qraw, Qraw, Qraw, Qraw, Qraw, Qraw, Qraw, Qraw, Qraw, Qraw, Qraw
Qraw, Qraw, Qraw, Qraw, Qraw, Qraw, Qraw, Qraw, Qraw, Qraw, Qraw, Qraw, Qraw, Qraw, Qraw, Qraw, Qraw, Qraw, Qraw, Qraw, Qraw, Qraw
Qraw, Qraw, Qraw, Qraw, Qraw, Qraw, Qraw, Qraw, Qraw, Qraw, Qraw, Qraw, Qraw, Qraw, Qraw, Qraw, Qraw, Qraw, Qraw, Qraw, Qraw, Qraw
Qraw, Qraw, Qraw, Qraw, Qraw, Qraw, Qraw, Qraw, Qraw, Qraw, Qraw, Qraw, Qraw, Qraw, Qraw, Qraw, Qraw, Qraw, Qraw, Qraw, Qraw, Qraw
Qraw, Qraw, Qraw, Qraw, Qraw, Qraw, Qraw, Qraw, Qraw, Qraw, Qraw, Qraw, Qraw, Qraw, Qraw, Qraw, Qraw, Qraw, Qraw, Qraw, Qraw, Qraw
Qraw, Qraw, Qraw, Qraw, Qraw, Qraw, Qraw, Qraw, Qraw, Qraw, Qraw, 2 Qraw, Qraw, Qraw, Qraw, Qraw, Qraw, Qraw, Qraw, Qraw, Qraw, Qraw
Qraw, Qraw, Qraw, Qraw, Qraw, Qraw, Qraw, Qraw, Qraw, Qraw, Qraw, Qraw, Qraw, Qraw, Qraw, Qraw, Qraw, Qraw, Qraw, Qraw, Qraw, Qraw
Qraw, Qraw, Qraw, Qraw, Qraw, Qraw, Qraw, Qraw, Qraw, Qraw, Qraw, Qraw, Qraw, Qraw, Qraw, Qraw, Qraw, Qraw, Qraw, Qraw, Qraw, Qraw
Qraw, Qraw, Qraw, Qraw, Qraw, Qraw, Qraw, Qraw, Qraw, Qraw, Qraw, Qraw, Qraw, Qraw, Qraw, Qraw, Qraw, Qraw, Qraw, Qraw, Qraw, Qraw
Qraw, Qraw, Qraw, Qraw, Qraw, Qraw, Qraw, Qraw, Qraw, Qraw, Qraw, Qraw, Qraw, Qraw, Qraw, Qraw, Qraw, Qraw, Qraw, Qraw, Qraw, Qraw
Qraw, Qraw, Qraw, Qraw, Qraw, Qraw, Qraw, Qraw, Qraw, Qraw, 1 Qraw, Qraw, Qraw, Qraw, Qraw, Qraw, Qraw, Qraw, Qraw, Qraw, Qraw, Qraw
Qraw, Qraw, Qraw, Qraw, Qraw, Qraw, Qraw, Qraw, Qraw, Qraw, Qraw, Qraw, Qraw, Qraw, Qraw, Qraw, Qraw, Qraw, Qraw, Qraw, Qraw, Qraw
Qraw, Qraw, Qraw, Qraw, Qraw, Qraw, Qraw, Qraw, Qraw, Qraw, Qraw, Qraw, Qraw, Qraw, Qraw, Qraw, Qraw, Qraw, Qraw, Qraw, Qraw, Qraw
Qraw, Qraw, Qraw, Qraw, Qraw, Qraw, Qraw, Qraw, Qraw, Qraw, Qraw, Qraw, Qraw, Qraw, Qraw, Qraw, Qraw, Qraw, Qraw, Qraw, Qraw, Qraw
Qraw, Qraw, Qraw, Qraw, Qraw, Qraw, Qraw, Qraw, Qraw, Qraw, Qraw, Qraw, Qraw, Qraw, Qraw, Qraw, Qraw, Qraw, Qraw, Qraw, Qraw, Qraw
Qraw, Qraw, Qraw, Qraw, Qraw, Qraw, Qraw, Qraw, Qraw, Qraw, Qraw, Qraw, Qraw, Qraw, Qraw, Qraw, Qraw, Qraw, Qraw, Qraw, Qraw, Qraw
Qraw, Qraw, Qraw, Qraw, Qraw, Qraw, Qraw, Qraw, Qraw, Qraw, Qraw, Qraw, Qraw, Qraw, Qraw, Qraw, Qraw, Qraw, Qraw, Qraw, Qraw, Qraw
Qraw, Qraw, Qraw, Qraw, Qraw, Qraw, Qraw, Qraw, Qraw, Qraw, Qraw, Qraw, Qraw, Qraw, Qraw, Qraw, Qraw, Qraw, Qraw, Qraw, Qraw, Qraw
Qraw, Qraw, Qraw, Qraw, Qraw, Qraw, Qraw, Qraw, Qraw, Qraw, Qraw, Qraw, Qraw, Qraw, Qraw, Qraw, Qraw, Qraw, Qraw, Qraw, Qraw, Qraw
