Kw, Kw, Kw, Cw, Cw, Cw, Cw, Cw, Cw, Cw, Cw, Cw, Cw, Cw, Cw, Cw, Cw, Cw, Kw, Kw, Kw
Kw, Kw, Kw, Kw, Kw, Cw, Cw, Cw, Cw, Cw, Cw, Cw, Cw, Cw, Cw, Cw, Kw, Kw, Kw, Kw, Kw
Wot, Kw, Kw, Kw, Kw, Kw, Kw, Kw, Kw, Kw, Kw, Kw, Kw, Kw, Kw, Kw, Kw, Kw, Kw, Kw, Wot
Wot, Wot, Wot, Kw, Kw, Kw, Kw, Kw, Kw, Kw, Kw, Kw, Kw, Kw, Kw, Kw, Kw, Kw, Wot, Wot, Wot
Wot, Wot, Wot, Wot, Wot, Kw, Kw, Kw, Kw, 1 Kw, Kw, Kw, Kw, Kw, Kw, Kw, Wot, Wot, Wot, Wot, Wot
Wot, Wot, Wot, Wot, Wot, Wot, Wot, Wot, Wot, Wot, Wot, Wot, Wot, Wot, Wot, Wot, Wot, Wot, Wot, Wot, Wot
Wot, Wot, Wot, Wot, Wot, Wot, Wot, Wot, Wot, Wot, Wot, Wot, Wot, Wot, Wot, Wot, Wot, Wot, Wot, Wot, Wot
Wot, Wot, Wot, Wot, Wot, Wot, Wot, Wot, Wot, Wot, Wot, Wot, Wot, Wot, Wot, Wot, Wot, Wot, Wot, Wot, Wot
