Xoi, Xoi, Xoi, Xoi, Irs, Xoi, Xoi, Xoi, Xoi, Xoi, Xoi, Irs, Irs^Ii, Irs, Xoi, Xoi, Xoi, Xoi, Xoi, Irs, Xoi, Xoi, Xoi, Xoi, Xoi
Irs, Xoi, Xoi, Xoi, Irs, Xoi, Xoi, Xoi, Xoi, Xoi, Xoi, Irs, Irs^Ii, Irs, Xoi, Xoi, Xoi, Xoi, Xoi, Irs, Irs, Xoi, Xoi, Xoi, Irs
Xoi, Irs, Irs, Xoi, Irs, Xoi, Xoi, Xoi, Xoi, Xoi, Xoi, Irs, Irs^Ii, Irs, Xoi, Xoi, Xoi, Xoi, Xoi, Xoi, Xoi, Irs, Irs, Irs, Xoi
Xoi, Xoi, Xoi, Irs, Irs, Xoi, Xoi, Xoi, Xoi, Xoi, Irs, Irs, Irs^Ii, Irs, Irs, Xoi, Xoi, Xoi, Xoi, Xoi, Irs, Irs, Xoi, Xoi, Xoi
Xoi, Xoi, Xoi, Xoi, Xoi, Irs, Irs, Xoi, Irs, Irs, Xoi, Irs, Irs^Ii, Irs, Xoi, Irs, Irs, Xoi, Irs, Irs, Xoi, Xoi, Xoi, Xoi, Xoi
Xoi, Xoi, Xoi, Xoi, Xoi, Xoi, Irs, Irs, Xoi, Xoi, Irs, Irs, Irs^Ii, Irs, Irs, Xoi, Xoi, Irs, Irs, Xoi, Xoi, Xoi, Xoi, Xoi, Xoi
Irs, Xoi, Xoi, Xoi, Irs, Irs, Xoi, Irs^Ii, Irs, Irs, Irs, Irs, Xoi^Efs, Irs, Irs, Irs, Irs, Irs^Ii, Xoi, Irs, Irs, Xoi, Xoi, Xoi, Irs
Xoi, Irs, Irs, Irs, Xoi, Xoi, Irs, Irs, Irs, Irs, Xoi^Efs, Irs^Ii, Irs, Irs^Ii, Xoi^Efs, Irs, Irs, Irs, Irs, Xoi, Xoi, Irs, Irs, Irs, Xoi
Xoi, Xoi, Irs, Irs^Ii, Irs, Irs, Irs, Irs, Xoi^Efs, Irs^Ii, Irs, Irs, Irs, Irs, Irs, Irs^Ii, Xoi^Efs, Irs, Irs, Irs, Irs, Irs^Ii, Irs, Xoi, Xoi
Xoi, Xoi, Irs, Xoi, Irs, Irs, Xoi^Efs, Irs^Ii, Irs, Irs, Irs, Irs, Irs, Irs, Irs, Irs, Irs, Irs^Ii, Xoi^Efs, Irs, Irs, Xoi, Irs, Xoi, Xoi
Xoi, Xoi, Irs, Xoi, Irs, Irs, Irs^Ii, Irs, Irs, Irs, Irs, Irs, Irs, Irs, Irs, Irs, Irs, Irs, Irs^Ii, Irs, Irs, Xoi, Irs, Xoi, Xoi
Irs, Xoi, Irs, Xoi, Irs, Irs, Xoi^Efs, Irs, Irs, Irs, Irs, Irs, Qxua^Ii, Irs, Irs, Irs, Irs, Irs, Xoi^Efs, Irs, Irs, Xoi, Irs, Xoi, Irs
Irs, Irs, Irs, Irs, Irs, Irs, Irs^Ii, Irs, Irs, Irs, Irs, Qxua^Ii, Irs^Vs, Qxua^Ii, Irs, Irs, Irs, Irs, Irs^Ii, Irs, Irs, Irs, Irs, Irs, Irs
Irs, Irs, Irs, Irs, Irs, Irs, Xoi^Efs, Irs, Irs, Irs, Irs, Qxua^Ii, Qxua^Ii, Qxua^Ii, Irs, Irs, Irs, Irs, Xoi^Efs, Irs, Irs, Irs, Irs, Irs, Irs
Xoi, Xoi, Irs, Xoi, Irs, Irs, Irs^Ii, Irs, Irs, Irs, Irs, Irs, Irs, Irs, Irs, Irs, Irs, Irs, Irs^Ii, Irs, Irs, Xoi, Irs, Xoi, Xoi
Xoi, Xoi, Irs, Xoi, Irs, Irs, Xoi^Efs, Irs, Irs, Irs, Irs, Irs, Irs, Irs, Irs, Irs, Irs, Irs, Xoi^Efs, Irs, Irs, Xoi, Irs, Xoi, Xoi
Xoi, Xoi, Irs, Xoi, Irs, Irs, Irs, Irs^Ii, Xoi^Efs, Irs, Irs, Irs, Irs, Irs, Irs, Irs, Xoi^Efs, Irs^Ii, Irs, Irs, Irs, Xoi, Irs, Xoi, Xoi
Xoi, Xoi, Irs, Irs^Ii, Xoi, Irs, Irs, Irs, Irs, Irs^Ii, Xoi^Efs, Irs, Irs, Irs, Xoi^Efs, Irs^Ii, Irs, Irs, Irs, Irs, Xoi, Irs^Ii, Irs, Xoi, Xoi
Irs, Irs, Xoi, Irs, Irs, Xoi, Xoi, Irs, Irs, Irs, Irs, Irs^Ii, Xoi^Efs, Irs^Ii, Irs, Irs, Irs, Irs, Xoi, Xoi, Irs, Irs, Xoi, Irs, Irs
Xoi, Xoi, Xoi, Xoi, Xoi, Irs, Irs, Irs^Ii, Xoi, Irs, Irs, Irs, Irs^Ii, Irs, Irs, Irs, Xoi, Irs^Ii, Irs, Irs, Xoi, Xoi, Xoi, Xoi, Xoi
Xoi, Xoi, Xoi, Xoi, Irs, Irs, Xoi, Irs, Irs, Xoi, Xoi, Irs, Irs^Ii, Irs, Xoi, Xoi, Irs, Irs, Xoi, Irs, Irs, Xoi, Xoi, Xoi, Xoi
Xoi, Xoi, Irs, Irs, Xoi, Xoi, Xoi, Xoi, Xoi, Irs, Irs, Irs, Irs^Ii, Irs, Irs, Irs, Xoi, Xoi, Xoi, Xoi, Xoi, Irs, Irs, Xoi, Xoi
Irs, Irs, Xoi, Irs, Xoi, Xoi, Xoi, Xoi, Xoi, Xoi, Xoi, Irs, Irs^Ii, Irs, Xoi, Xoi, Xoi, Xoi, Xoi, Xoi, Xoi, Irs, Xoi, Irs, Irs
Xoi, Xoi, Xoi, Irs, Xoi, Xoi, Xoi, Xoi, Xoi, Xoi, Xoi, Irs, Irs^Ii, Irs, Xoi, Xoi, Xoi, Xoi, Xoi, Xoi, Xoi, Irs, Xoi, Xoi, Xoi
Xoi, Xoi, Xoi, Irs, Xoi, Xoi, Xoi, Xoi, Xoi, Xoi, Xoi, Irs, Irs^Ii, Irs, Xoi, Xoi, Xoi, Xoi, Xoi, Xoi, Xoi, Irs, Xoi, Xoi, Xoi
