Xoi, Xoi, Xoi, Xoi, Xoi, Xoi, Xoi, Xoi, Irs, Irs, Irs, Xoi, Xoi, Xoi, Xoi, Xoi, Xoi, Xoi, Gg
Xoi, Xoi, Xoi, Gg^Efm, Gg^Efm, Xoi, Gg^Efm, Xoi, Irs, Irs, Irs, Xoi, Gg^Efm, Xoi, Gg^Efm, Gg^Efm, Xoi, Xoi, Gg
Xoi, Xoi, Irs, Gg^Efm, Irs, Gg^Efm, Gg^Efm, Xoi, Irs, Irs, Irs, Xoi, Gg^Efm, Gg^Efm, Irs, Gg^Efm, Irs, Xoi, Gg
Xoi, Xoi, Irs, Gg^Efm, Irs, Irs, Irs, Gg^Efm, Irs, Irs, Irs, Gg^Efm, Irs, Irs, Irs, Gg^Efm, Irs, Xoi, Gg
Xoi, Xoi, Irs, Gg^Efm, Irs, Gg^Efm, Irs, Gg^Efm, Irs, Irs, Irs, Gg^Efm, Irs, Gg^Efm, Irs, Gg^Efm, Irs, Xoi, Gg
Xoi, Xoi, Irs, Irs, Irs, Gg^Efm, Irs, Gg^Efm, Irs, Irs, Irs, Gg^Efm, Cw, Gg^Efm, Cw, Irs, Irs, Xoi, Gg
Xoi, Xoi, Irs, Gg^Efm, Irs, Gg^Efm, Irs, Gg^Efm, Irs, Irs, Irs, Gg^Efm, Cw, Gg^Efm, Cw, Gg^Efm, Irs, Xoi, Gg
Xoi, Xoi, Irs, Gg^Efm, Irs, Irs, Irs, Gg^Efm, Irs, Gg^Efm, Irs, Gg^Efm, Cw, Kw, Cw, Gg^Efm, Irs, Xoi, Gg
Xoi, Xoi, Irs, Gg^Efm, Irs, Gg^Efm, Irs, Gg^Efm, Irs, Gg^Efm, Irs, Gg^Efm, Cw, Gg^Efm, Cw, Gg^Efm, Irs, Xoi, Gg
Xoi, Xoi, Irs, Irs, Irs, Gg^Efm, Irs, Gg^Efm, Irs, Gg^Efm, Irs, Gg^Efm, Irs, Gg^Efm, Irs, Irs, Irs, Xoi, Gg
Xoi, Xoi, Irs, Gg^Efm, Irs, Gg^Efm, Irs, Gg^Efm, Irs, Gg^Efm, Irs, Gg^Efm, Irs, Gg^Efm, Irs, Gg^Efm, Irs, Xoi, Gg
Xoi, Xoi, Irs, Gg^Efm, Irs, Irs, Irs, Gg^Efm, Irs, Gg^Efm, Irs, Gg^Efm, Irs, Irs, Irs, Gg^Efm, Irs, Xoi, Gg
Xoi, Xoi, Qxu, Qxu, Qxu, Qxu, Qxu, Qxu, Qxu^Bsb|, Qxu^Bsb|, Qxu^Bsb|, Qxu, Qxu, Qxu, Qxu, Qxu, Qxu, Xoi, Gg
Qxu, Qxu, Qxu, Qxu, Qxu, Qxu, Qxu, Qxu, Qxu^Bsb|, Qxu^Bsb|, Qxu^Bsb|, Qxu, Qxu, Qxu, Qxu, Qxu, Qxu, Qxu, Qxu
Qxu, Qxu, Qxu, Qxu, Qxu, Qxu, Qxu, Qxu, Qxu^Bsb|, Qxu^Bsb|, Qxu^Bsb|, Qxu, Qxu, Qxu, Qxu, Qxu, Qxu, Qxu, Qxu
Qxu, Qxu, Qxu, Qxu, Qxu, Qxu, Qxu, Qxu, Qxu^Bsb|, Qxu^Bsb|, Qxu^Bsb|, Qxu, Qxu, Qxu, Qxu, Qxu, Gg, Qxu, Qxu
