Xoi, Xoi, Xoi, Xoi, Irs, Xoi, Xoi, Xoi, Xoi, Xoi, Xoi, Irs, Irs^Ii, Irs, Xoi, Xoi, Xoi, Xoi, Xoi, Irs, Xoi, Xoi, Xoi, Xoi, Xoi
Irs, Xoi, Xoi, Xoi, Irs, Xoi, Xoi, Xoi, Xoi, Xoi, Xoi, Ias, Irs^Ii, Irs, Xoi, Xoi, Xoi, Xoi, Xoi, Irs, Irs, Xoi, Xoi, Xoi, Irs
Xoi, Irs, Irs, Xoi, Irs, Xoi, Xoi, Xoi, Xoi, Xoi, Xoi, Ias, Ias, Ias, Xoi, Xoi, Xoi, Xoi, Xoi, Xoi, Xoi, Irs, Irs, Irs, Xoi
Xoi, Xoi, Xoi, Irs, Irs, Xoi, Xoi, Xoi, Xoi, Xoi, Irs, Irs, Ias, Irs, Ias, Xoi, Xoi, Xoi, Xoi, Xoi, Irs, Irs, Xoi, Xoi, Xoi
Xoi, Xoi, Xoi, Xoi, Xoi, Ias, Ias, Xoi, Irs, Irs, Xoi, Ias, Ias, Irs, Xoi, Irs, Irs, Xoi, Ias, Ias, Xoi, Xoi, Xoi, Xoi, Xoi
Xoi, Xoi, Xoi, Xoi, Xoi, Xoi, Irs, Irs, Xoi, Xoa, Ias, Ias, Ias, Ias, Ias, Xoa, Xoi, Ias, Irs, Xoi, Xoi, Xoi, Xoi, Xoi, Xoi
Irs, Xoi, Xoi, Xoi, Irs, Irs, Xoi, Irs^Ii, Ias, Ias, Ias, Ias, Xoa, Ias, Ias, Ias, Ias, Ias, Xoi, Irs, Ias, Xoi, Xoi, Xoi, Irs
Xoi, Irs, Irs, Ias, Xoi, Xoa, Ias, Ias, Ias, Ias, Xoa, Ias, Uue, Ias, Xoa, Ias, Ias, Ias, Ias, Xoa, Xoi, Irs, Ias, Irs, Xoi
Xoi, Xoi, Irs, Ias, Ias, Ias, Ias, Ias, Xoa, Uue, Ias, Ias, Uue, Ias, Uue, Ias, Xoa, Ias, Ias, Ias, Ias, Ias, Irs, Xoi, Xoi
Xoi, Xoi, Ias, Xoi, Ias, Ias, Xoa, Uue, Ias, Uue, Uue, Ias, Uue, Ias, Uue, Uue, Ias, Ias, Xoa, Ias, Ias, Xoi, Ias, Xoi, Xoi
Xoi, Xoi, Ias, Xoa, Ias, Ias, Uue, Uue, Uue, Ias, Uue, Uue, Qxe, Uue, Uue, Ias, Ias, Uue, Ias, Ias, Ias, Xoa, Ias, Xoi, Xoi
Irs, Xoi, Irs, Xoi, Ias, Ias, Xoa, Ias, Ias, Uue, Qxe, Qxe, Qxe, Qxe, Uue, Ias, Uue, Uue, Xoa, Ias, Ias, Xoi, Irs, Xoi, Irs
Irs, Ias, Ias, Ias, Ias, Ias, Uue, Uue, Uue, Uue, Qxe, Qxua^Ii, Qxe, Qxe, Qxe, Uue, Ias, Ias, Ias, Ias, Ias, Ias, Ias, Irs, Irs
Irs, Irs, Ias, Irs, Ias, Ias, Xoa, Ias, Uue, Uue, Qxe, Qxe, Qxua^Ii, Qxua^Ii, Qxe, Uue, Uue, Uue, Xoa, Ias, Ias, Ias, Irs, Irs, Irs
Xoi, Xoi, Irs, Xoi, Ias, Ias, Uue, Uue, Ias, Uue, Uue, Qxe, Qxe, Qxe, Uue, Uue, Uue, Ias, Ias, Ias, Ias, Xoi, Irs, Xoi, Xoi
Xoi, Xoi, Ias, Xoa, Ias, Ias, Xoa, Ias, Uue, Ias, Uue, Uue, Uue, Uue, Uue, Ias, Ias, Uue, Xoa, Ias, Ias, Xoa, Irs, Xoi, Xoi
Xoi, Xoi, Irs, Xoi, Ias, Ias, Ias, Ias, Xoa, Uue, Ias, Ias, Uue, Ias, Ias, Uue, Xoa, Ias, Ias, Ias, Ias, Xoi, Irs, Xoi, Xoi
Xoi, Xoi, Ias, Ias, Xoi, Ias, Ias, Ias, Ias, Ias, Xoa, Ias, Uue, Ias, Xoa, Uue, Ias, Ias, Ias, Ias, Xoi, Ias, Ias, Xoi, Xoi
Irs, Irs, Xoi, Irs, Ias, Xoa, Xoi, Ias, Ias, Ias, Ias, Uue, Xoa, Ias, Ias, Ias, Ias, Ias, Xoi, Xoa, Irs, Ias, Xoi, Ias, Irs
Xoi, Xoi, Xoi, Xoi, Xoi, Ias, Ias, Ias, Xoi, Ias, Ias, Ias, Ias, Ias, Ias, Ias, Xoi, Ias, Ias, Irs, Xoi, Xoi, Xoi, Xoi, Xoi
Xoi, Xoi, Xoi, Xoi, Irs, Irs, Xoi, Ias, Irs, Xoa, Xoi, Ias, Ias, Ias, Xoi, Xoa, Irs, Ias, Xoi, Irs, Irs, Xoi, Xoi, Xoi, Xoi
Xoi, Xoi, Irs, Irs, Xoi, Xoi, Xoi, Xoi, Xoi, Irs, Irs, Irs, Ias, Irs, Irs, Ias, Xoi, Xoi, Xoi, Xoi, Xoi, Irs, Irs, Xoi, Xoi
Irs, Irs, Xoi, Irs, Xoi, Xoi, Xoi, Xoi, Xoi, Xoi, Xoi, Irs, Ias, Irs, Xoi, Xoi, Xoi, Xoi, Xoi, Xoi, Xoi, Irs, Xoi, Irs, Irs
Xoi, Xoi, Xoi, Irs, Xoi, Xoi, Xoi, Xoi, Xoi, Xoi, Xoi, Ias, Irs^Ii, Ias, Xoi, Xoi, Xoi, Xoi, Xoi, Xoi, Xoi, Irs, Xoi, Xoi, Xoi
Xoi, Xoi, Xoi, Irs, Xoi, Xoi, Xoi, Xoi, Xoi, Xoi, Xoi, Irs, Irs^Ii, Irs, Xoi, Xoi, Xoi, Xoi, Xoi, Xoi, Xoi, Irs, Xoi, Xoi, Xoi
